XR650L	XR650L
(Erik	(إريك
daya?!?	واحد؟!؟
saman.	القمة.
535	535
samu,	وجدت،
Surface	سطح
samu.	تم العثور عليها.
jet	طائرة نفاثة
#	#
&quot;hujja-Tsara	على &amp; quot؛ إثبات تنسيق
laifuffuka	مجرم
matakin.	المستوى.
James	جيمس
$	$
%	٪
*	*
airlifted	جوا
+	+
(Jon	(جون
(	(
)	)
.	.
isa!	بما فيه الكفاية!
Team	فريق
/	/
,	،
-	-
isa.	بما فيه الكفاية.
3	3
2	2
dawo	عودة
1	1
7	7
6	6
5	5
4	4
cafe	مقهى
:	:
9	9
retrograde	رجعي
8	8
&lt;94318@hydra.gatech.EDU&gt;	العلامة &amp; lt؛ 94318@hydra.gatech.EDU&amp;gt.
=	=
Gauche	أخرق
D	D
E	E
tushen.	القائمة.
F	F
SetWUTime	SetWUTime
tushen,	مقرها،
@	@
Kattai	عمالقة
A	A
B	B
lokaci.&quot;	. الوقت ومثل؛
sped	اسرعت
C	C
L	L
M	M
MATATTU	الحسابات
H	H
I	أنا
J	J
Dangantaka	العلاقات
U	U
T	تي
muka	نحن
hukumar	وكالة
(713)	(713)
Q	Q
S	S
daruna	السلطانيات
\	\
_	_
^	^
yankinka	منطقة
X	X
1846	1846
mmm@cup.portal.com	html>
g	ز
d	د
Feb	فبراير
e	ه
Tambayoyi:	الأسئلة:
a	في
daya	واحد
bayani	حل
slated	المقرر
&lt;1r10jcINNt1g@lynx.unm.edu&gt;	العلامة &amp; lt؛ 1r10jcINNt1g@lynx.unm.edu&amp;gt.
kunshe-kunshe&quot;	حزم ومثل؛
o	س
m	م
tsananin.	شتيرن.
h	ح
i	ط
w	ث
hakikanin	حقيقي
520	520
p	ص
Optilink!	Optilink!
isar	نقل
~	~
|	|
&quot;Re-bayyana?&quot;	على &amp; quot؛ إعادة تظهر على &amp; quot؛؟
&#39;Ina	&#39;I
x	س
kankara	جليد
karanta,	قراءة،
(KJV)	(KJV)
zambiyõyin	خطى
(ciki	(بما في ذلك
agressive	عدوانية
mallakar.	تملكها.
Melnick)	ميلنك)
updated	تحديث
Duniya-a	في عالم
JPEG,	JPEG،
azuzuwan	فصول
ocom.okstate.edu	html>
580	580
Adam	آدم
paralleled	يتوازى
helium,	الهيليوم،
firamare	ابتدائي
tsalle	القفز
FAQ.	أسئلة وأجوبة.
Gida	منزل
farfaganda.	الدعاية.
helium.	الهيليوم.
FAQ,	التعليمات
(sorry	(عذرا
&quot;yi	على &amp; quot؛
hadar	قيود
(haɗa	(بما في ذلك
update	التحديث
ƙunshi	يحتوي على
Halitta	خلق
Ma&#39;aikatan	العاملين
tekuna.	البحار.
(__)	(__)
Kasar	بلد
&#39;yan&#39;	&#39;&#39;
samu]	وجدت]
&quot;mun	على &amp; quot؛ نحن
dalilai:	الأسباب:
(Wannan	(هذا
XBell	XBell
YI.	DO.
dangane	صلة
samun	وصول
Yunkurin	محاولة
Sugar	سكر
lpt1	LPT1
azaba.)	العقاب).
Fir	خشب التنوب
3rd	3
Godiya	شكر
pgf@srl02.cacs.usl.edu|Like	pgf@srl02.cacs.usl.edu|Like
Division	تقسيم
Fit	صالح
dalilai.	الأسباب.
addini	ديني
karya-koyaswa?	عقيدة خاطئة؟
Tasco	TASCO
DR250ES	DR250ES
&quot;ko	على &amp; quot؛
Kashi	في المئة
vesterman.	vesterman.
ishe	كاف
redefined	إعادة تعريف
&gt;&gt;	وطن؛ &amp; GT؛
jobs.	وظائف.
labarai-taron	أخبار المؤتمر
kanta.	نفسها.
burodi.	الخبز.
miles)	ميلا)
&lt;C51nLs.7As@boi.hp.com&gt;,	العلامة &amp; lt؛ C51nLs.7As@boi.hp.com&amp;gt،،
noiseless	بلا ضجة
cewa&quot;	هذا ومثل؛
tafi,	تذهب،
Detriot,	Detriot،
m-ja	م أحمر
cryptography	التشفير
comets	المذنبات
faruwa	الذهاب
hange.	رصدت.
masu&gt;	وGT.
zanga-gun	مكافحة بندقية
freezes,	يتجمد،
frosted	مثلج
tambayar.	المسألة.
kãfirta.	رفض.
samfurori.	المنتجات.
Intanet	الإنترنت
tun&#39;	منذ &quot;
tafi?	تذهب؟
hunturu	شتاء
internet:	الإنترنت:
ciniki,	التجارة،
(Blaise	(بليز
010-A	010-A
luwadi,	مثليون جنسيا،
Juyin	ثورة
Annabawa.	الأنبياء.
4H7	4H7
Annabawa,	الأنبياء،
&quot;hakikanin&quot;&gt;	على &amp; quot؛ حقيقية ومثل؛ &amp; GT؛
Irin	مثل
Norway	النرويج
&quot;ja	على &amp; quot؛ أحمر
indepth	وراء الخبر
Norway):	النرويج):
dutsen	جبل
tarurruka&gt;	الاجتماعات &amp; GT؛
Algorithms	خوارزميات
GIDA.	HOME.
jin	يشعر
bayanai.	المعلومات.
bayanai,	المعلومات،
Douglas	دوغلاس
Liwadi	المثلية
Neptune	نبتون
Toyota,	تويوتا،
tranfer	يمكنك نقل
50.	50.
50,	50
DOUBLE_BUFFER	DOUBLE_BUFFER
ciwon	وجود
500	500
--------------------------------------------	--------------------------------------------
yanayi	الشروط
muke	نحن
opti	غروب
12:26	00:26
tangent	المماس
kyau&quot;	جيدة ومثل؛
maria,	ماريا،
Edmond	إدموند
&quot;kai&quot;	على &amp; quot؛ &amp; مثل؛
&quot;mu	على &amp; quot؛
&quot;na	على &amp; quot؛
bukata	مطلوب
gashi&quot;	الشعر ومثل؛
dunes.	الكثبان الرملية.
launuka	الألوان
muni	أسوأ
5.7	5.7
accusors.	accusors.
LOVE	الحب
tattaunawa	محادثات
Stein)	شتاين)
hasãrar	ضائع
meteoroids.	النيازك.
5.0	5.0
ambaliya	الفيضانات
1870	1870
muna	نحن
zobe	عصابة
ciwo)	متلازمة)
Wolves	الذئاب
&lt;1r9j33$4g8@hsdndev.harvard.edu&gt;,	العلامة &amp; lt؛ 1r9j33$4g8@hsdndev.harvard.edu&amp;gt،،
2,000	2000
^^^^^^^^^^^^^^^^^^^^^^^^^^^^^^^^^^^^^^^^^^^^^^^^^^	^^^^^^^^^^^^^^^^^^^^^^^^^^^^^^^^^^^^^^^^^^^^^^^^^^
rooting	تأصيل
huce.	البرد.
m-grained	غرامة الحبيبات
763-5889	763-5889
saman	أعلى
tursasawa	قهري
84-shekara	84 سنة
bazara	الصيف
duk&gt;	كل وGT.
samar	الإنتاج
mulkin.	الحكم.
timmbake@mcl.ucsb.edu	html>
Window	نافذة
&quot;cika&quot;	على &amp; quot؛ كامل &amp; مثل؛
Cyrix	Cyrix
mulkin)	القاعدة)
amana.	الثقة.
Jamus	ألمانيا
16-169	16-169
ita	هو
Katange	محظور
sama)	أعلاه)
ɗan&#39;uwãna	شقيق
1ff,	1ff
sama,	أعلاه،
sama.	أعلاه.
Cyric	Cyric
helium	الهيليوم
NUETZMAN	NUETZMAN
sama?	السماء؟
ayyuka.	وظائف.
joules	جول
escalating,	المتصاعدة،
FTP	FTP
Domin&gt;	ل&amp; GT؛
gumakan.	الآلهة.
likita&quot;	الطبية ومثل؛
&lt;sl3b+@andrew.cmu.edu&gt;	العلامة &amp; lt؛ sl3b+@andrew.cmu.edu&amp;gt.
ɗ	د
Kwana	أيام
Popup	منبثقة
magance	صفقة
gabatar	قدم
tsunkule	قرصة
Honda	هوندا
Back&quot;	الظهر ومثل؛
superencipherment	superencipherment
&lt;1rbn60$gs7@usenet.INS.CWRU.Edu&gt;	العلامة &amp; lt؛ 1rbn60$gs7@usenet.INS.CWRU.Edu&amp;gt.
sababbin	جديد
al&#39;umma,	المجتمع،
irin	مثل
chipset.	شرائح.
al&#39;umma)	المجتمع)
&#39;jin	&quot;السمع
musu	منهم
kiwon	الصحة
bautawarku.	الله.
naushe	الضربات
(82,178	(82178
daban-daban,	مختلفة،
Maɗaukaki,	عالية،
kansu.	أنفسهم.
Technology,	التكنولوجيا،
seconds.	ثواني.
kansu,	أنفسهم،
Craters	الحفر
&quot;yisti	على &amp; quot؛ الخميرة
Muka	نحن
noring@netcom.com	html>
mutu	يموت
&quot;Developing	على &amp; quot؛ تطوير
688-8231	688-8231
Tsarin	نظام
tunaninka,	الذكاء
XXX	XXX
gigice	صدمت
kodadde,	شاحب،
hays@ssd.intel.com	html>
vata	نفاية
...........	...........
subsystems	النظم الفرعية
wanzu	الوجود
Muna	نحن
iri	علامة تجارية
haske	ضوء
isa	كاف
littattafai,	الكتب،
Tsai)	تساي)
&lt;_Atheism:	العلامة &amp; lt؛ _Atheism:
Godiya!	بفضل!
iconified).	iconified).
karye.	مبكرة.
methane	الميثان
jiragen	سفن
kwamfuta	كمبيوتر
ra&#39;ayin,	الفكرة،
kwaro	بق
11:25	11:25
Tsarki	نقاء
al&#39;umma:	المجتمع:
magani,	العلاج،
inã	أنا
(604)	(604)
watsi.	الانبعاثات.
magani.	العلاج.
ra&#39;ayin?	الفكرة؟
kwari	الحشرات
gravitational	الجاذبية
giant	عملاق
gargajiya	تقليدي
Almasihu	يسوع المسيح
Palasdinawa	فلسطيني
Shugaba	رئيس
Fe&gt;	ساعي &amp; GT؛
(Kusan	(تقريبا
rãyuwar,	الحياة،
Dalilin	سبب
PowerPC	باور
hakkin.	الحق.
yawan.	السكان.
nitrogen,	النيتروجين،
paperwork?	الأوراق؟
nitrogen.	النيتروجين.
(SKELTON,	(سكيلتون
&lt;rauser.734062608@sfu.ca&gt;	العلامة &amp; lt؛ rauser.734062608@sfu.ca&amp;gt.
interrupts.	المقاطعات.
Crawford)	كروفورد)
southeners,	southeners
autoexec.bat	AUTOEXEC.BAT
============ECHO	============ صدى
dangantaka	العلاقات
premade	ولم يضف
ɓullo	متطور
tattaunawa,	مناقشة،
nan.&quot;	. ومثل؛
tattaunawa.	مناقشة.
Misira	مصر
gaskata	نعتقد
kusanci	نهج
launuka.	الألوان.
cokula,	معاول،
kwana	أيام
jeri	وضع
wargi.	نكتة.
NEA.	وكالة الطاقة النووية.
resisters	المقاومين
nassi	مرور
jere	صف
soke	إلغاء
jera	المدرجة
caje	بحث
addini&gt;	الدين و GT.
jaskew@spam.maths.adelaide.edu	html>
caji	بحث
nufin,	يعني،
iya	علبة
Clint	كلينت
Technologies,	التقنيات،
Hockey	الهوكي
gajeren?	باختصار؟
littattafan:	كتب:
Jordan	الأردن
rumfa	سقيفة
ultraviolet	فوق بنفسجي
sunã	هم
Daidai,	بالضبط،
&quot;Kirista&quot;,	على &amp; quot؛ &amp; مثل؛ والمسيحية
Marty,	مارتي،
1.770	1770
samfurin	نتاج
maganar	كلمة
percieved	percieved
-391	-391
&#39;watanni	أشهر
can.	هناك.
sadaka.	جمعية خيرية.
Columbia	كولومبيا
babba	عظيم
Original	الأصل
surveyed.	شملتها الدراسة.
post.	وظيفة.
anti-dogara	مكافحة الاحتكار
post,	آخر،
fun.	متعة.
rangadin	جولة
tashinsa	قيامة
matafã	انحسار
&amp;	والأمبير.
rscharfy@magnus.acs.ohio-state.edu	html>
magana,	خطاب
magana.	الكلام.
can?	هناك؟
mafaka	منتجع
G20	G20
Kristi&gt;	المسيح &amp; GT؛
watsa,	انتقال،
mujalloli	النشرات الإخبارية
tuntube&gt;	الإتصال و GT.
ikon,	السلطة،
Fasaha&gt;	تكنولوجيا و GT.
daɗi	مريح
kwafe	نسخة
Suka	و
kamanta	مقارن
bidiyo	فيديو
(saman	(الأعلى
.4ID	.4ID
salon	صالون
atmospheres	أجواء
Louis	لويس
Shell	قذيفة
Chance	فرصة
Sun!	الشمس!
ALLAH	GOD
meteoroid	نيزك
mafarkai,	الأحلام،
inda&gt;	حيث &amp; GT؛
354-1333,	354-1333،
#:	#:
401	401
Charon	كارون
jimla	جملة
400	400
henling	henling
&quot;wadanda	على &amp; quot؛
kusa,	قريب
&quot;New	على &amp; quot؛ جديد
Cryptologia	Cryptologia
&quot;^^^^^^^^^^^^^^^^^^^^^^^^^^^^^^^^	على &amp; quot؛ ^^^^^^^^^^^^^^^^^^^^^^^^^^^^^^^^
1.610	1.610
kalmomi	كلام
bazuwar	عشوائي
bege?	نأمل؟
Larabci	العربية
170,	170
MUSU	THEIR
2nd	2
watakila	ربما
Kumbon	السفينة الفضائية
suna	هي
securital	securital
!!	!!
kofa&quot;	باب ومثل؛
nukiliya	نووي
sabobin	خوادم
yarda	توافق
karfe.	الصلب.
artmel@well.sf.ca.us	html>
(______	(______
siffar	شكل
Littafi	كتاب
************	************
Elvis	ألفيس
suma	بقعة
reponse	أن reponse
14-19	14-19
(Karl	(كارل
yarda,	توافق،
Martin,	مارتن،
kiyaye	الحفاظ
barin	ترك
yarda.	نوافق على ذلك.
&lt;RVESTERM@vma.cc.nd.edu&gt;	العلامة &amp; lt؛ RVESTERM@vma.cc.nd.edu&amp;gt.
engp2008@nusvm.nus.sg	html>
yarda?	توافقون على ذلك؟
ken	كين
CETO	SAVING
farashin	السعر
rinjayar	تأثير
key	مفتاح
35.789	35789
&quot;mu&quot;	على &amp; quot؛ &amp; مثل؛
majalisan	مجلس
Attaura.&quot;	القانون على &amp; quot؛
dama&gt;	عدة وGT.
tantanin	خلية
100&gt;&gt;	100 &amp; GT؛ &amp; GT؛
Leafs	يورق
ƙamus	قاموس
($	($
dookie!&quot;	! dookie ومثل؛
8:31	08:31
gwaje-gwaje.	الاختبارات.
mamaki	مفاجأة
bargo	بطانية
suke	هم
Boston	بوسطن
gwamnatin	حكومة
fuskantar	مواجهة
suka	هم
mutane&gt;	الناس &amp; GT؛
Sun,	الشمس،
rinjaye.	الأغلبية.
firearm	سلاح ناري
placid-neman	الهادئة المظهر
Sun.	الشمس.
shaidan	إبليس
decrypt	فك تشفير
Laifuka	مجرم
Shirya	أعدت
ke,	،
dogayen	طويل
pizza-canza	البيتزا التغيير
barga	مستقر
Sun;	الشمس؛
shaidar	الشاهد
nisa	عرض
Stassen	[ستسن]
barjat	تناثرت
audio	سمعي
Suna	هل
ake&gt;	وGT.
funny	مضحك
gyara.	إصلاح.
ƙiren	تلفيق
sightings	مشاهدات
kafin&gt;	قبل وGT.
kowa.	الجميع.
467	467
waje	أجنبي
-&gt;	- وطن.
schematics.	الخطط.
tafi&gt;	إذهب &amp; GT؛
zurfi.	عميق.
rodents	القوارض
lander	المسبار
Kiyãma&gt;	حكم و GT.
shaida,	الشاهد
shaida.	الشاهد.
ringlets	الجدائل
themself	ذاتهما
Driver	سائق
Fayiloli	ملفات
shaida)	الشاهد)
bunkasa	تنمية
(m	(M
**	**
Kwafa	نسخة
Wai	واي
Sue,	سو،
ku)	)
photochemical	ضوئية
mil).	ميلا).
Shirin	برنامج
mil),	ميلا)،
Iska	هواء
Johnson,	جونسون،
Purchase	شراء
iri.	أنواع.
+1	+1
++	++
rabin	نصف
&quot;gabatarwa&quot;	على &amp; quot؛ تعزيز ومثل؛
(A	(A
phj@remus.rutgers.edu	html>
stats:&gt;&gt;	احصائيات: &amp; GT؛ &amp; GT؛
*************************************	*************************************
look-	look-
plexiglassso	plexiglassso
4.094	4094
¡uraishi	تمطر
algorithm	خوارزمية
(2	(2
lawfully	يوجد على نحو قانوني
CSHOW	CSHOW
samaniya.	الكون.
ƙarshe	نهائي
(1	(1
jarrabawa.	الفحص.
War	حرب
(7	(7
zahiri	في الواقع
jarrabawa,	الفحص،
()	()
kasance	يكون
cikinsu.	لهم.
samaniya,	الكون،
(a	(
&#39;real&#39;	&quot;ريال مدريد&quot;
Magic	سحر
hijira	AH
fringes	هامش
(\	(\
abubuwan	أحداث
arewa	شمال
ritley@uimrl7.mrl.uiuc.edu	html>
&quot;madadin&quot;	على &amp; quot؛ البديل &amp; مثل؛
(I	(I
),	)
Cometary	المذنبات
tarkace	حطام
abũbuwan	الآلهة
Puryear	Puryear
Menene	ما
wuri.	المكان.
preps	محضرات
hardcore	المتشددين
..	..
gonzaled@ucsu.Colorado.EDU	html>
(korenek@nmti.com)	(Korenek@nmti.com)
Altima	ألتيما
kwanaki,	أيام،
lalata	ضرر
kwanaki)	أيام)
lamba	اتصال
dokar,	عمل
ruxani	متحير
eroded,	تآكل،
league	عصبة
kwanaki.	أيام.
//	//
&quot;Babu	على &amp; quot؛ لا
abubuwa,	البنود
exhibiting	العارضة
abubuwa.	البنود.
idan&gt;	إذا وGT.
shirye-shirye.	البرامج.
babur	دراجة نارية
Kalmar	كلمة
wurin	مكان
Abun	محتوى
ge!severy%severy@uunet.UU.NET	html>
MAX641,	MAX641،
[Gen	[الجنرال
tectonics	تكتونية
iri-iri	تشكيلة
impedance	مقاومة
tsakanin	بين
e-mail:	البريد الإلكتروني:
colder	برودة
faɗaɗa	توسع
dakatar	تعليق
ergo	إرجو
ILV20078@UDELVM.UDEL.EDU	html>
fãce	لكن
Gay	مثلي الجنس
sharudda	المعايير
451-0815	451-0815
banza.	دون جدوى.
hushi	غاضب
4.6	4.6
Cramer	كريمر
Gas	غاز
nike	هضم
-.	-.
raster	Raste
maneuvering	المناورة
duration	مدة
kungiyar.	المجموعة.
up&quot;	يصل ومثل؛
kungiyar,	مجموعة،
midsummer.	منتصف الصيف.
Ɗan	ابن
Kloo	Kloo
walwala	حرية
hadewa	صلة
karya-likita	استراحة بين الطبيب
sirri	الشخصية
namelplate	namelplate
Morocco	المغرب
35	35
Wata	A
waya	هاتف
Tug-na-yaki	لعبة شد الحبل من الحرب
ansu	البعض
3:	3:
&lt;1993Apr21.170403.22855@yang.earlham.edu&gt;	العلامة &amp; lt؛ 1993Apr21.170403.22855@yang.earlham.edu&amp;gt.
4.	4.
4,	4،
Wasu	البعض
42	42
40	40
jirgin.	الفلك.
(613)	(613)
2:	2:
(128.149.6.2);	(128.149.6.2)؛
anti	المضادة
22	22
severy	سيفيري
23	23
24	24
befor	قبل احتساب
kurakurai.	الأخطاء.
PowerBooks?	PowerBooks؟
25	25
Rowland	رولاند
tura	دفع
26	26
1W	1W
kwararru.	المتخصصين.
dashi.	التخلص منها.
3,	3،
tsarkakewa	تنقية
3.	3.
30	30
1m	1M
Ishii,	إيشي،
31	31
PowerBooks,	PowerBooks
greenhouse,	الاحتباس الحراري،
3)	3)
isasshe	كاف
19	19
1:	1:
dakunan	الغرف
17	17
wawa	مجنون
18	18
15	15
Abin	ما
16	16
13	13
14	14
11	11
12	12
21	21
20	20
kimanin	حول
2.	2.
Lalle	أن
2,	2،
mamaye	هيمنت
2)	2)
21-22:	21-22:
2%	2٪
teku,	البحر،
teku.	البحر.
wucewa	عابر
taga.	نافذة.
taga,	النافذة،
watã	هلال
erikb@idt.unit.no	html>
1.	1.
cututtuka&quot;	الأمراض ومثل؛
10	10
lokacin.	الوقت.
1)	1)
lokacin,	الوقت،
1%	1٪
maroƙi	مزود
unaccepted	منبوذة
Swartz	سوارتز
Linjila?	الإنجيل؟
7:	7:
Sulfur	كبريت
78	78
West.	الغرب.
Bugu	طبع
7.329.	7329.
prohipiting	prohipiting
(gaskiya),	(صحيح)،
compatable	المتوافقة معها
jarumi,	شجاع،
8,	8،
ZUWA	TO
minutes.	دقيقة.
butterscotch	حلوى من سكر أسمر وزبدة
(waxanda	(أي
6:	6:
Lunar	قمري
hukuma	رسمي
7)	7)
zur	زور
ce:&gt;	وقال: &amp; GT؛
!!!!&quot;	!!!! &amp; قووت]؛
7,	7،
kurakurai	أخطاء
generated	ولدت
70	70
72	72
rasa!	فقدت!
76	76
modem	مودم
model	نموذج
5:	5:
martyj@uiuc.edu	html>
Solomita)	Solomina)
56	56
Update	التحديث
dũbi	رؤية
55	55
5?	5؟
dũba	نظرة
6,	6،
girma	عظيم
&#39;yan&#39;uwa,	أيها الإخوة،
rigor.	RIGO.
12,00	12،00
lambar,	عدد،
mahallin.	السياق.
60	60
narke	صهر
kudancin	جنوبي
^^^^^^^^^^^^^^^^^^^^^^^^^^^^^^^^^^^	^^^^^^^^^^^^^^^^^^^^^^^^^^^^^^^^^^^
4:	4:
1980s.	1980s.
makirci.	المخطط.
4th?	4؟
makada.	العصابات.
feda,	دواسة،
______	______
Wane	التي
70,000th	70000
WW2	WW2
maniyyi	قطرة
5,	5،
haye-duba	عبر الاختيار
Wani	A
Clipper	مجز
subsystem	النظام الفرعي
Arewacin	شمال
pcx,	PCX،
5.	5.
Torre:	توري:
50	50
damar	وصول
(508)	(508)
Sheen	لمعان
Azzam)	عزام)
486	486
*************************************************	*************************************************
lalle	أن
99,86	99.86
namiji,&gt;	الذكور، و GT.
kulawa	رعاية
482	482
&lt;a	العلامة &amp; lt؛
kasashen	الدول
sakamakon,	نتيجة لذلك،
&lt;/	واللفتنانت؛ /
kar	فعل
kan	في
Madrid	مدريد
baucoci	كوبونات
kai	رئيس
Aikace-aikace	تطبيقات
gwaje-gwajen	تجارب
cakulan	شوكولاتة
Lankform,	Lankform
::	::
10:39:15	10:39:15
gurbata	ملوث
turɓaya	غبار
grounded.	على الارض.
rududdugaggu	فاسد
ƙila	ربما
wani	ل
dama?	أليس كذلك؟
:)	:)
gawawwaki	الهيئات
Madogararsa.	مصدر.
fitila,	مصباح،
ka.	.
sbp002@acad.drake.edu	html>
kasanta	ارتكبت
93	93
90	90
misinformed.	معلومات خاطئة.
ka,	،
followup	متابعة
[Kiristoci]	[المسيحيين]
daman	حق
==================================================	==================================================
88	88
azzãlumai?	الخطأ؟
kamfanin,&gt;	شركة &amp; GT؛
da&#39;ira	دورة
ce&gt;	وGT.
wato	ال
madadin	بدلا من ذلك
Kardon	كاردون
codify	جمع القوانين و ينسقها
Sama.&quot;	. أعلاه على &amp; quot؛
??	؟؟
kusurwa)	الزاوية)
Watã	هلال
MacRae):&gt;&gt;&gt;	ماكراي): &amp; GT؛ &amp; GT؛ &amp; GT؛
mishap,	حادث مؤسف،
wahala?	صعوبة؟
prescient	عالم الغيب
dama,	عدة
?!	؟!
fassara	ترجمة
manufacturer	الشركة المصنعة
sa-saukar	وضعت أسفل
na&gt;	وGT.
dansa.	الابن.
Moon.	القمر.
tsohon	سابق
kimiyyar	علم
sabobin.	الملقمات.
kusan	تقريبا
Moon,	القمر،
daruruwan	مئات
Leong,	ليونغ،
dũka	إضراب
laifi-line	خط الصدع-
faranta	من فضلك
kuri&#39;a	الكثير
X11	X11
(LGV	(LGV
faranti	لوحات
wahala.	صعوبة.
Bure	تحميل مجاني
wahala,	صعوبة،
(Ken	(كين
For	ل
graphics	الرسومات
Erik	إريك
gt4417a@prism.gatech.EDU	html>
wasa	لعب
WNI	WNI
wasu	البعض
halicce	خلق
Fahrenheit)	فهرنهايت)
jita-jita	إشاعة
wata	ل
bishara	الإنجيل
tsoho,	افتراضيا،
hattara	احترس
motherships	motherships
Da	و
yoghurt	الزبادي
Glance	لمحة
bukatan	حاجة
labari	مقالة
ethane	الإيثان
4,850	4.850
aiki?	العمل؟
daidaitattun	معيار
bukatar	حاجة
&#39;taimako	مساعدة
E.	E.
aiki,	العملية،
Land,	الأرض،
DE	DE
jihar,	الدولة
Galatiyawa	غلاطية
(korenek@nmti.com)&gt;&gt;&gt;	(Korenek@nmti.com) وGT؛ &amp; GT؛ &amp; GT؛
aiki.	العمل.
DH	DH
shafukan	المواقع
jihar.	الدولة.
Ci	أكل
bisharar	الإنجيل
Bures&gt;	بوريش &amp; GT؛
California.	كاليفورنيا.
virus..It	virus..It
340	340
knowledgable	الاطلاع
Ta&#39;addanci)	الإرهاب)
manajoji	مدراء
Kiristanci	مسيحية
falsafa	فلسفة
fitilar	مصباح
GE	GE
Fe	الحديد
Wen-Cheng	ون تشنغ
outlaws	الخارجين عن القانون
babbar,	عظيم
Spaceflight	رحلات الفضاء
mutu-karshen	طريق مسدود
wadãta	ازدهار
handbooks	كتيبات
tẽkun.	المحيط.
kwaruruka,	الوديان،
tẽkun,	المحيط،
IO.	IO.
G.	G.
FM	FM
IO,	IO،
kanmu	أنفسنا
FI	FI
HG	HG
Place	مكان
mahadi	مركبات
Ga	إلى
samfurin.	المنتج.
&lt;C5t7Gs.7v3@news.iastate.edu&gt;	العلامة &amp; lt؛ C5t7Gs.7v3@news.iastate.edu&amp;gt.
Almasihu.&quot;	المسيح على &amp; quot؛
Incorporated	أدرجت
IP:	IP:
proportionally,	نسبيا،
763-2626	763-2626
Larabawa	عربي
teku	بحر
suKe	هم
mutane?&quot;	الناس ومثل؛؟
GP	GP
GO	GO
H.	H.
GM	GM
fata)	الجلد)
(Paul	(بول
recomendations	توصيات المؤتمر
oddball	غريب الاطوار
volts	فولت
Systems,	نظم،
itself_	itself_
jima&#39;i.	الجنس.
Secondaries	المرتبات الثانية
manufa	الهدف
hau	ركوب
5:17	05:17
jima&#39;i)	الجنس)
jusgement	jusgement
Oort	أورت
har	فوق
cruise	رحلة بحرية
&quot;Ɗan	على &amp; quot؛ دان
yaya	كيف
fafitikar	تكافح
Titan	عملاق
spirochetal,	ملتوياتي
Yadda	كيف
Johnson,&gt;	جونسون آند جي تي؛
1930,	1930،
yayi	العروض
A.	A.
======================================&gt;	====================================== وطن.
AT	AT
300	300
ɗan	ابن
rana-generated	ولدت الشمس
amfãni	فوائد
BA	BA
gabatarwar	مقدمة
30%	30٪
lokacin&gt;	عندما وGT.
III	III
AM	AM
B.	B.
Sweden	السويد
30,	30،
Hi,	مرحبا،
IMMMMMMMMMMMMMMMMMMMMMMMMMMMMMMMMMMMMMMMMMMMMMMMMMMMMMMMMMMM.	IMMMMMMMMMMMMMMMMMMMMMMMMMMMMMMMMMMMMMMMMMMMMMMMMMMMMMMMMMMM.
AN	AN
BV	BV
C:	C:
frame,	الإطار،
&lt;C5qsBF.IEK@ms.uky.edu&gt;	العلامة &amp; lt؛ C5qsBF.IEK@ms.uky.edu&amp;gt.
As	AS
Ba	ليس
CA	CA
ƙaunar	حب
BF	BF
aikin	عمل
BI	BI
Extraterrestrial	خارج الأرض
BC	BC
Ad	إعلان
wuce.	قبل.
An	ل
wuce,	منذ
(2,147	(2147
C,	C
C.	C.
Al	شركة
3.0	3.0
By	بواسطة
3.1	3.1
Eastwood	إيستوود
3.8	3.8
sarari	الفضاء
DB	DB
DA	و
yanzu	الآن
gabatarwa.	الترويج.
3.5	3.5
zai	سوف
&#39;Allah.&quot;	. &#39;الله على &amp; quot؛
Jovian	جوبيتري
zan	أنا
CD	القرص المضغوط
kanka	نفسك
D.	D.
dakin	غرفة
Ku	أنت
!!)	!!)
(Ibraniyawa	(عبرانيين
Assad	الأسد
IDE	IDE
!!!	!!!
M.	M.
haihuwa	قديم
Ko	أو
Twin	التوأم
hey	مهلا
(NASA	(NASA
cratered	متهالكة
gwiwa	تعاون
wuski	ويسكي
Leonard	ليونارد
LITTLE	LITTLE
ɗaure	مقيد
MD	MD
MB	MB
kõguna	الأنهار
kananan,	صغيرة،
da&gt;	وGT.
162,	162
reformatting	إعادة صياغة
yanayi.	شروط.
N.	N.
yanayi,	الشروط
Gilkey	Gilkey
keyboard,	لوحة المفاتيح،
SOSAI	DEEP
MS	MS
Me	لماذا
kirki.&quot;	. الخير ومثل؛
sandare	تكثف
NI	NI
bauta	عبادة
riverbeds	مجاري الأنهار
NA	NA
dlb@fanny.wash.inmet.com	html>
NE	NE
tef.	الشريط.
My	لي
Mu	نحن
Electronics,	الالكترونيات،
Homo	لوطي
---------------------------	---------------------------
Zai	سوف
NO	NO
Zan	أنا
&lt;ekdfc.14.0@ttacs1.ttu.edu&gt;,	العلامة &amp; lt؛ ekdfc.14.0@ttacs1.ttu.edu&amp;gt،،
P.	P.
(6,200	(6200
ON	ON
Ni	لي
amaryar	عروس
Ne	هل
(&quot;sararan	(على &amp; quot؛ السهول
Multi-da	متعددة
Na	أنا
zo,	تأتي،
farantin,	لوحة،
star	نجمة
P5	P5 +
OP	OP
yanayin	حالة
lei@rtsg.mot.com	html>
Ok	حسنا
On	في
(Wen-Cheng	(ون تشنغ
Oh	يا
sulfur	كبريت
musun	رفض
PA	السلطة الفلسطينية
PB	برميل
PC	PC
pseudo-	الزائفة
I,	I،
yanar-gizo.	الانترنت.
tsakiya,	الوسطى،
kirkiro	خلق
al&#39;amari	مسألة
Barringer	بارنجر
wucin	مؤقت
domin,	لأنه،
(idan	(إذا
Yankee	يانكي
jawabi	معالجة
meteor.	نيزك.
meteorites	النيازك
hit	ضرب
ID	الهوية
domin:	إلى:
IF	IF
II	II
nuet_ke@pts.mot.com	html>
Tom&gt;	توم &amp; GT؛
Hi	مرحبا
J.	J.
fatan	آمال
IN	IN
quack	الدجال
IO	IO
fatar	بشرة
IT	IT
canza	تغيير
dh782@cleveland.Freenet.Edu	html>
sitiriyo	ستيريو
Club.	النادي.
musu,	لهم،
PLEASE	PLEASE
ɗaukar	مع الأخذ
sana&#39;a	محترف
Hz	هرتز
Network	شبكة
EGALON)	EGALON)
Larabawa,	العربية،
&quot;),	على &amp; quot؛)،
gudu-na-da-niƙa&gt;	التشغيل للطاحونة &amp; GT؛
christian	مسيحي
In	أنا
taimake	مساعدة
flexing	الثناء
misinformation	معلومات خاطئة
volcanic	بركاني
taimaka	مساعدة
JT	JT
validating	التحقق من صحة
tsakiyar	وسط
meteorite.	نيزك.
meteors	الشهب
(Hamaza	(Hamaza
IBM	IBM
yayan.	المكونات.
taimako	مساعدة
st1ge@Elroy.UH.EDU	html>
Toyota	تويوتا
promiscuous	لاأخلاقي
(Joseph	(جوزيف
KO	OR
taswira	خريطة
L.	L.
jagoranci	الصمام
your	ك
bombardment	قصف
Hal	هال
ID.	ID.
Ka	أنت
Nereid	الناريدة واحدة من حوريات البحر
LH	LH
1938,	عام 1938،
Kimiyya	علم
Har	فوق
ƙunci	أجمة
FROMTHEDEAD:	FROMTHEDEAD:
Afirka	أفريقيا
haskakawa,	يضيء،
swirl	دوامة
stephen.guerke@mvs.udel.edu~~V	stephen.guerke@mvs.udel.edu
&lt;C5w5CB.Ct4@rahul.net&gt;,	العلامة &amp; lt؛ C5w5CB.Ct4@rahul.net&amp;gt،،
VL	VL
W.	W.
juya	منعطف
yayata	تأمل
jagoran	زعيم
Lebannon.	Lebannon.
&quot;Ga	على &amp; quot؛ لل
ashin	عنوان
hotunan	الصور
diferential	diferential
Yesu&quot;.	يسوع ومثل؛
kasuwanci.	الأعمال.
almajiri	تلميذ
To	ثم
wasanni	الرياضة
shigar	مساهمة
Ta	بواسطة
abokiyar	شريك
&quot;Bã	على &amp; quot؛ هم
TX	TX
TV	التلفزيون
Su	إلى
Kundin	مجلدات
wnk@aquifer.geology.uiuc.edu	html>
waɗannan	هؤلاء
XT	المقاعد
inconsistency	تضارب
dogara	ثقة
Norton	نورتون
Landmann	Landmann
hotuna.	الصور.
low&gt;	منخفض &amp; GT؛
(Fir)	(المحمولة)
canja	تغيير
canji	تغيير
Larabawa?	عرب؟
gogayya	احتكاك
------------------------	------------------------
Jun&#39;ichiro	Jun&#39;ichiro
dogaro	عرضة
gabatar.	العرض.
Larabawa.	عرب.
tubalan	كتل
Mene	ما
Open	فتح
Sysops)	عمال النظام)
wuce	منذ
shari&#39;a,	القانونية،
mutane&#39;	الناس
Pathfinder&gt;&gt;&gt;	باثفايندر &amp; GT؛ &amp; GT؛ &amp; GT؛
S.	S.
Yakubu&#39;?	يعقوب؟
Gun	بندقية
Lahadi	يوم الأحد
Saita	تعيين
Folta)	Folta)
sarari.	الفضاء.
haramun	حرام
Guy	شخص
&quot;wucin	على &amp; quot؛ إعلان
kimiya	علم
(daban-daban),	(متنوع)
dacewa	لياقة بدنية
R.	R.
alin@nyx.cs.du.edu	html>
al&#39;amarin	حالة
(1.5-mil)	(1.5 ميل)
rundunar	مضيف
ka&#39;idodinta	مبادئ
mãsu	هي
ka&#39;idojin	نظري
yancin	حق
lemu.	البرتقال.
Bayahude	اليهودي
kwari.	البق.
kirki&quot;	جيدة ومثل؛
ganewar	تعقيد
TO	TO
juyin	ثورة
makãmashin	وقود
sararin	الفضاء
SS	SS
hawaye	دموع
surface,	السطح،
tattali	أعدت
Chin	ذقن
TA	TA
T)	T)
mutunci.	النزاهة.
SI	SI
surface.	السطح.
liscened	liscened
-120	-120
&quot;bindiga	على &amp; quot؛ بندقية
RR	RR
DH-kamar	DH-مثل
ka&#39;idoji.	اللوائح.
ma&#39;aunan	أرصدة
gwaje-gwajen,	التجارب،
fatally	على نحو مهلك
Sarkar.	السلسلة.
///////	///////
al&#39;amari:	المسألة:
franjion@spot.colorado.edu	html>
SA	SA
Driver&gt;	سائق &amp; GT؛
Bayahude,	يهودي،
&quot;alamar	على &amp; quot؛ علامة
Yã	O
​​daga	من
za,	،
Refayawa.	عمالقة.
site,	موقع،
(Etan	(إيثان
N3JXP	N3JXP
ruwa-ruwa	مائي
Sale	بيع
planetary	كوكبي
^)	^)
Severy	سيفيري
waving	التلويح
\\	\\
argon	الأرجون
CONFIG.SYS	CONFIG.SYS
=============================================	=============================================
Sam.	سام.
zuwa&gt;	وGT.
Saki	إطلاق
geyser-kamar	مثل السخان
unsympathetic	غير متعاطف
zabi&gt;	اختيار &amp; GT؛
mutãne	الناس
Sake	ثانية
jure	مقاومة
&#39;madawwama	&quot;أبد
a,	،
a.	أ.
__	__
block	كتلة
&#39;haƙiƙa	&quot;بالتأكيد
a!	في!
rayuwa	حياة
izinin	إذن
ekweita	خط الاستواء
MouseWare	MouseWare
dbernard@clesun.Central.Sun.COM	html>
Oktoba	تشرين الأول
.signature.	.signature.
Hutchison&quot;	هوتشيسون ومثل؛
cikinsu	منهم
talauci	فقر
aiko.	أرسلت.
ainihi	حقيقي
r&gt;	R &amp; GT؛
[2]	[2]
^^	^^
Yahaya	جون
Bayani	حل
umurni	عرض
gun	بندقية
3-8),&gt;	3-8)، وGT.
Press	صحافة
ZA	WILL
wuta.	النار.
-183	-183
binciko,	استكشاف،
382	382
halittu	العالم
Ya	إلى
game,	حول
Renaissance,	النهضة،
tarihi	تاريخ
littafin	كتاب
Renaissance.	النهضة.
Bincike	بحث
Yi	فعل
tattare	يقرر
tattara	جمع
-179	-179
dukkan,	كل
halitta	خلق
sabawa.	التعديلات.
kanta	نفسه
tsautsayi	المنضب
catagories	فئات *
Lokacin	مرة
Italiya,	إيطاليا،
(Douglas	(دوغلاس
yankinka,	المنطقة
375	375
YI	DO
saki)	الإفراج)
Shin&gt;	هل وGT.
dala}!	$!
juna	آخر
craters.	الحفر.
sosai	جدا
remnants	بقايا
kansa	نفسه
Masters	الماجستير
sake,	مرة أخرى،
[a	[
Nanaimo,	نانايمو،
magoya	المشجعين
360	360
Uranus.	أورانوس.
Uranus,	أورانوس،
rantsuwa,	من قبل،
Dogarin	ADC
Sũ	هم
kansu	أنفسهم
Isra&#39;ila.	إسرائيل.
karbar	المتلقي
zurfin	عمق
HRB	HRB
biliyan	مليار
Samo	وجدت
Za	سوف
Sams	سامس
apriori.	APRIORI.
&quot;quack&quot;	على &amp; quot؛ الدجال ومثل؛
Chris	كريس
\)	\)
mummunan	سلبي
\.	\.
¡iyãma	حكم
ga&gt;	وGT.
abyss	هاوية
YESU	JESUS
48?)	48؟)
K1Y	K1Y
jefa	رمي
Land	أرض
al&#39;adar	عرف
Tsaya	واقف
tsallake	تخطى
(nan	(
ga	إلى
&lt;1qksc2$2mr@fido.asd.sgi.com&gt;	العلامة &amp; lt؛ 1qksc2$2mr@fido.asd.sgi.com&amp;gt.
bisexual	المخنثين
bikin	احتفال
rayuwa,	الحياة،
bã	ليس
IRIN	نوع
JPL	JPL
fi	أكثر
rayuwa.	الحياة.
zafi-livered	الساخن livered
bangaskiya	إيمان
Paul	بول
Iraki?	العراق؟
203	203
bulala	سوط
200	200
koyar	علم
201	201
20:	20:
dã	كان
Serbian	صربي
mutane	الناس
ita.	لها.
Dutsen	جبل
SLEGGE@kean.ucs.munc.ca	html>
rahotannin.	التقارير.
Yin	إلى
20%	20٪
wutar	حريق
kyamarori	كاميرات
tsarkake	تطهير
miliyoyin	الملايين
cikinku	أنت
20-	20-
idan	إذا
20,	20،
zaunanniya	دائم
Uba,	الأب،
Uba.	الأب.
Beta	بيتا
yiwuwa	ربما
Rantsuwa	بواسطة
ra&#39;ayoyin	الآراء
&quot;...	على &amp; quot؛ ...
recklessly	بتهور
akwai	هناك
thrusters	الدفاعات
facade?	الواجهة؟
ailin	Aili
&quot;nasan	على &amp; quot؛ أنا أعرف
Banks	البنوك
key&quot;	مفتاح ومثل؛
21)	21)
rayuwar	حياة
Iftccu:	Iftccu:
21,	21،
tacky,	مبتذل،
Hanyar	من خلال
look	نظرة
ĩmãni,	إيمان
su).	).
ĩmãni.	نعتقد.
Ina	أنا
delusional&gt;	الوهمية وGT.
Advanced	المتقدم
gagarumin	هام
(UNT-Tech	(الاتحاد الوطني للعمال التكنولوجيا
matar,	زوجة،
bãya	إلى الوراء
Apollo	أبولو
2,300	2300
en	EN
murna	بهجة
Fraering)	Fraering)
jadawalin.	الجدول الزمني.
(babu	(لا يوجد
nassoshi	المراجع
vuya,	يختفي،
by	بواسطة
Lantz)	انتس)
(Dostoevsky)	(دوستويفسكي)
d,	د،
Yuni	حزيران
jikin	هيئة
(62-mile)	(62 ميل)
etching	النقش
(objectivity,	(الموضوعية،
bi	تابع
idanu	عيون
talakawa,	الفقراء،
1610,	1610،
da	و
talakawa.	العاديين.
Teemu	احتشد
ya?	؟
&quot;haƙiƙa&quot;	على &amp; quot؛ الهدف ومثل؛
(Shin,	(هل ل
fassarar	ترجمة
talakawa:	عادي:
(da&gt;	(&amp; طن.
wuri	موقع
ci	أكل
ya.	.
ce	قال
&#39;mai	&#39;
ya,	،
blank&quot;.	فارغة ومثل؛
XT350	XT350
ab245@cleveland.Freenet.Edu	html>
Ihu	زمارة
Jama&#39;a	جمهور
batutuwa	الموضوعات
statistics	إحصائيات
geb@cs.pitt.edu	html>
cibiyoyin	مراكز
magana	خطاب
falaki	علماء الفلك
ice	جليد
sace	مسروق
mataki	عمل
ƙananan	أدنى
``	``
halittu,	العالم
magani	علاج
Yuli	تموز
Azancin	منطقيا
talakawan	متوسط
&quot;mayar	على &amp; quot؛ العودة
wuta	حريق
ba	ليس
tattalin	أعدت
at	في
saba	معتاد
ido	عين
transfering	بنقلها
Law,	القانون،
c:	ج:
National	مواطن
franjion@spot.Colorado.EDU	html>
ƙaryata	رفض
memory	ذاكرة
zalunta	معالجة
c.	ج.
JKN	JKN
Tarho	هاتف
ai	منظمة العفو الدولية
yau	اليوم
yar	ابنة
Janairu,	يناير،
A&#39;a,	لا،
an	ل
yan	الصورة
[1]	[1]
annabce-annabce	نبوءات
bijirar	فضح
realy	حقا
manufa!	استهداف!
Cadillac&quot;	كاديلاك ومثل؛
California	كاليفورنيا
da&#39;awar	مطالبة
of	من
manufa.	الهدف.
tsĩrar	تسليم
mayar	عودة
on	في
manufa,	الهدف،
batun	قضية
schuster@panix.com	html>
Wannan	هذا
yafi	أكثر
texts	النصوص
jinkirin	بطيء
wuccin	عرضي
dutse-sized	الجبلية الحجم
Bilatus	بيلاطس
Lippard)	Lippard)
kõ	أو
ni),	I)،
gyare-gyare,	إصلاحات،
Jiki	هيئة
pe	المؤسسة العامة
&quot;Na	على &amp; quot؛
pc	كمبيوتر
pl	رر
fledged	العضوية
amps,	الامبير،
pm	مساء
amps.	أمبير.
comment	تعليق
tashoshin,	محطات،
radiation	إشعاع
Member	الأعضاء
psyrobtw@ubvmsb.cc.buffalo.edu	html>
Yan	يان
dos.	دوس.
myselfe	myselfe
jiki.	الجسم.
meteor	نيزك
yadu	على نحو واسع
Yau	اليوم
batu:	نقطة:
daji,	البرية،
&quot;Ni	على &amp; quot؛ I
Yar	ابنة
novices	المبتدئين
manufar	هدف
yada	انتشار
sinusitis	إلتهاب الجيب
ma	أيضا
mb	ميغابايت
jiki,	الجسم،
uku.	ثلاثة.
duniya-sized	الحجم العالم
ƙulli,&gt;&gt;	إغلاق &amp; GT؛ &amp; GT؛
me	لماذا
Ditto.	كما سبق.
batu,	نقطة،
ido,	العين،
Messier	مسير
46904	46904
shipper	شاحن
ms	مرض التصلب العصبي المتعدد
mu	نحن
inning	الشوط
garwaya	متشابكة
&quot;kammala&quot;	على &amp; quot؛ كاملة ومثل؛
tawada	حبر
na	أنا
ne	غير
tafiya	سفر
ni	لي
p.	ص.
makamai,	أسلحة،
Fahrenheit),	فهرنهايت)،
ra&#39;ayin	فكرة
nagarta	خير
waɗannan,	هذه،
Fahrenheit).	فهرنهايت).
Orbiters	المدارية
yabo	مدح
wuka	سكين
mock@watt.support.Corp.Sun.COM	html>
P.S.	سكرتير خاص
doke	فاز
motoci	السيارات
doka	القانون
kama,	مثل،
XQueryTree	XQueryTree
m,	الجراحية،
Corollas,	التويج،
ki	كي
yi)	)
ni.)	لي).
ke	إلى
yi.	.
ina	أنا
yi,	،
ka	أنت
Kimanin	حول
Bressler)	Bressler)
Urushalima	القدس
ku	أنت
yi?	؟
ko	أو
m.	م.
gida	منزل
Rubenfeld)	Rubenfeld)
sako-sako	فضفاض
tsaunuka	المرتفعات
&quot;cantaloupe&quot;	على &amp; quot؛ الشمام ومثل؛
low.	منخفضة.
&quot;mai	على &amp; quot؛
murmurs	لغط
Baftisma	معمودية
kamar	كما
iko	قوة
===========	===========
catastrophic	فاجع
Orbiter,	المسبار،
ra&#39;ayi.	الرأي.
tsammani.	كان متوقعا.
Orbiter.	المتتبع.
da&#39;	&#39;
hi	مرحبا
&gt;&gt;&gt;?	وطن؛ &amp; GT؛ &amp; GT؛؟
alt.psychology.personality!	alt.psychology.personality!
shafi.	الصفحة.
Dukan	كل
amounted	بلغت
ila	رابطة القانون الدولي
ra&#39;ayi:	الرأي:
yin	إلى
matasa	شاب
ra&#39;ayi?	الرأي؟
daga&quot;	من ومثل؛
livesey@solntze.wpd.sgi.com	html>
Xelion	Xelion
rauser@sfu.ca	html>
puck	عفريت
____	____
tsoho	الافتراضي
&quot;Ka	على &amp; quot؛
kida.	الموسيقى.
down.	إلى أسفل.
disclaimer]	تنصل
Kasashen	الدول
dole	يجب
in	في
je	اذهب
disclaimers	إبراء الذمة
blue	أزرق
ji	سمع
kallon	مشاهدة
daftarin	مسودة
jinginar,	تعهد،
ja	أحمر
warkarwa	شفاء
COEGALON@LARC.NASA.GOV	html>
Sharma)	شارما)
&lt;imani	العلامة &amp; lt؛ الإيمان
&quot;yarda&quot;	على &amp; quot؛ سمح &amp; مثل؛
al&#39;adu.	الثقافة.
YYY	YYY
xt	المقاعد
Tambayata	مسألة
mazauni	مقعد
Trondheim	تروندهايم
&#39;yana	&#39;
Powerbook	بووربووك
Schaufenbuel	Schaufenbuel
bading@cs.tu-	bading@cs.tu-
vv	VV
upperleft	upperleft
&quot;Zan	على &amp; quot؛ I
ɗauka	اتخذت
wa	إلى
ɗauke	حمل
sunana,	اسمي،
Lantz	انتس
nodrog@hardy.u.washington.edu	html>
&lt;C4Hyou.1Iz@mentor.cc.purdue.edu&gt;	العلامة &amp; lt؛ C4Hyou.1Iz@mentor.cc.purdue.edu&amp;gt.
Pull	سحب
vs	مباراة
malaman	معلمون
inshora	تأمين
airlift	النقل الجوي
cẽwa,	ذلك،
jima&#39;i&quot;.	الجنس ومثل؛
Kira	المكالمات
iska	هواء
kaɗawa&#39;	موجة &quot;
(James	(جيمس
11-15,	11-15،
yana	غير
kasancewar	وجود
(huluna,	(قبعات،
matrix	قالب
mũ	نحن
deportes	ديبورتيس
Kinsley	كينسلي
sassa,	أجزاء،
up	فوق
rethorical.	rethorical.
dabbobi?	الحيوانات؟
part	جزء
&quot;Minnesota	على &amp; quot؛ مينيسوتا
nĩ	أنا
to	إلى
v.	ضد
ISA.	ISA.
(bari	(ول
des,	قصر
Kefas,	سيفاس
roƙonka	من فضلك
ISA)	ISA)
(Marcus	(ماركوس
des)	قصر)
gaskiya,	في الواقع،
pre-amp&gt;	قبل أمبير &amp; GT؛
te	الشركة المصرية للاتصالات
yake	غير
gaskiya.	صحيح.
crustal	القشرة الأرضية
gaskiya)	الحقيقة)
yaki	عراك
ta	بواسطة
su	إلى
markings	علامات
sakewa	إلغاء
maza,	الرجال،
asiri	سر
sm	SM
maza.	الرجال.
kaifin	ذكي
Delaware,	ديلاوير،
so	الوصايا
hte	إيرباص
mahara	مضاعف
Texas	تكساس
canji.	تغيير.
zurfi	عميق
brenner@ldgo.columbia.edu	html>
sa	ماركات
labarai.	الأخبار.
gano,	تحديد،
gano.	التي تم تحديدها.
fashe	مشقوق
nã	أنا
&#39;Yan	ال
watanni	أشهر
kwashe	تقليد
Nereid,	نيريد،
powerbook	بووربووك
Krista	CHRISTIAN
System	نظام
&quot;da	على &amp; quot؛
Kristi	يسوع المسيح
gasar.	المنافسة.
mirgina	لف
-221	-221
flocking	يتدفقون
bressler@iftccu.ca.boeing.com	html>
mikawa	إطالة
bridgehead	رأس الجسر
birane,	مدن،
iko&quot;&gt;	التحكم ومثل؛ &amp; GT؛
bukatun	متطلبات
&#39;&#39;	&#39;&#39;
Banks)	البنوك)
octagonal	مثمن ذو تماني زوايا و أضلاع
sarƙoƙi,	سلاسل،
Arewa&quot;	شمال ومثل؛
sakonni	رسائل
Ayyukan	الأنشطة
orbiting	تدور
tilasta	قسري
silicate	السليكات
280	280
rahoton	تقرير
Brooks)	بروكس)
Arab	عربي
yawo	لقطات
Janairu	يناير
bãbu	لا
28:	28:
gani,	رؤية
yayatawa	يشاع
mutãnen	الناس
amsa:&gt;	الإجابة: &amp; GT؛
&quot;Bure&quot;	على &amp; quot؛ مكتب ومثل؛
yawa	كثير
27,	27،
NHL.	NHL.
koguna	الأنهار
kabilar	قبيلة
engp2008@nusunix.nus.sg	html>
winfrvk@dutiws.twi.tudelft.nl	html>
bindiga	بندقية
40-22k	40-22k
willisw@willisw.ENG.CLEMSON.edu	html>
Systems	أنظمة
sneakers	أحذية رياضية
&quot;Yã	على &amp; quot؛ O
fitina)	محاكمة)
propter	propter
hitter	ضاربا
583.	583.
Egalon	Egalon
azumi-motsi	سريع الحركة
zã	سوف
drum-dimbin	طبل على شكل
&quot;Mene	على &amp; quot؛ ما
zanga-TRUST	ANTI-TRUST
abubuwa	البنود
ganin	رؤية
gina	بناء
shahara	مشهور
Watts	واتس
gini	بناء
karatu,	القراءة،
hadin	تعاون
Bulus:	بولس:
29,	29،
hanyar	من خلال
logo	الشعار
&lt;BADING.93Apr23105229@athene.cs.tu-berlin.de&gt;	العلامة &amp; lt؛ BADING.93Apr23105229@athene.cs.tu-berlin.de&amp;gt.
talk.politics.guns	talk.politics.guns
ƙungiyoyin!	المجموعات!
leveling	التسوية
City	مدينة
(memory	(الذاكرة
wuya	من الصعب
darajõji,	درجات
Jerin	لائحة
sanda.	قضيب.
&quot;a,	على &amp; quot؛
pubinfo.jpl.nasa.gov	html>
katantanwa	حلزون
fitina.	محاكمة.
shahararren	بارز
wa&#39;adin	وعد
Qarshen	نهاية
24,	24،
gani&gt;	رؤية و GT.
caltech.edu	html>
falalarSa	سخاء
240	240
lankwasa	ثني
haƙĩƙa,	في الواقع،
little	القليل
gist	جوهر
safiya,	الصباح،
malami.	المعلم.
Journal	مجلة
raunata	جريح
yau.	اليوم.
243	243
Ming)	مينغ)
Prescribing	وصف
Hays)	هايز)
(5.25	(5.25
perpetuate	تديم
kalmar	كلمة
hanya:	الطريقة:
yau,	اليوم،
hanya.	الطريقة.
&quot;mafi	على &amp; quot؛ أكثر
juyawa	تناوب
24-bit	24-بت
hanya,	الطريقة،
likitoci,	الأطباء،
Shopper)	المتسوق)
ISA	ISA
ummiyan	مشرك
yaro	صبي
sũ	هم
kludgy	kludgy
&lt;basu	العلامة &amp; lt؛ لا
ze	مباراة
yara	الأطفال
Bloom	إزهار
za	سوف
taimakawa	مساعدة
&quot;MAGIC&quot;&gt;&gt;	على &amp; quot؛ &amp; MAGIC مثل؛ &amp; GT؛ &amp; GT؛
Japan&gt;	اليابان &amp; GT؛
(Walter	(والتر
zo	جاء
250	250
(Henling,	(Henling
J23	J23
farantin	لوحة
25,	25،
ya	إلى
*****	*****
mutãne,	الناس،
(mai	(
kalma,	كلمة،
Winding.	متعرج.
rufaffen	مشفرة
[&quot;Mutanen	[&amp; قووت]؛ الناس
White	أبيض
wannan	هذا
dukansu,	كل
berlin.de	html>
&lt;1r0vk6INNaft@cronkite.Central.Sun.COM&gt;	العلامة &amp; lt؛ 1r0vk6INNaft@cronkite.Central.Sun.COM&amp;gt.
yi	فعل
Brenner	برينر
GetGeometry	GetGeometry
kõme.	لا شيء.
Iaccoca	Iaccoca
Shopper	المتسوق
muhimmancin	خطورة
kore	أخضر
Matrix	قالب
mafi	أكثر
sakamako&quot;	تأثير ومثل؛
&#39;Ba	&#39;لا يوجد
jagororin	المبادئ التوجيهية
Mitsubishi	ميتسوبيشي
**************	**************
amatuer	الهواة
smudges	اللطخات
(Phil	(فيل
Spot,	بقعة،
comic	كوميدي
Pathfinder	مستكشف
kisan	قتل
hydrogen,	الهيدروجين،
hydrogen.	الهيدروجين.
Hiroki	هيروكي
sunan&gt;	اسم &amp; GT؛
App	التطبيق
Hard	من الصعب
Apr	أبريل
Sport	رياضة
shawarar	موصى به
kamfanin,	شركة،
guntu.	رقاقة.
Tsarki-masoya	عشاق نقية
saran	متوقع
tabbas,	ربما،
PowerBook)?	بووربووك)؟
&lt;1993Apr20.102756.1709@mala.bc.ca&gt;,	العلامة &amp; lt؛ 1993Apr20.102756.1709@mala.bc.ca&amp;gt،،
Turai	أوروبا
xa&#39;a	أخلاق
Stony	حجري
fara,	بدء،
floppy..BURN	floppy..BURN
shawara:	النصيحة:
(watau,	(أي،
Weiss	فايس
shawara,	المشورة،
hallaka	دمرت
filin,	الحقل،
developer	المطور
hall@boi.hp.com	html>
91%	91٪
pharvey@quack.kfu.com	html>
fi.	أكثر من ذلك.
fi,	أكثر
shawara.	المشورة.
kona	احتراق
fastball	الكرة السريعة
lippard@skyblu.ccit.arizona.edu	html>
(kusan)	(تقريبا)
Zbib)	زبيب)
2000,	2000
ƙiyayya	كراهية
ƙayyadaddu	تفاصيل
(GIF,	(GIF،
jawo	رسم
Brian	بريان
halitta.	بإنشائه.
iyakar	الحدود
sirri-kwamfuta	الحواسيب الشخصية
Hawk	صقر
na&#39;ura	جهاز
lamba:	الاتصال:
North	شمال
walƙiya	صاعقة
Amurka&quot;	US &amp; مثل؛
maki	نقاط
mazan	كبار السن
abada,	من أي وقت مضى،
fax	فاكس
Posting	المشاركة
lambar	عدد
luck	حظ
far	علاج
mako	أسبوع
fan	مروحة
974	974
Summary	ملخص
jihar	دولة
cututtuka.	الأمراض.
maka	أنت
(872	(872
duniya	عالم
Store	مخزن
PROOFOF::::	PROOFOF ::::
tashin	الأعمال العدائية
banschbach	banschbach
Amerika	أمريكا الشمالية
johnson)	جونسون)
atomic	الذري
thread,	موضوع،
mags	مجلات
halittar	خلق
Sun	هم
Bayahude&quot;	يهودي ومثل؛
(842	(842
Sharuddan	حيث
mail	بريد
140.	140.
Toronto,	تورونتو،
lamba.	العدد.
main	رئيسي
Nissan	نيسان
Europa	أوروبا
pre-amp	قبل أمبير
billq@ms.uky.edu	html>
KASANCE	HAD
Uban.	الأب.
akwatin	صندوق
Haka	هكذا
Shadow	ظل
farauta	الصيد
Kanun	العنوان
zaba	مختار
jihohi	الدول
zabe	استطلاع
664-6354	664-6354
zabi	مختار
meteorology	الأرصاد الجوية
ba&gt;	وGT.
-This	، هذا
fuskantarwa	توجيه
Fiction	خيال
echoed	وردد
Kwakwalwan	رقائق
iyaka.	الحد.
#From	#From
tururi.	البخار.
========	========
idanuna.	العينين.
ƙwarai	جدا
Brothers	الاخوة
Intanit:	الإنترنت:
frank@D012S658.uucp	frank@D012S658.uucp
core-zafin	الأساسية درجات الحرارة
DMA.	الحق.
as-ne	كما هو
Krsek)	Krsek)
Uranus	أورانوس
Halo	هالة
Hutchison	هوتشيسون
yanar-gizo	الإنترنت
kalma	كلمة
Bukata	مطلوب
Venus	فينوس
kuskure?	خطأ؟
1959,	1959،
9:31	09:31
Noring	Noring
ƙãre,	استنفدت،
alhẽri).	جيد).
kuskure,	خطأ،
kuskure.	خطأ.
boye-boye&gt;	التشفير &amp; GT؛
kalla	الأقل
O&#39;Dwyer)	أو دواير)
&quot;nameplates.&quot;	على &amp; quot؛ لوحات تحمل أسماء على &amp; quot؛
Sauran	البعض
=========================	=========================
kowa	كل شخص
1958,	1958،
lambobi	اتصالات
Jihar	دولة
rarrabe,	مميزة،
kallo	أبحث
forming	تشكيل
mace	امرأة
Hans	هانز
Boston?	بوسطن؟
sukar	النقاد
gafarta	غفر
uu.net	html>
koyarwar&gt;	تعليم و GT.
Na&#39;am	نعم
_CRAZY_?	_CRAZY_؟
Ban	أنا
dabaru,	التقنيات،
dabaru.	التقنيات.
Disclaimer!	تنويه!
&quot;babur,&quot;	على &amp; quot؛ دراجة نارية، ومثل؛
&quot;Terminator&quot;,	على &amp; quot؛ فاصل ومثل،،
94550	94550
jingina	أمن
Frmwrks	Frmwrks
Glance&quot;	وهلة ومثل؛
Kida	موسيقى
Babbar	عظيم
&quot;healers&quot;	على &amp; quot؛ المعالجين ومثل؛
rippled	متموج
haihuwarka	الدوائر
diagnoses?	التشخيص؟
Galileo	غاليليو
(317)	(317)
Galilei	غاليلي
koya	تعلم
[namiji]	[ذكر]
Disclaimer?	إخلاء المسئولية؟
Knowles&quot;	نولز ومثل؛
David.	ديفيد.
airless,	الرش،
koyi	تعلم
koyo	تعلم
Babban	عظيم
aberrant	شاذ
&#39;shaida&#39;.	&quot;الشاهد&quot;.
Statistics	إحصائيات
punjabi@leland.Stanford.EDU	html>
binciken:	دراسة:
miliyan	مليون
haske,	ضوء،
sharhi	تعليق
haske.	ضوء.
jita-jita.	الأطباق.
binciken.	الدراسة.
09:02:48	09:02:48
Yamakawa,	ياماكاوا،
alkawuran&gt;	وعود &amp; GT؛
Gwada	اختبار
&lt;Wannan	واللفتنانت؛ هذا
sauƙi	سهل
ashirin	عشرون
Clayton	كلايتون
filayen.	الحقول.
rediyoaktif	المشعة
SuperVGA	SuperVGA
hypersensitivity	فرط الحساسية
Koyi.	تعلم.
roth)	روث)
Isra&#39;ila	إسرائيل
somwhere,	سمور
Abu	أبو
wuya,)	صعوبة)
Shi	هو
Malaspina	مالاسبينا
Ibraniyawa],	العبرانيين]
ziyara	زيارة
V-Mail:	V الإلكتروني:
hasken	ضوء
&quot;fararen	على &amp; quot؛ الأبيض
style,	النمط،
ya&gt;	وGT.
dabara,	تقنية،
comparatively	نسبيا
e_mail:	e_mail:
Craig	كريغ
m-magana	م كلمة
gamuwa	لقاء
ambata.	الذكر.
Sir	سيدي
marubucin	الكاتب
tidal	متعلق بالمد والجزر
mulki,	السلطة،
vms.	VMS.
--------------------	--------------------
mata	نساء
BIOS	BIOS
darn,	الرتق،
rayuwarsu,	حياة
zama	يكون
bindiga-kulob	بندقية النادي
Bitrus&gt;	بيتر &amp; GT؛
AMINCI	الموثوقية
THE	THE
(daga	(من
salla.	الصلاة.
(Chris	(كريس
memba	الأعضاء
faru,	الأحداث
dski.	يشفق.
kewayon	نطاق
inji	آلات
orange	البرتقالي
photocell	ضوئية
zafi	حار
mahallin	السياق
outposts.	البؤر الاستيطانية.
sabon,	جديد،
sci.med	sci.med
(Darryl	(داريل
mulkin	حكم
Kammalawa	اختتام
vfintd.386	vfintd.386
Zaka	أنت
maza	الرجال
Macworld	مكوورلد
Bitnet	البتنت
faɗi.	على نطاق واسع.
Denning	دينينغ
overriding	تجاوز
&#39;::	::
maye	بديل
wispy	ناعم
devide	devide
tsakaninka	بين
share,	حذف،
----------------------------------------------	----------------------------------------------
manyan,	عموما،
faru?	حدث؟
warware,	حل،
kowace	كل
misalai.	الأمثلة.
sys.ini	sys.ini
pro-gun	الموالية للبندقية
direbobi,	السائقين،
dare.	الليل.
misalai,	الأمثلة،
cikasa	كامل
wancan	أن
kewaye.	حولها.
Sanin:	أعرف:
Richard	ريتشارد
TTL	TTL
info	المعلومات
St.	شارع
:-)	:-)
falakin	علماء الفلك
kabarin	قبر
boasted	تفاخر
fari,	أبيض
Muhimman	مهم
janareto	مولدات
kalamai&gt;	البيانات وGT.
en,	أون،
mani	لي
sharri	سيئة
bincike	بحث
mana	لنا
oak.oakland.edu:pub/msdos/windows3/winjp210.zip	html>
Air	هواء
Shaidar	الشاهد
zai&gt;	وGT.
bincika	بحث
kewayawa	ملاحة
sauransu)	الخ)
tashi.	الارتفاع.
bayãnin	المميزة
agaji	معونة
Cuesta	كويستا
Activity	نشاط
bayyanar,	المظهر،
dogon	طويل
Gaskiya	حقيقة
C.)	C.)
Dodson)	دودسون)
binciko	استكشاف
amsar.	الإجابة.
translation	ترجمة
daren	ليل
jari	الأوراق المالية
star,	نجوم،
star.	نجوم.
aikatãwa.	القيام به.
kome	لا شيء
fallacious	مخادع
koma	عودة
&#39;NF&#39;	&#39;NF&#39;
zasu	سوف
Koyar	تدريس
shawarwari.	التوصيات.
zaunar	نزل
farin	أبيض
&lt;188@ky3b.UUCP&gt;	العلامة &amp; lt؛ 188@ky3b.UUCP&amp;gt.
BMP	BMP
TSC	TSC
zato	نزوة
Tidal	متعلق بالمد والجزر
son&gt;	الحب &amp; GT؛
Giotto	جيوتو
Heights	مرتفعات
tsiro	ينمو
gidansa,	منزل
volcanoes	البراكين
freeware.	مجانية.
(akwai	(وهناك
bangare	جزء
rayuwata,	الحياة،
amfani.	استخدام.
Barton)	بارتون)
farka	استيقظ
zane	تصميم
daraja	ثلمة
dabaran	عجلة
amfani,	استخدام،
zana	رسم
masa	له
tsira	نجا
All	كل
masu	ال
zamu	نحن
parody	باروديا
farko	أولا
maso	الجنوب الشرقي
Ami	عامي
Formats,	الأشكال،
Formats.	الأشكال.
Genie:	الجني:
high-gudun	عالية السرعة
kowane	كل
rijista	تسجيل
saboda	ل
rafke	حطم
E-mail	البريد الإلكتروني
Davis)	ديفيس)
wanzuwa?	دائم؟
Crash	تحطم
Nice	لطيف
ka&#39;idar	نظرية
shipping).	الشحن).
zargin	الرسوم
C2.	C2.
Sol	محلول
Ana	هل
transistor?	الترانزستور؟
kofa	باب
1-301-340-4543	1-301-340-4543
gyara	إصلاح
amfanin	فوائد
kewayen	حول
().	().
resistive	مقاوم
likita&gt;&gt;	الطبية وGT؛ &amp; GT؛
lokaci	مرة
Alane	Alane
inda	حيث
(10-105	(10-105
fili&gt;	مجمع &amp; GT؛
cikas,	العقبات،
dukkan	كل
&gt;&gt;,	وطن؛ &amp; GT؛،
Road	طريق
kogi	نهر
Delaware	ديلاوير
samaniya	سماوي
&#39;ya&#39;yan	الأطفال
Finland	فنلندا
email:	البريد الإلكتروني:
755-8742	755-8742
tashar	محطة
email.	البريد الإلكتروني.
&gt;&gt;?	وطن؛ &amp; GT؛؟
Galant,	جالانت،
1970s.	1970s.
da-tsare	والبرامج
Layer	طبقة
&#39;girgije	&quot;الغيوم
cover,	غطاء،
wanzuwar	وجود
jmilhoan@magnus.acs.ohio-state.edu	html>
Tsarki,	نقية،
Madogararsa	مصدر
bijiro	حوادث
gt7469a@prism.gatech.edu	html>
mutu.	توفي.
1312	1312
fararen	أبيض
mutu,	يموت،
kimiyya	علم
altitudes.	الارتفاعات.
mutãnensa	عائلة
Attaura&quot;	القانون ومثل؛
thyroid	درقي
1949.	1949.
Buy	شراء
(zuwa	(
high&gt;	ارتفاع &amp; GT؛
Juliet.	جولييت.
fito	خارج
kyau&#39;	جيد &quot;
Replay	إعادة
(6)	(6)
Jami&#39;ar	الجامعة
shakka,	وبطبيعة الحال،
fita	خارج
(59	(59
arcs	أقواس
1948:	1948:
Adaptec	ADAPTEC
musamman,	خاصة،
shirts,	قمصان،
8.6	8.6
THERMOCOUPLE	المزدوجة الحرارية
gif	GIF
1948,	1948
shekara-dogon	لمدة عام
arab	عربي
(5)	(5)
jiya,	يوم أمس،
gamuwa,	اجتماعات،
Umbriel,	Umbriel
mutum	رجل
jarrabawa	فحص
tasiri	فعال
Amirka,	أمريكي
.com&gt;	الأسود &amp; GT؛
Asteroids	الكويكبات
Page)	الصفحة)
Mafarki.	الحلم.
(sunã	(
Barton	بارتون
nahiyar.	القارة.
gaishe	استقبال
(4)	(4)
Landmann&gt;	Landmann &amp; GT؛
tangents.	الظلال.
yanzu-yanzu	وجيز جدا
Kwanaki	أيام
hydrogen	هيدروجين
mãkirci	المؤامرات
Ubangijinku,	الرب
Harman	هارمان
(32	(32
manya-manyan	كبيرة جدا
abar	إغلاق
(3)	(3)
Ru?	رو؟
eccentricity	الانحراف
variaty	فارياتي
[26]	[26]
theories	نظريات
karshen,	نهاية،
&quot;Pink	على &amp; quot؛ الوردي
(27	(27
matsanancin	خارجي
ƙarfe	معدن
ƙarfi	قوة
misali.	المثال.
lokatai,	في بعض الأحيان،
kiyasin.	وتقدر.
misali,	على سبيل المثال،
(2)	(2)
maida	انتعاش
binne,	دفن،
Miranda,	ميراندا،
======================	======================
Majagaba	رائد
Miranda.	ميراندا.
Celsius	مئوية
82:	82:
(1)	(1)
windows,	النوافذ،
dokokin,&gt;	القوانين، وGT.
windows.	النوافذ.
(6,118	(6118
jps&gt;	JPS &amp; GT؛
turbaya	غبار
============================================	============================================
(745	(745
[23]	[23]
cinikayya,	التجارة،
Dancing	رقص
LaStrange)	LaStrange)
karkata	عوجا
daki-daki.	التفاصيل.
goaltender	حارس مرمى
hasashe	الصور
fix.	إصلاح.
[24]	[24]
misalin	مثال
lantarki	إلكتروني
Kiristoci	المسيحيين
dattawan	شيوخ
Ƙasã,	أرض
Tsarki.	نقية.
zauna,	البقاء،
[25]	[25]
zauna.	سبت
wanda,	الذي،
kosad	يرضى
Iraki	العراق
jawabai	مكبرات الصوت
ka&#39;idodin	مبادئ
wasika	حرف
ƙuduri?	القرار؟
&quot;Pavel	على &amp; quot؛ بافل
X11R4.	X11R4.
godiya.	الشكر.
I3150101@dbstu1.rz.tu-bs.de	html>
jh6r@andrew.cmu.edu	html>
bambanta	تختلف
biyar	خمسة
IBM?	IBM؟
James,	جيمس،
godiya,	شكرا،
nema	بحث
dalibai,	الطلاب،
gargaɗi	تحذير
Sai	و
godiya!	بفضل!
Sam	سام
nemi	سعى
kwamfutarka	كمبيوتر
ragowar	بصمات
Franjione)	Franjione)
Cramer)	كريمر)
(?)	(؟)
Triantafyllopoulos	Triantafyllopoulos
kai&quot;	ومثل؛
nauyi.	الوزن.
nauyi,	الوزن،
plutoneon,	plutoneon
gas	غاز
kammala	خلص
gay	مثلي الجنس
IBM.	IBM.
Yahudawa&gt;	اليهود وGT.
&lt;id.XNFZ.VJ8@nmti.com&gt;	العلامة &amp; lt؛ id.XNFZ.VJ8@nmti.com&amp;gt.
al&#39;umma&quot;,	المجتمع ومثل،،
gan	رؤية
fiye	أكثر
hander	يدوي
kyau.	جيدة.
ramummuka,	فتحات،
=====================================	=====================================
9,846	9،846
posted	شارك
kyau,	خير
hobbiest	hobbiest
nickel.	النيكل.
lalatar	سفاح القربى
(Richard	(ريتشارد
c23st@kocrsv01.delcoelect.com	html>
acetylene,	الأسيتيلين،
sauran&gt;	البعض &amp; GT؛
6x9	6X9
wasannin,	ألعاب،
karɓar)	المتلقي)
tushe,	قاعدة،
Sau	مرات
kaɗawa	موجة
ware.)	الاستثناءات).
sabo-sabo	أحدث
San	سان
(Scott	(سكوت
albarkatun,	الموارد،
hadiri	عاصفة
Q4ayata,	Q4
liyãfa.	الترفيه.
jari,	الاستثمار،
Canadiens	كنديينز
ɗora	الملحقون
weather,	الطقس،
biyan	اشتراك
aure,	الزواج،
weather.	الطقس.
kyaun	جميل
wa.	.
batirin	بطارية
Khan	خان
Kinsey	كينزي
zirga-zirga?	المرور؟
&quot;kiwon	على &amp; quot؛ والصحة
abin	ما
riqo	الولي
xterm	إكس تيرم
Mafarki&quot;	حلم ومثل؛
753-3245,	753-3245،
duba,	الرأي،
shorelines,	الشواطئ،
lalata.	الضرر.
&quot;sai	على &amp; quot؛
Rosa	روزا
Rockville,	روكفيل،
ganina	أفترض
&#39;zobba	&#39;خواتم
Research	بحث
kyawawan	جميل
tsallake.	حذفت.
(95	(95
(93	(93
tushen	مصدر
ammonia	غاز الأمونيا
tsattsarkar	باستثناء
etiologic	سببياتي
shawarta	نصح
biya.	المدفوعة.
fili,	على ما يبدو،
cj195@cleveland.Freenet.Edu	html>
karshe	نهائي
stylizied	stylizied
Agency	وكالة
Ancient	القديمة
uunet.	UUNET.
(88	(88
ESPN	ESPN
Car	سيارة
makamashi	طاقة
billa?	ترتد؟
uunet!	UUNET!
Bashing?	تقريع؟
jawabin	خطاب
tsayar).	وقف).
Inshora	تأمين
1,200	1200
nuna,	المعرض،
nuna.	المعرض.
untreatable	غير قابل للعلاج
filin	حقل
comic,	كوميدي،
misalai	أمثلة
ed&quot;,	إد ومثل،،
korenek@nmti.com	html>
SHI	HE
Hadi	إكسسوارات
Shin,	سواء
lura	مذكرة
gaɓãɓuwa	الجسيمات
windowed	إطارات
halayyar	صفة مميزة
hagu	اليسار
takan	وتستخدم
Harumph.	Harumph.
&quot;bari	على &amp; quot؛ ول
constraints	القيود
fallasa	يتعرض
sosai),	جدا)،
daskararre	مجمد
shi).	ذلك).
Nelson)	نيلسون)
kiyaye.	حافظ.
damar.	الوصول.
A&gt;	A &amp; GT؛
Zbib	زبيب
raga,	الأهداف،
whirling	الإلتفاف
VanHeyningen	VanHeyningen
baƙo	ضيف
bangaskiyarku	إيمان
baƙi	أسود
baseball.	لعبة البيسبول.
(Ba	(لا يوجد
kyale	السماح
fus	فتيل
waɗanda	هؤلاء
SKS	SKS
godiya	شكر
duhu	ظلام
muted	صامتة
Ikkilisiyar	كنيسة
leonard@aix3090b.uky.edu	html>
cuce,	تؤذي،
riga	سابقا
filayen	الحقول
paperwork	عمل ورقي
(matata).	(زوجتي).
falalen	صخرة
Kwayoyin.	البكتيريا.
00ecgillespi@leo.bsuvc.bsu.edu&gt;	00ecgillespi@leo.bsuvc.bsu.edu&amp;gt.
sabuwar	جديد
abu,	شيء،
artistically	وفنيا
hada	بما فيه
hade	مجموعة
burodi	خبز
tare&gt;	وGT.
Citizen	مواطن
duka	كل
415-	415-
banza	عديم القيمة
agressive.	عدوانية.
parented	أصليا
gidanmu	عائلتنا
&quot;jargonese&quot;	على &amp; quot؛ jargonese ومثل؛
Kirk.	كيرك.
yarjejeniyar	اتفاقية
barbashi,	الجسيمات،
&lt;jh6r+@andrew.cmu.edu&gt;	العلامة &amp; lt؛ jh6r+@andrew.cmu.edu&amp;gt.
gamsarwa	مرض
size	حجم
hitter.	الضارب.
duk?	كل شيء؟
abun	محتوى
Robert	روبرت
nuni,	العرض،
[wata	[
hitter)	ضاربا)
tayin	عرض
hitter,	الضارب،
lõkacin	عندما
iya&gt;	وGT.
SER	SER
SET	SET
jituwa&quot;)	متوافق ومثل؛)
haɗa	بما فيه
rawar	دور
ĩmãni	نعتقد
Re:	رد:
take,	لقب
kunya	عار
Red	أحمر
rayuwarsu	حياة
dukiya	ممتلكات
saɓani	عموميات
Afrilu	نيسان
riko	يتصرف
posts,	المشاركات
Dokokin	قوانين
Cikakken	كامل
dokoki	قواعد
karkace	حلزوني
megatest.com&gt;,	megatest.com &amp; GT؛،
miliyoyin).	الملايين).
rike	عقد
lurk	ثابر
nesa	بعد
guntu-sa	رقاقة مجموعة
&quot;Jonathan	على &amp; quot؛ جوناثان
html>	أتش تي أم أل&gt;
flash	فلاش
SPL	SPL
via	بواسطة
ƙirƙirar	خلق
for	إلى
&quot;Home	على &amp; quot؛ الرئيسية
biyu)	اثنين)
Kamar	كما
biyu.	اثنين.
biyu,	اثنين،
foo	فو
dabi&#39;u	القيم
da).	).
kwakwalwa	ذاكرة
biyu:	الثاني:
COD	COD
---------------------	---------------------
York	نيويورك
Shida	ستة
biyu?	اثنين؟
tilted	يميل
POBox	صندوق البريد
(tvtwm).	(Tvtwm).
fil.	دبوس.
tayin,	العرض،
bambanci	فرق
Ron	رون
DAGA:	FROM:
tushe	قاعدة
high-matsa	الضغط العالي
Aeronautics	علم الطيران
amfana	مصلحة
(Mike	(مايك
aikata	فعل
bugun	سرعة
yiwu,	ربما،
(martin	(مارتن
HITTER	الضارب
Crawford	كروفورد
manzanni.	رسل.
manzanni,	الرسل،
dual	مزدوج
(Ka	(
yarmulke	القبعة اليهودية
sallama,	عرض
PowerBook	بووربووك
bindiga&gt;	بندقية و GT.
Lyme,	لايم،
jiyya	علاج
(Ko	(أو
800mA.	800M.
(Family	(الأسرة
Grounding	أساس
sarkin.	الملك.
phrases	عبارات
ƙarin	أكثر
Spot	بقعة
amfani	استعمال
yawa.	الكثير.
&quot;Personal	على &amp; quot؛ الشخصية
dubu	ألف
(musamman	(خاصة
na&#39;urar	جهاز
Jupiter	كوكب المشتري
riba	ربح
yawa)	كثير)
(J.	(J.
274-5357	274-5357
tabbata	بالتأكيد
&lt;1993Apr21.234159.1206@ualr.edu&gt;	العلامة &amp; lt؛ 1993Apr21.234159.1206@ualr.edu&amp;gt.
gudun	سرعة
ƙarni	قرن
tsiwirwirinsu	اكتسبت
&quot;Drakula&quot;	على &amp; quot؛ Drakula ومثل؛
flank	جناح
motoci.	السيارات.
...]]	...]]
asara.	الخسارة.
gwamnoni.	المنظمين.
alhãli	و
(Edward	(إدوارد
yawa?	كثير؟
duba	رأي
gaba&gt;	بجوار &amp; GT؛
dubi	نظرة
dokokin,	القوانين،
yawan	عدد السكان
fil	دبوس
tauraro	نجمة
cikakken	كامل
manyan	عظيم
Manzanni	رسل
Matsuo,	ماتسو،
Baftisma&gt;	معمودية &amp; GT؛
makirci	مخطط
zažužžukan.	خيارات.
fis	فتيل
takwarorinsu	نظراء
abokan.	شركاء.
taurari	النجوم
fix	حل
shakatawa	موقف
abokan,	شركاء،
gudu.	تشغيل.
gudu,	تشغيل،
da&quot;	و &amp; مثل؛
Columbia&gt;	كولومبيا وGT.
fili	كما يبدو
karshe&gt;	أخيرا وGT.
Bos	بوس
90%	90٪
video,	فيديو
Jupiter,	كوكب المشتري،
aikawa	تصدير
cewa:&gt;&gt;	: &amp; GT؛ &amp; GT؛
BUFFERS	BUFFERS
aiwatarwa	تطبيق
90,	90،
Jupiter.	كوكب المشتري.
Advancements	التقدم
Jupiter;	كوكب المشتري.
tsarawa	مخططي
Herschel.	هيرشيل.
dabam-dabam	مختلف
Inc.,	شركة،
Vehical	Vehical
ɓawon	قذيفة
sharma@tiger.vill.edu	html>
line?	الخط؟
su&gt;	وGT.
horo	تدريب
yãƙi	عراك
rauni	ضعيف
wannan:	هذا:
takwarorina).	الأقران).
27,6	27.6
asymmetric	لا متماثل
faulting	يخطأ
kaya	جرد
boye-boye&quot;	التشفير ومثل؛
wannan?	هذه؟
auku	مرر
bisa	فوق
wadda,	الذي،
video	فيديو
(&lt;o&gt;	(&amp; اللفتنانت؛ س &amp; GT؛
kayyade	تحديد
animation	حيوية
wannan.	هذا.
^^^^^^^^^^^^^^^^^^^^^^^^^^	^^^^^^^^^^^^^^^^^^^^^^^^^^
kawayeniya	أوهام
wannan,	هذا،
Maras	منخفض
sauransu&gt;&gt;	الخ &amp; GT؛ &amp; GT؛
xelion!	xelion!
rigima	جدل
Neptunian	نبتون
&quot;akwai	على &amp; quot؛ هناك
73,	73،
Friedman	فريدمان
Scarring	تندب
KRISTI:	المسيح:
baicin	بدلا من
bayyanar	مظهر
&lt;pgf.735012282@srl03.cacs.usl.edu&gt;,	العلامة &amp; lt؛ pgf.735012282@srl03.cacs.usl.edu&amp;gt،،
da?	؟
Callsign:	العلامة نداء:
hoto	صورة
Station	محطة
sunayen	أسماء
27.2	27.2
tabbatar&gt;	ثبت &amp; GT؛
(Detroit,	(ديترويت،
tekun	المحيط
&quot;smog&quot;	على &amp; quot؛ &amp; الضباب الدخاني مثل؛
Far!	العلاج!
da,	و،
DISKs	أقراص
auna	قياس
da)	)
Lampoon_	Lampoon_
Asteroid	الكويكب
1,500	1500
Selannes	Selannes
LURA.	الاعتراف.
kawo	جلب
da!	!
tuntubi	اتصال
Yunƙurin	محاولة
N-8-1.	N-8-1.
tuntube	اتصال
&quot;wanda	على &amp; quot؛
electronically	إلكترونيا
line.	الخط.
da.	.
410-34-1	410-34-1
fayiloli	ملفات
Software	البرمجيات
Yammacin	غرب
sihiri	سحر
alkawuran	وعود
700	700
alloli.	الآلهة.
703	703
kwata&gt;	الربع &amp; GT؛
G20,	G20،
Shekaru	سنوات
dutse-pocked	حجر دمره
dai	لكن
Microsoft	مايكروسوفت
Maplewood	خشب القيقب
code	رمز
dc)	العاصمة)
G20.	G20.
DX)	DX)
recharge	إعادة شحن البطارية
cigaba	وعلاوة على ذلك
wannan&gt;	وGT.
dan	ابن
shakka&gt;	بالطبع &amp; GT؛
Fax:	الفاكس:
Lee)	لي)
kare	حماية
fasara:	إعادة صياغة:
speculating	المضاربة
kari	ملحقات
Hiroshi	هيروشي
sci.med,	sci.med
wayar:	الهاتف:
Nanaimo	نانايمو
&lt;o&gt;)	واللفتنانت؛ س &amp; GT؛)
kara	المزيد
Wadannan	هؤلاء
Almasihu,	المسيح،
halarci	حضر
Almasihu.	المسيح.
7.5	7.5
karo	مرة
Kennedy	كينيدي
indistinct	غير واضح
cl056@cleveland.Freenet.Edu	html>
(Spiros	(سبيروس
&lt;sarari&gt;	العلامة &amp; lt؛ &amp; GT الفضاء.
kasa	أرض
alkyabbar	عباءة
&lt;1APR199313404295@skyblu.ccit.arizona.edu	html>
200uf	200uf
alfijir,	الفجر،
Turawa,	دفع،
Brenda	بريندا
(61302	(61302
Ave.	افي.
redrawn	إعادة رسم
tsare-tsaren	خطط
Henry	هنري
Whitten	ويتن
ƙarfi.	قوية.
zbib@bnr.ca	html>
millitary	MILLITARY
betel@camelot.bradley.edu	html>
&quot;Wasi-wasi	على &amp; quot؛ الشك
ra&#39;ayi	عدد المشاهدات
Shipping	الشحن
&lt;,	العلامة &amp; lt؛،
iyakacin	ماسة
Lines	خطوط
(azurta	(شريطة
McCord,	ماكورد،
zuwa	إلى
saman&quot;	أعلى ومثل؛
Turawa:	الضغط:
ta?]&quot;]	؟ ومثل؛
jesus	يسوع
kungiyoyin,	مجموعات،
Amurka	الولايات المتحدة
24:46,	24:46،
auto	السيارات
DOSKEY	DOSKEY
Yiwuwar	إمكانية
al&#39;amura	أحداث
Pentium	بنتيوم
_outside_	_outside_
Medicare	الرعاية الطبية
(1,430	(1430
rauser@fraser.sfu.ca	html>
hotuna	الصور
empiric	دجال
League,	الدوري،
&lt;na	العلامة &amp; lt؛
League.	الدوري.
Colorado,	كولورادو،
ƙarfin	قوة
akayi	متورط
HMMMMMMMMMMMMMMMMMMMMMMMMMMMMMMMMMMMMMMMMMMMMMMMMMMMMMMMMMMM	HMMMMMMMMMMMMMMMMMMMMMMMMMMMMMMMMMMMMMMMMMMMMMMMMMMMMMMMMMMM
al&#39;amurran.	القضايا.
hakkokin	حقوق
biya	المدفوعات
bitar.	الاستعراض.
(severy)	(سيفيري)
Voyagers	الرحالة
(kasance	(
tambaya,)	السؤال)
articles	مقالات
Maibaftisma	المعمد
Alhãli	و
links	الروابط
Farashin	السعر
zone,	منطقة،
Oberon	أوبيرون
brenner)	برينر)
shi.....	ذلك .....
.....	.....
Van	عربة
biyu	اثنان
partially	جزئيا
&lt;2958804@QUCDN.QueensU.CA&gt;	العلامة &amp; lt؛ 2958804@QUCDN.QueensU.CA&amp;gt.
sunlit	مشمس
Wai-Ming	واي مينغ
Majalisun	Majalisun
gida,	منزل
related	ذات الصلة
gida.	المنزل.
1979,	1979،
&#39;makamai&#39;	&#39;الأسلحة&#39;
bayyana,	وذكر،
1979.	1979.
Taimakon:	مساعدة:
bayyana.	واضح.
miƙa	عرض
mabukaci	مستهلك
firinta	طابعة
(Yuro-Bashing?)	(اليورو تقريع؟)
frameworks	الأطر
gt7469a@prism.gatech.EDU	html>
Frank	فرانك
canjawa	تحول
TASHIN	MUSCLE
Nice.	لطيفة.
622121	622121
Digi-Key	DIGI-مفتاح
bindiga-lasisi	بندقية ترخيص
magani,&gt;	العلاج &amp; GT؛
circling	تدور
1978,	1978
&quot;haƙiƙa	على &amp; quot؛ الهدف
placebo	دواء وهمي
1978.	1978.
Kreiling)	Kreiling)
Dan	ابن
kasa&gt;	أقل &amp; GT؛
Regio	منطقة
&quot;arab?&quot;	على &amp; quot؛ العربية &amp; قووت]؛؟
fadada	توسع
gidan	منزل
low-yawa	منخفض الكثافة
zunubanku.	الخطايا.
Indonesia.	إندونيسيا.
zunubanku,	الخطايا،
orbiters	المدارية
girmama	تكريم
Hiram	حيرام
goolsbey@cs.utexas.edu	html>
&#39;yanayi	&#39;شروط
dozin	دزينة
hujjoji	حقائق
rikodin	سجل
ƙarƙashinsu	تدفق
unsa	إشراك
&quot;Kai	على &amp; quot؛ أنت
Faehl	Faehl
1976,	1976
Friedman:	فريدمان:
Fasaha	تكنولوجيا
aure	زواج
Karshe	نهائي
faifai,	القرص،
nauyi	الوزن
bara,	في العام الماضي،
VLB	VLB
32-bit	32-بت
fadin	عبر
1974.	1974.
1974,	1974،
shafewa	شطب
kankara.	الجليد.
king@reasoning.com	html>
kankara,	الجليد،
486DX-33	486DX-33
4.0-4.3	4،0-4،3
Martian	المريخ
auna.	قياس.
Mars?	المريخ؟
undocumented	غير موثقة
Mars,	المريخ،
Steve	ستيف
Mars.	المريخ.
VLX	VLX
karfi,	قوية،
Mataki	عمل
1975,	1975
hukumomin	وكالات
kai?	؟
R&gt;	R &amp; GT؛
DLC	DLC
manzo,	رسول،
blaisec@sr.hp.com	html>
Uku	ثلاثة
uwa	أم
rajistan	تحقق
Sarki)	الملك)
bangaren	عنصر
mahaliccin	الخالق
Um,	أم،
fadi,	على نطاق واسع،
yankuna	المناطق
Huygens,	هيغنز،
1972,	1972،
kubuta	فرار
Mocker)	مستهزئ)
DMA	حق
1970s	1970s
&quot;taimaka	على &amp; quot؛ مساعدة
kai,	،
Samun	وصول
kai.	.
1973,	1973،
daya&gt;	وGT.
cewa&gt;	وGT.
mallaki	حيازة
(Hal	(هال
Mitsubushi	Mitsubushi
zane.	التصميم.
Montreal,	مونتريال،
coma	غيبوبة
mallaka	خاص
zance	إشارة
----	----
kafa	مجموعة
(Henry	(هنري
up).	متابعة).
bangare.	جزء.
belts,	الأحزمة،
boye-boye&quot;&gt;	التشفير ومثل؛ &amp; GT؛
Mexico,	المكسيك،
&#39;to	&#39;
______________________________________________	______________________________________________
(amma	(ولكن
barci	نوم
&lt;May.12.04.27.47.1993.9935@athos.rutgers.edu&gt;	العلامة &amp; lt؛ May.12.04.27.47.1993.9935@athos.rutgers.edu&amp;gt.
zubi	مصهور
ron.roth@rose.com	html>
Formats	صيغ
haɗin	تعاون
amsar	إجابة
dalĩli	سلطان
unethical	غير أخلاقية
ƙarshe.	في نهاية المطاف.
7.3.	7.3.
amsa:	الإجابة:
&quot;nameplate&quot;	على &amp; quot؛ لوحة ومثل؛
ƙarshe,	وأخيرا،
tabarau	المواصفات
1971,	1971،
modified	تعديل
kadi	الغزل
guda.	احد.
&#39;93).	&#39;93).
guda,	وحيد
Manufar	هدف
kada	فعل
husũma	خلاف
sabani	عموميات
alhẽri	خير
kwakwalwan	رقائق
(317)743-1394	(317)743-1394
(kuskure),	(خطأ)،
yadda	كيف
kirki&gt;	سلامة و GT.
Mike	ميكروفون
(2,544	(2544
ƙarfi&gt;	قوية وGT.
&#39;ve	&#39;هاء
Multi-kabilanci	متعدد الأعراق
140-165	140-165
sun4nl!	sun4nl!
(Claudio	(كلاوديو
saurari	استمع
lokuta	الحالات
Gaisuwa,	تحية طيبة،
karfin	قوة
Computers	أجهزة الكمبيوتر
ƙarshen	نهاية
batman@cisco.com	html>
zuba	صب
cometa,	قادم،
(-290	(-290
drive,	محرك،
Duniya-sized	الأرض الحجم
kafofin	مصادر
(-298	(-298
core	جوهر
DATE:	التاريخ:
Sarkin	ملك
ce:	وقال:
kashe,	الخروج،
[misali	[مثال
Maris	مسيرة
aiwatar	تطبيق
kyalkyali	لمعان
fitar,	بها،
Engineering	الهندسة
ce,	وقال،
ce.	قال.
Diffie-Hellman	ديفي هيلمان
tiff	شجار
matakin	مستوى
8.1	8.1
hours	ساعات
up.	يصل.
duniya&gt;	العالم &amp; GT؛
up,	فوق
bambance-bambance	الخلافات
Rosenau)	ROSENAU)
daidaito.	دقة.
jama&#39;a-key	المفتاح العام
&quot;Kun	على &amp; quot؛ أنت
fegi,	شماعة،
uku	ثلاثة
babur.	دراجة نارية.
_____________	_____________
Club	ناد
ra&#39;ayoyi	عدد المشاهدات
ɓangare	جزء
gode	شكر
Allah.)	الله).
shawara	نصيحة
boye-boye,	التشفير
kayan.	المواد.
Mouting	Mouting
boye-boye)	التشفير)
(5,000	(5000
likita	طبيب
arewacin	شمال
alane@microsoft.com	html>
hit&gt;	ضرب &amp; GT؛
afronted	afronted
Rhode	رود
Theodore	ثيودور
ciyayi	الحياة النباتية
kana	أنت
Japan	اليابان
kome.	لا شيء.
Church.	الكنيسة.
gauraya	مزيج
asteroids	الكويكبات
mamba	الأعضاء
kamu	مدمن
landiroba	سيارات الدفع الرباعي
radar	رادار
DEVICEHIGH	DEVICEHIGH
babura	الدراجات النارية
Springs,	الينابيع،
sauran.	البعض.
kama	مزلاج
fetur	نفط
hidima	خدمة
&#39;le	لو
kwarewa.	التجربة.
impedance.	مقاومة.
Clr	CLR
kan?	على؟
kwarewa,	الخبرة،
gibba,	ثغرات،
uje	كدمة
com1	COM1
sanyi,	بارد،
Power	قوة
Stein	شتاين
(kamar	(كما
format	شكل
&lt;1993Apr21.032427.22464@leland.Stanford.EDU&gt;,	العلامة &amp; lt؛ 1993Apr21.032427.22464@leland.Stanford.EDU&amp;gt،،
boye-boye.	التشفير.
matsakanci	وسيط
(-235	(-235
Gretzky	Gretzky
komai	لا شيء
559.	559.
powered	تعمل بالطاقة
zanen	مصمم
Ingila	إنجلترا
ƙanana	صغير
DOS	DOS
(Leonard	(ليونارد
&lt;1qvb5aINNmoi@darkstar.UCSC.EDU&gt;,	العلامة &amp; lt؛ 1qvb5aINNmoi@darkstar.UCSC.EDU&amp;gt،،
Attaura,&gt;	القانون و GT.
akafi	نقرات
kasida,	المادة،
kula,	الرعاية،
kula.	الرعاية.
fama&gt;	التعامل &amp; GT؛
(har	(
kusantar,	رسم،
Magangara	أدنى
microsoft	مايكروسوفت
veneer	القشرة
ɗã&#39;a	مسار
kaka	فصل الخريف
Deptt.	Deptt.
Canucks)	كنوكس)
cin	الأكل
sanyin	راحة
definition	تعريف
general.	عام.
zane],	تصميم،
(Michael	(مايكل
Sanyi.	بارد.
Alkawari	وعد
ko&#39;ina,	في كل مكان،
adam	بشري
zazzabi	حمى
chances	فرص
(Spain)	(إسبانيا)
[ped]	[إدخال رقم التعريف الشخصي]
Safety&quot;	السلامة ومثل؛
dadi	مريح
Gaza	غزة
nufi	الوسائل
ragowa	بت
utzoo!	utzoo!
adawa	معارضة
nufa	عنوان
Magnetic	مغنطيسي
:-)&gt;&gt;	: -) &amp; طن؛ &amp; GT؛
images.	الصور.
FAQ	التعليمات
jam&#39;iyyun	الأطراف
sguerke@brahms.udel.edu	html>
koutd@hiramb.hiram.edu	html>
lu&#39;ulu&#39;u	لؤلؤة
katin,	بطاقة،
katin.	البطاقة.
Jahannama&gt;	الجحيم &amp; GT؛
Flyby	التحليق
makami	سلاح
batu-na-view.	نقطة من رأي.
V9R	V9R
mutumin	رجل
mangolawa	المغول
&quot;karshe&gt;	على &amp; quot؛ مشاركة &amp; GT؛
mažalli&quot;.	مفتاح ومثل؛
Stalin	ستالين
kishili	مثلي الجنس
sarrafa	مدير
maganganun	البيانات
league!	الدوري!
matakai	خطوات
league.	الدوري.
layi	على الانترنت
23-25).	23-25).
&quot;kishili	على &amp; quot؛ مثلي الجنس
dace	مناسب
korenek)	korenek)
committ	يرتكب
tsaye.	واقفا.
makircinsu	مخططات
kwanaki	أيام
kunsasshen	وتعبئتها
kwafin	نسخة
alama&gt;	ميزة &amp; GT؛
Cleopatra.	كليوباترا.
daki-daki	التفاصيل
gawarwakin,	الهيئات،
miscommunication.	سوء الفهم.
asali,&gt;	اصلية و GT.
wanda	التي
low-matsa	الضغط المنخفض
halaka&quot;	دمرت ومثل؛
dade	طويل
lmouse	lmouse
dada	زيادة
&quot;kulle	على &amp; quot؛ قفل
(misali,	(على سبيل المثال،
Kusan	تقريبا
(misali)	(على سبيل المثال)
birnin	مدينة
mataki.	المرحلة.
Newtonian	النيوتونية
99.9	99.9
(29.95)	(29.95)
tsayar	إنشاء
fahimci	فهم
kansa,	نفسه،
maraba&gt;	ترحيب &amp; GT؛
Mariners.	البحارة.
kunshi&gt;	يحتوي &amp; GT؛
nelson_p@apollo.hp.com	html>
kamara	كاميرا
(932	(932
Dorothy	دوروثي
bututu.	الأنابيب.
.indiana.edu	.indiana.edu
Resources	موارد
6-7	6-7
dansa	ابن
lafiya-tune	صقل
tsaya,	الوقوف،
&quot;Konstantinov&quot;	على &amp; quot؛ كونستانتينوف ومثل؛
lashe	وون
6.4	6.4
uba	الأب
maki,	نقطة
Radio	راديو
wani,	لذلك،
tsakiya	الوسطى
SAMA	عودة
bantara	قطعة
hockey,	الهوكي،
direbobi-lasisi	السائقين والترخيص
na&#39;urar,	الجهاز،
adulation&gt;	التملق وGT.
THEWITNESS	THEWITNESS
kwarewa	تجربة
gatari	الفأس
Korantiyawa	كورينثيانز
Donut&quot;	دونات ومثل؛
&quot;muhimmanci&quot;	على &amp; quot؛ أهمية ومثل؛
kira.	الدعوة.
karɓa,	المتلقي،
Kayayyakin	المنتجات
kashi.	في المئة.
kamata	ينبغي
POSTITION	POSTITION
sau&gt;	مرة وGT.
rashin	نقص
cuta.&quot;	. المرض ومثل؛
waiiiiiit,	waiiiiiit
Saboda	لأن
S5R3.2).	S5R3.2).
&#39;m&#39;:	&#39;M&#39;:
wanin	من
Dole	يجب
Charon,	شارون،
hakika,	في الواقع،
daidaita,	ضبط،
tsakãtsaki	متوسط
Center	مركز
taga).	نافذة).
isasshen	كاف
ado.	الديكور.
4th	4
ga&#39;	&#39;
nuni	عرض
Shostack	Shostack
ashin:	العنوان:
dubu&gt;	ألف &amp; GT؛
frigid	تفه
System,&quot;	النظام، ومثل؛
Dwarf&quot;	قزم ومثل؛
Hughes	هيوز
sauya.	تغيير.
1968.	1968.
escalated	تصاعدت
beeps.	الصفافير.
294-8153	294-8153
kulle	مغلق
kulla	صفقات
Montes,	مونتيس،
hardware	الأجهزة
Jamus,	ألمانيا،
redraws.	يعيد رسم.
da&#39;irar	دائرة
(900	(900
ethically	أخلاقيا
bayanai	معلومات
flights	رحلات
Sarrafa	مدير
openlook.	openlook.
adalci	عدالة
Dodson	دودسون
nuna	عروض
VDC	VDC
sanyi	بارد
kaifi	حاد
Windows.	النوافذ.
5X9	5X9
dutsen.	الصخور.
dutsen,	الصخور،
shigarwa	تركيب
Attaura&gt;	القانون و GT.
hadisai.	التقاليد.
(Yahaya	(يوحنا
fansa	تعويضات
Landers	اندرز
Yohanna?	جون؟
Gary	غاري
sanya	مصنوع
Georgia	جورجيا
hotan	هوتان
vax839@tid.es	html>
sanye	يرتدي
Gasa	خبز
adam.	الإنسان.
gleaned	استقاها
mako,	الاسبوع،
adam,	الإنسان،
Gano	حدد
MLINDROOS@FINABO.ABO.FI	html>
Gans	مجنون
VGA	VGA
bayani:	المعلومات:
Fitowa	هجرة جماعية
640	640
bayani?	المعلومات؟
Dubban	الآلاف
tasirin	التسميات
gudana.	جارية.
kulob	ناد
Bagalile	الجليل
Ee.	نعم.
armada	أسطول حربي
1965,	1965،
wanna	أريد أن
(10,000	(10،000
bayani.	الحل.
(JT)	(JT)
cututtuka	أمراض
kotun	محكمة
ãyõyin	علامات
Game	حول
(kuma	(
flag	علم
tun	منذ
Mercury,	الزئبق،
Gama	ل
haɓaka	الوقود
Mercury.	الزئبق.
1964,	1964،
Diplomasiyyar	دبلوماسية
alfahari	فخور
Marty	مارتي
(Ina	(I
Atkinson	أتكينسون
(JPL	(JPL
makale	تمسك
bisa).	أعلاه).
gudanar	مقبوض
486DLC-33	486DLC-33
fanni	تخصص
layout	تصميم
1967,	1967،
Brian,	بريان،
tauraron	نجمة
bangaskiya&gt;	الإيمان و GT.
VHS	VHS
Kwatancen	مقارنات
cypher	سايفر
haifi	مولود بالفطرة
Houston	هيوستن
counterclockwise	عكس
lawa	حمم
650	650
APPRECITATED.	APPRECITATED.
FBI	FBI
quibble-	quibble-
Virago	إمرأة سليطة
Carlos	كارلوس
mutuwa	الموت
don	إلى
sannu	مرحبا
izgili	تحدى بإزدراء
km@ky3b.pgh.pa.us	html>
ions	الأيونات
Sanjeev	سانجيف
dos	دوس
Tare	مع
zamba	احتيال
baseball	البيسبول
(wanin	(بخلاف
(-366	(-366
dpi	DPI
Buntus	البنطي
Nunnally@acs.Harding.edu	html>
zaman	جلسة
(Matt.	(مات.
American	أمريكي
windows	نوافذ
kirki	خير
canyons,	الأخاديد،
fitarwa	الانتاج
Canada	كندا
sha&#39;awar	مهتم
mutum,	رجل
Bading)	Baerecke)
mutum.	رجل.
Siemon)	Siemon)
hankali	تركيز
unalterably	قاطع
kaina	نفسي
Jose,	جوزيه،
Lura	مذكرة
shida	ستة
data	معطيات
400dpi)	400dpi)
1962,	1962
hazo.	الضباب.
zama?	يكون؟
sigina	إشارة
The	ال
Logitech	لوجيتك
fasali,	الميزات،
northeners	northeners
cutarwa	مضر
&#39;yan	قليل
fasali.	الميزات.
AutoCAD	أوتوكاد
Thu	الخميس
sharuddan	حيث
League	الدوري
zama,	،
adadi	شخصية
sha&#39;awa)	الفائدة)
(Edmonton,	(إدمونتون،
auroral	الشفقي
(Dave	(ديف
School,	مدرسة
auroras	الشفق
&#39;jinkirin	بطء
Brenn)	الجدة)
zama)	)
Tim	تيم
Brenn,	الجدة،
(1,500	(1500
256k	256K
optilink	optilink
newsdesk@jplpost.jpl.nasa.gov	html>
Biyu	اثنان
musayar,	الصرف،
fahimta	فهم
almarar	خيال
&lt;1993Apr7.221357.12533@lamont.ldgo.columbia.edu&gt;	العلامة &amp; lt؛ 1993Apr7.221357.12533@lamont.ldgo.columbia.edu&amp;gt.
enteritis	بادئة معناها معي
Fade	تتلاشى
hoax	خدعة
shekaru&gt;	عمر &amp; GT؛
ƙarfi,	قوية،
dari	مركبات
fallout	تداعيات
dare	ليل
to,	ثم
Krista&gt;	كريستيان &amp; GT؛
stephen@orchid.UCSC.EDU	html>
takaice,	لفترة وجيزة،
sanin	معرفة
duk	كل
takaici	للأسف
takaice	لفترة وجيزة
tajirai	امتلاكي
&#39;yar&#39;uwa	شقيقة
(wanda	(
&gt;&gt;&gt;	وطن؛ &amp; GT؛ &amp; GT؛
wallafe	المنشورات
-----------------	-----------------
10:34	10:34
elliptical	بيضاوي الشكل
lilo.	سوينغ.
communicants.	المبلغون.
Cassini	كاسيني
taurari.	النجوم.
sunanka,	اسمك،
Disamba	كانون الاول
shigo	واردات
ƙarfe,	الصلب،
&#39;	&#39;
Idan	إذا
taurari,	النجوم
VL-bus	VL حافلة
(Version	(النسخة
&gt;	وطن.
shige	مرت
months	أشهر
shiga	دخول
schauf@iastate.edu	html>
To,	ثم
serial	مسلسل
zama&gt;	وGT.
kiran	دعوة
shine	غير
Duk	كل
daukawa	يحمل
damu	قلق
Wadanda	هؤلاء
Almasihu,&quot;	المسيح، ومثل؛
Campus)	الحرم الجامعي)
&gt;&gt;&gt;&gt;	وطن؛ &amp; GT؛ &amp; GT؛ &amp; GT؛
Too	أيضا
gazed	حدق
dame	ازعجت
Venusian	متعلق بكوكب الزهرة
dama	حق
Tom	توم
karshe.	في نهاية المطاف.
karshe)	أخيرا)
divider	مقسم
100-kilomita	100 كم
Lei)	لى)
Weapon:	السلاح:
kasida	مقالة
bautãwa	إله
wa&#39;azi,	تعليمات،
100,	100،
1000	1000
gwargwadon	كثيرا
Personaly,	Personaly
der	دير
(tushen	(المصدر
des	قصر
Alpha	ألفا
kuma,	و،
islamic	الإسلامية
&quot;kimiyya&quot;	على &amp; quot؛ للعلوم ومثل؛
kaiwa	قيادات
&lt;31MAR199321091163@juliet.caltech.edu	html>
kuma:	و:
bike	دراجة هوائية
Yemen	يمني
larry	لاري
biki	عطلة
Kwanan	مؤخرا
&lt;p00261@psilink.com&gt;	العلامة &amp; lt؛ p00261@psilink.com&amp;gt.
Luis	لويس
kuma.	و.
lawa-cika	مليئة الحمم
kayayyaki	التصاميم
sani?	تعلم؟
dake	في
Hudu	أربعة
&#39;yanci.	الحرية.
XRaiseWindow	XRaiseWindow
malpractice	سوء التصرف
WAYAR:	الهاتف:
comets,	المذنبات،
bayyane	ظاهر
sani.	أعرف.
USA	الولايات المتحدة الأمريكية
jituwa	متوافق
Luka	لوقا
nasarar	فوز
&#39;Ni	&#39;I
agogon	راقب
dãɗin	الراحة
Sama.	أعلاه.
kwatancen?	مقارنات؟
sani,	أعرف،
bayyana	ظهر
daji	وحشي
shiri	خطة
digiri.	درجة.
anecdotal	القولية
1ff,&gt;	1ff &amp; GT؛
tabbataccen	واضح
indicting	توجيه الاتهام
Agusta	آب
alewa	حلوى
tsari&quot;.	عملية ومثل؛
(yadda	(
Länder	تعداها
gilkey,	gilkey
Dr.	الدكتور
alternating	بالتناوب
&quot;pop	على &amp; quot؛ البوب
ƙone	حرق
kangara	متغطرس
sanar	أعلن
&quot;dual	على &amp; quot؛ المزدوج
kangare	متغطرس
zamba&gt;	الحيل &amp; GT؛
LaStrange	LaStrange
////	////
Moroccan	مغربي
henry@zoo.toronto.edu	html>
&quot;wuya&quot;	على &amp; quot؛ الصعب ومثل؛
Kattai.	عمالقة.
sharudda.	المعايير.
unethical.	غير أخلاقية.
Lindroos	Lindroos
wanda&gt;	وGT.
Dod	وزارة الدفاع
3511,	3511،
bitnet:	البتنت:
Fang	ناب
1024	1024
sauyin	المناخ
DOS6	DOS6
batting	الضرب
Support	دعم
Huh?	هاه؟
Finney	فيني
azumi	بسرعة
withs	withs
DOS.	DOS.
dai,	ومع ذلك،
&quot;x9&quot;	على &amp; quot؛ X9 ومثل؛
Hui)	هوى)
amfanin:	الفوائد:
sanda	شرطة
&#39;yanci	حرية
baya&quot;.	الظهر ومثل؛
Lucifer,	لوسيفر،
farjinsu	عفة
cikin&gt;	وGT.
karshen	نهاية
daga	من
Dos	دوس
Tun	منذ
100k	100K
Don	إلى
codified	دونت
more.	أكثر من ذلك.
goyan	أيد
Jon.	جون.
Nazarin	دراسة
haka,	لذلك،
haka.	.
verbatim).	حرفيا).
tsoro.	الخوف.
neccities	neccities
altimeter	الألتميتر
orthodoxy	العقيدة
hakkin	حق
Mafarki	حلم
(Amirkawa)	(الأميركيين)
namiji,	الذكور،
horo.	التدريب.
Buffalo	جاموس
da&#39;awar,	مطالبة
jamiái	وكلاء
*************************	*************************
ƙahonin	قرون
Magazine	مجلة
Ƙara	وعلاوة على ذلك
cikin	ال
exeption.	اكسيبشن.
girgizar	زلزال
wahayi	كشف
saura	حقل
size.	الحجم.
size,	حجم،
sauri	أسرع
(Steve	(ستيف
Bloom,	ازهر،
saukar.	إلى أسفل.
Georgetown,	جورج تاون،
tun&gt;	منذ وGT.
Harshen	لغة
saukar,	إلى أسفل،
yaudarar	مضلل
(Kirk	(كيرك
Kristanci	مسيحية
&quot;duk	على &amp; quot؛ جميع
​​Lee	لي
rem	عيني
cancantar	مستحق
miles).	ميلا).
{asar	الولايات المتحدة
TIFF,	TIFF،
Proud	فخور
-428-0800	-428-0800
ciki.	الداخلية.
ciki,	بما في ذلك،
John	جون
Rifleman&quot;,	الرامي ومثل،،
Pluto,	بلوتو،
Pluto.	بلوتو.
qananan	قاصر
Assurance	تأمين
Spencer)	سبنسر)
description	وصف
sauti	صوت
Ashe,	ديك
latsa	صحافة
Overall	عموما
vertically	عموديا
Dave	ديف
lahadi	يوم الأحد
lura:&gt;:	ملاحظة: &amp; GT؛:
Tapered	مدبب
dila	تاجر
tvtwm,	tvtwm
daya.&quot;	واحد ومثل؛
Heat	حرارة
override	تجاوز
-486-9975	-486-9975
17th,	17،
lãbãri	قصة
&lt;Ba.	العلامة &amp; lt؛ رقم
raw	الخام
martani	ردود
din.	الدين.
jon,	جون،
Daya	واحد
taƙawa	الحذر
Tabbatar	أكد
farko.	لأول مرة.
farko,	أولا،
rind@enterprise.bih.harvard.edu	html>
Sannu,	مرحبا،
...&gt;&gt;&gt;	... وطن؛ &amp; GT؛ &amp; GT؛
adaftan.	محول.
Alan	آلان
Alal	ل
Ni,	لي
5X9&gt;&gt;	5X9 &amp; GT؛ &amp; GT؛
perturbations	الاضطرابات
girgije.	الغيوم.
commited	ارتكبت
axis	محور
girgije,	الغيوم،
Systems&gt;	نظم &amp; GT؛
New	جديد
gaya,	وقال،
inorganic	غير العضوية
direbobi	السائقين
rai	حياة
ran	متوقع
&quot;gani&quot;,	على &amp; quot؛ نرى ومثل،،
luwadi	مثليون جنسيا
rijiya-gina	حسن البناء
gabas-da-yamma	الشرق إلى الغرب
Amsawa	رد فعل
^^^^^^^^^^^^^^^^^^^^^^^^^^^	^^^^^^^^^^^^^^^^^^^^^^^^^^^
kofin	كوب
ƙarin,	أكثر
tambayoyi	الأسئلة
Yake	هل
8,000	8000
Leifson)	Leifson)
farkon	في وقت مبكر
aninai!	سنت!
Shari&#39;ar	محاكمة
halaka&quot;&gt;	دمرت ومثل؛ &amp; GT؛
alamu	أنماط
sunadarai.	المواد الكيميائية.
yiwuwar	إمكانية
gajeren	باختصار
kumburi	التهاب
alama	ميزة
sabuwa&gt;	جديد &amp; GT؛
AMMA	BUT
1986,	1986
1986.	1986.
WNCI	WNCI
sauya	تغيير
free,	مجانا،
Ra&#39;ayin?	الفكرة؟
Syria	سوريا
kanka,	نفسك،
(22,238	(22238
Soviet	السوفييتي
10,000	10000
clipper	مجز
Yana	هل
alhẽri?	خير؟
1985.	1985.
&lt;mvanheyn@cs.indiana.edu&gt;	العلامة &amp; lt؛ mvanheyn@cs.indiana.edu&amp;gt.
Whethe	Whethe
motif.	عزر.
Venus.	فينوس.
UNIX	UNIX
kome&gt;	أي شيء &amp; GT؛
jikinsa,	الجسم،
faifai	أسطوانة
clears	ثبات
tofa	بصاق
Venus,	فينوس،
kasancewa	توفر
nagle@netcom.com	html>
gudãnar	محركات
Wanda	التي
acetylene	الأستيلين غاز عديم اللون
Ground	أرض
Nan	هنا
kalmomi.	الكلمات.
seethes	يغلي
Explorer	المستكشف
daina&gt;	وقف &amp; GT؛
bindigogi	البنادق
1983.	1983.
Wadannan&gt;	هذه وGT.
Utopia	المدينة الفاضلة
kwayar	تفاحة
core.	الأساسية.
ka&#39;idojin?	المبادئ؟
core,	الأساسية،
kwayan	بكتيريا
palastenians	palastenians
ulysses.att..com	ulysses.att..com
Europa,	أوروبا،
mahautsini!	خلاط!
kwantar	بارد
ka&#39;idojin.	المبادئ.
misali	مثال
lafiya.	الصحة.
al&#39;ummomi.	أجيال.
lafiya,	الصحة
doka,	القانون،
doka.	قانون.
Columbia,	كولومبيا،
igiyoyin	التيارات
almajiran)	التلاميذ)
***************	***************
kalmomin	كلام
dagagge	مرتفع
labarai	أخبار
overlapping	تداخل
1981.	1981.
cakuda	مزيج
tsanani	حاد
Stores	مخازن
amfani&gt;	استخدام &amp; GT؛
al&#39;adu	ثقافة
rip	مزق
fadowa	هبوط
Bisimillah	هتاف
lafiyar	الصحة
al&#39;ada	عرف
&quot;dogon	على &amp; quot؛ منذ فترة طويلة
1980,	1980،
Littafi,	الكتاب،
Bzzt!	Bzzt!
-rigth	-rigth
alaka	ذات الصلة
Timmons)	تيمونس)
Timmons,	تيمونس،
kwamfutarka.	الكمبيوتر.
shrank,	انكمش،
5-11,	11/05،
promiscuous&quot;	منحل ومثل؛
martian,	المريخ،
hrubin@pop.stat.purdue.edu	html>
makamai	أسلحة
Nissan.	نيسان.
Celsius,	مئوية،
kaya,	المخزون،
Salah)	صلاح)
kaya)	المخزون)
Attaura?	القانون؟
kaya.	الاشياء.
wayar	هاتف
rinjaye	أغلبية
kasancewa&gt;	يجري &amp; GT؛
(Leong	(يونغ
martyj@mrcnext.cso.uiuc.edu	html>
wahala	صعوبة
kaɗan	القليل
Attaura,	القانون،
Attaura.	قانون.
&lt;1qnb9tINN7ff@rave.larc.nasa.gov&gt;	العلامة &amp; lt؛ 1qnb9tINN7ff@rave.larc.nasa.gov&amp;gt.
accuire	accuire
inherently	بطبيعتها
&quot;tuna	على &amp; quot؛ تذكر
quack,&gt;	الدجال، وGT.
97,9	97.9
&quot;Duk	على &amp; quot؛ جميع
GSX-145	GSX-145
teams	فرق
nasaba	مرتبط
akwati	حاوية
Comics.	الكوميديا.
Mives	Mives
Control	سيطرة
ƙasa-moon-rãnã	الأرض مون سون
kayan	معدات
hanyar.	الطريقة.
reeves)	ريفز)
cfaehl@vesta.unm.edu	html>
hula.	الحد الأقصى.
hanyar,	الطريقة،
bisa,	أعلاه،
&quot;q	على &amp; quot؛ ف
Iyakar	الحدود
hanyar)	الطريق)
cryptography.	التشفير.
sadar	يربط
goyon	دعم
brian@gab.unt.edu	html>
comp.sys.ibm.pc.hardware	comp.sys.ibm.pc.hardware
Jahannama	الجحيم
bukatar.	تحتاج إليها.
Canucks	كنوكس
(Sam	(سام
samfurori	المنتجات
horar	تدريب
Stephen	ستيفن
Livermore,	ليفرمور،
kullum	يوميا
FRED&#39;S	فريد
&#39;halitta	&quot;مكون
likitoci	الأطباء
Redelfs)	Redelfs)
des-kamar	دي مثل
nstassen@magnus.acs.ohio-state.edu	html>
addu&#39;a&gt;	الصلاة و GT.
lokuta,	الحالات،
Ibrahim,	إبراهيم،
&quot;	على &amp; quot؛
harshe	لغة
Addu&#39;a	صلاة
samuwar.	تشكيل.
yisti	خبز
kammala.	الانتهاء.
hannun	يد
riko,	يتصرف
Kuma,	و،
Maxwell	ماكسويل
imputs	imputs
sada?	ودية؟
fushin	غضب
&quot;wutsiyoyi.&quot;	على &amp; quot؛. ذيول على &amp; quot؛
Electronics	الإلكترونيات
jikinsu.	الهيئات.
daraja,	قيمتها،
rairayi.	الرمال.
Neptune.	نبتون.
wuraren	الأماكن
Neptune,	نبتون،
486-33DX)	486-33DX)
blank.	فارغا.
saukad	قطرات
hulda	اتصال
Attaura&quot;&gt;	القانون ومثل؛ &amp; GT؛
ohms	أوم
martians	المريخ
terrestrial	أرضي
saukar	أسفل
yiwuwa.	ممكن.
yiwuwa,	ربما،
&quot;karshe	على &amp; quot؛ النهائي
==========	==========
Tsarki,)	نقاء)
(Carl	(كارل
&#39;gnostein?&#39;	Gnostein؟
hannu.	اليد.
Kwatancen,	المقارنات،
hannu,	المحمول،
1989,	1989
makafi),	أعمى)،
durkushe	انهيار
Wagner,	واغنر،
Howdy	مرحبا
Coons)	كونز)
kogin	نهر
yiwu	ممكن
eruptions	الثورات
-Karl&gt;	-Karl وطن.
(ncsc8!	(Ncsc8!
tashoshin	محطات
lin)	لين)
tarayya	الاتحادية
fang@en.ecn.purdue.edu	html>
Sharma	شارما
asibitin&gt;	مستشفى &amp; GT؛
telescopic	تلسكوبي
sai	و
Duniya.	العالم.
Duniya,	عالم
anti-gun	مكافحة بندقية
carbon	كربون
Anecdotal	القولية
sauki.	من السهل.
upgradable	ترقية
tafsirin	تفسير
Everest.	ايفرست.
san	تعرف
sau	مرات
spec&#39;d	spec&#39;d
years	سنوات
zaune	المعيشة
zauna	إقامة
line	خط
Bulus	بول
sa,	،
Properties	عقارات
yankuna&#39;.	المناطق.
nauyin&gt;	الوزن وGT.
(Bryan	(بريان
taskõkin	الكنوز
saƙonni	رسائل
(Kevin	(كيفن
SCSI	SCSI
free-mutumin	الرجل الحر
rahama	رحمة
Darryl	داريل
jumper	الطائر
muhimmanci	مهم
kowane,	كل،
kowane.	لكل منهما.
[ban	[بان كي مون
lilo	تصفح
&lt;&lt;	العلامة &amp; lt؛ العلامة &amp; lt؛
===	===
Rasha	روسيا
nema)	السعي)
fuka-fuki	أجنحة
dukan&gt;	كل وGT.
750.	750.
Thomas	توماس
lyme	لايم
&quot;manyan	على &amp; quot؛ كبيرة
&quot;doke	على &amp; quot؛ ضربات
RS-6903	RS-6903
mayar.	العودة.
All!	كل شيء!
amma&gt;	ولكن وGT.
Ohio	أوهايو
82%,	82٪،
Potvin,	Potvin،
ayoyi	الآيات
Gosh..I	Gosh..I
J.David.W.Reeves@dartmouth.edu	html>
m-dutsen	م-الصخور
&quot;Stephen	على &amp; quot؛ ستيفن
aep@world.std.com	html>
baƙin	فم
Ranger,	حارس،
Bentz	بنتز
sabanin	خلافا ل
(watakila	(ربما
Kusa-guguwa	شبه الإعصار
&lt;	العلامة &amp; lt؛
Littattafan	كتب
haka?	لذلك؟
yini	يوم
sanya&gt;	قدم &amp; GT؛
kyau&gt;	الجمال و GT.
natonal	natonal
Suzuki	سوزوكي
sojojin	القوات
Spencer	سبنسر
saukin	بسهولة
emulators	محاكاة
Center.	المركز.
Planitia	بلانيتيا
awon	مختبر
makanikai	علم الميكانيكا
launi	اللون
akwai.	هناك.
!!&quot;	!! على &amp; quot؛
makullin	مفاتيح
Winslow,	وينسلو،
sha	شراب
zagayowar,	دورة،
&#39;Allah&quot;	&quot;الله ومثل؛
SU&gt;	SU &amp; GT؛
16804	16804
University	الجامعة
kekuna,	الدراجات،
safiya	صباح
bãya,	بعيدا،
Gaba	التالي
bãya.	بعيدا.
aikace-aikace	تطبيقات
unguwa	حي
(JPS)	(JPS)
bashin	دين
shi	هو
(All	(جميع
sashen	قسم
Washington.	واشنطن.
nasara	فوز
laifuka,	الجرائم،
sadarwa	الإتصالات
garkuwoyi	الدروع
Dayton,	دايتون،
matakai.	الخطوات.
_in	_in
kafar	قدم
safiyo	مساح أراضي
ruwan.	المياه.
ƙarƙashin	تحت
ruwan,	الماء،
macijin	دودة
ƙãrẽwar	الإنفاق
kuka)	أنت)
madalla	ممتاز
siriyal,	المسلسل،
lasisi	ترخيص
kwaikwayo	مسرح
(______________________________________)	(______________________________________)
lafiya&quot;.	الصحة ومثل؛
saman&gt;	أعلى وGT.
Pgf@srl02.cacs.usl.edu|Like	Pgf@srl02.cacs.usl.edu|Like
10/82	10/82
Amirka	الولايات المتحدة
Kawasaki	كاواساكي
(game	(معلومات
ɗaba&#39;ar	منشور
karkashin	تحت
keyboard	لوحة المفاتيح
1990.	1990.
1990,	1990،
bakin	فم
birki	فرامل
jerin	قائمة
ekdfc@ttacs1.ttu.edu	html>
College	كلية
fama.	القتال.
4Runner&gt;	4RUNNER &amp; GT؛
Domin	ل
Oh,	أوه،
Djakarta,	جاكرتا،
4/26/93.	4/26/93.
Ok,	طيب،
Callisto	كاليستو
anecdotally&gt;	الروايات المتناقلة &amp; GT؛
promiscuity	اختلاط
Space	الفضاء
6/91	6/91
qananan)	قاصر)
akidarsu	عقيدة
abinda&gt;	ما وGT.
daidaita	ضبط
barbashi	الجسيمات
Canada,	كندا،
karfafa	تعزيز
Fla.	فلوريدا.
00ECGILLESPIE	00ECGILLESPIE
kasar,	البلد
daidaito	اتساق
-14	-14
degeneration.	انحطاط.
irregularly	غير منتظم
Scharfy)	Scharfy)
ne,&gt;	وGT.
hours).	ساعة).
ƙofar	بوابة
ƙoƙari	جهود
ganewa	تحديد
2230	2230
(Amy	(ايمي
PMS	PMS
kafin	قبل
fatauci,	التجارة،
Kuna	أنت
biyan&gt;	الشحن و GT.
rauni.	إصابة.
Franjione	Franjione
HOMOSEXUAL-	HOMOSEXUAL-
rocketry	علم الصواريخ
complexities	التعقيدات
Kaufman)	كوفمان)
Telecope	Telecope
Kuma	و
Volcanic	بركاني
Edwin	إدوين
barci.	النوم.
barci,	النوم،
murya:	صوت:
gida-daga	المنزل من
cleanly	نظيف
zaben	انتخابات
maƙiya&gt;	أعداء &amp; GT؛
outermost	الأبعد
Duba	رأي
retinue	حاشية الملك
Ludwick&quot;	Ludwick ومثل؛
bigots.	المتعصبين.
(Andrew	(أندرو
game,&gt;&gt;	وGT؛ &amp; GT؛
(Tobiya	(توبياس
(3,010	(3010
haƙuri.	آسف.
(-184	(-184
files:	ملفات:
haƙuri,	آسف،
mika&gt;	عرض &amp; GT؛
amino	الأمينية
tulun,	جرة،
son	حب
girgije	سحاب
shãfe	لمس
inganci&gt;	الجودة وGT.
ni&gt;	I &amp; GT؛
babban&gt;	و&amp; GT؛
---	---
&#39;.	&quot;.
leanings,	الميول،
invading	الغازية
Ryan	ريان
records	تسجيل
Hoffman	هوفمان
su!	!
themon	themon
zabi.	الخيار.
korean,	الكورية،
File,	ملف،
gudun;	السرعة؛
alt.atheism	alt.atheism
Santa	سانتا
1999.	1999.
crisscrossing	يتنقل
&quot;Lyme	على &amp; quot؛ لايم
Stanza	مقطع شعري
ambaliyar	الفيضانات
10&quot;,	10 ومثل،،
gaseous	غازي
handgun,	مسدس،
dazzling	باهر
gangaren	منحدرات
a&gt;	و&amp; GT؛
addu&#39;a	صلاة
20th	20
ma&#39;amaloli.	صفقة.
haraji	الضرائب
Multiprobe	Multiprobe
alama.	الميزة.
hadisai	تقاليد
--clh]	--clh
hukuncin	حكم
dimbin	الشكل
&lt;C5r60r	العلامة &amp; lt؛ C5r60r
kishili.	مثلي الجنس.
___	___
kishili,	مثلي الجنس،
shipping	الشحن
hankula	نموذجي
lvc@cbnews.cb.att.com	html>
tebur	جدول
1993,	1993
sababinsa,	ها
Gyara:	تحرير:
deceleration.	التباطؤ.
yaƙi	عراك
Altimas	Altimas
&quot;gabar&quot;	على &amp; quot؛ بمعنى ومثل؛
Candida	المبيضات
freezes	تجميد
bayyananniya	واضح
(cyanide	(السيانيد
awa,	ساعة،
tsawon	فترة
1992,	1992
adam@das.harvard.edu	html>
dole.	يجب.
hukunci.	القاضي.
radioed	اسلكيا
William	وليام
kwanda!	المعضلة!
shĩ	هو
Mamaki	مفاجأة
wa&#39;azi	تعليمات
&#39;:	&#39;:
Lauria)	لوري)
juna.	بعضها البعض.
handers.	يستخدمون اليد.
juna,	بعضها البعض،
real	حقيقي
kewayewa	مدار
makamashi.	الطاقة.
1995,	1995
articals	عناوين مختارة
Turawa	دفع
apples	تفاح
daviss@sweetpea.jsc.nasa.gov	html>
tauraron-dan	نجمة وابنه
Bayyana	ظهر
[magana	[حديث
19947	19947
so,	أراد،
forsale	FORSALE
so.	تريد.
Altima,	ألتيما،
Obo	أوبو
so;	الوصايا.
maimakon	بدلا من
dalili	سبب
^^^^^	^^^^^
teams.	فرق.
Gen3:	Gen3:
&#39;s	&#39;S
PCX	PCX
hali&quot;	حرف ومثل؛
HCI.	حمض الهيدروكلوريك.
bangarori	لوحات
so)	تريد)
diamita	قطر
&#39;m	M
gidajen	منازل
mugu.	سيئة.
luck.	الحظ.
hankali.	الاهتمام.
dokoki.	القواعد.
hankali,	الاستخبارات،
Poster	الملصق
ergonomically	هندسيا
tarihi,	التاريخ،
tamu-fadi	على نطاق الكوكب
wakeup	التنبيه
hyundai	مخاضة
shirin	برنامج
tarihi.	التاريخ.
Dale	واد بلغة الشعر
isolator&quot;	المعزل ومثل؛
Out	خارج
babura,	الدراجات النارية،
Our	لنا
32-bit).	32-بت).
kasada	مغامرة
happed	happed
babura.	الدراجات النارية.
strawman	strawman
27611@athos.rutgers.edu,	27611@athos.rutgers.edu
cypher.	سايفر.
96,5	96.5
folta@zen.holonet.net	html>
Skelton	سكيلتون
direba	سائق
Cikin	ال
zuriyar	بذرة
marubuta	الكتاب
yankin.	منطقة.
dokokin	قوانين
yankin,	المنطقة
-oOOO	-oOOO
shirye-shirye	برامج
astein@nysernet.org	html>
buƙaci	وحث
asali	أصلي
cututtuka,&gt;	الأمراض، وGT.
marigayi	متأخر
yankin:	المنطقة:
^^^^^^^^^^^^^^^^^^^^^^^^^^^^^^^^^^^^^^^^^^^^^	^^^^^^^^^^^^^^^^^^^^^^^^^^^^^^^^^^^^^^^^^^^^^
ko&#39;ina	في كل مكان
sharma@monet.vill.edu	html>
Patient-Likita	المريض طبيب
Qasa	أرض
Kolodny	Kolodny
(Dick	(ديك
kasafi	توزيع
BMP,	BMP،
sguerke@ravel.udel.edu	html>
OTOH,	OTOH،
Oliveira	أوليفيرا
kõme	لا شيء
GMT,	GMT
sadarin	طوية
kfrank@magnus.acs.ohio-state.edu	html>
kwamfutarka?	الكمبيوتر؟
9600	9600
Wancan	أن
Independence.	الاستقلال.
coalesced	ملتئم
baka.	القوس.
su.	.
su,	،
hans@xelion.nl	html>
sha&#39;awar,	مهتمة،
Motherboards	اللوحات الأم
rake,	أشعل النار،
Huduba&gt;	عظة &amp; GT؛
kamar&gt;	كما وGT.
&#39;Larabawa.	&quot;العربية.
SMARTDRV	SMARTDRV
labarin	قصة
lankford	lankford
Williams,	وليامز،
muhalli.	البيئة.
watau,	أي
&quot;hankula&quot;	على &amp; quot؛ نموذجي ومثل؛
Bayan	بعد
kudi	نقود
Report	تقرير
ɗakin	غرفة
manta	ننسى
makale,	تمسك،
kundin	مجلدات
sun	هم
tarihin	تاريخ
Frank)	فرانك)
kudu	جنوب
rakes	مكابس
televison.&quot;	تليفزيون ومثل؛
wakilci	التمثيل
kwalban	زجاجة
shuka	مصنع
taɓa	أبدا
malami	معلم
Wakiltar	يمثل
holsend@mhd.moorhead.msus.edu	html>
Wasiku	رسائل
Daga	من
decrypting	فك تشفير
cyphers	كيبهيرس
(Robert	(روبرت
main-bel	الرئيسية الحزام
subwindows	subwindows
kyakkyawa	الجمال
addinin	دين
FORSALE	FORSALE
sallama	عرض
Callisto,	كاليستو،
sauka	أسفل
Disclaim-ta:	نخلي:
wurare	المواقع
statistics&gt;	إحصاءات &amp; GT؛
aboki	صديق
weather	حالة الطقس
(12V	(12V
===========================================	===========================================
WP51	WP51
addini,	الدين،
kusoshi	المسامير
addini.	الدين.
hali,	حرف،
gurin	إشتهى ملك غيره
kungiyoyin	المجموعات
&lt;1993Apr22.153959.12328@ucsu.Colorado.EDU&gt;	العلامة &amp; lt؛ 1993Apr22.153959.12328@ucsu.Colorado.EDU&amp;gt.
hali.	الطابع.
Latin	لاتينية
addini?	الدين؟
pitchers	أباريق
hayaniya	ضجيج
(125	(125
cyanide.	السيانيد.
tap	صنبور
(JPL)	(JPL)
shiryawa	حزم
Dark	ظلام
reno	تمريض
Lawrence	لورانس
&lt;1qkoel$5fr@horus.ap.mchp.sni.de&gt;,	العلامة &amp; lt؛ 1qkoel$5fr@horus.ap.mchp.sni.de&amp;gt،،
rufe	إغلاق
Musa,	موسى
likitoci).	الأطباء).
(Stephen	(ستيفن
Geiger	جيجر
mahaukaci	مجنون
halin	حرف
aminci&quot;	السلامة ومثل؛
&lt;C5DxBs.5ov@panix.com&gt;	العلامة &amp; lt؛ C5DxBs.5ov@panix.com&amp;gt.
&quot;wasanni&quot;	على &amp; quot؛ &amp; الرياضة مثل؛
****	****
dual-Sport	المزدوج الرياضة
liscenced	liscenced
PS:	PS:
sãmun	تجد
baki,	الأسود،
Fusion.	الانصهار.
kõma	عودة
ƙwalo	رئيس الوزراء
halfway	في منتصف الطريق
(175	(175
rufaffiyar	إغلاق
Rayuwa	حياة
NUNNALLY@acs.harding.edu	html>
Duo)	ديو)
[...	[...
canals	القنوات
WOW!	WOW!
&quot;Kada	على &amp; quot؛ دو
bearings	اتجاهات
kafa,	مجموعة،
psyrobtw@ubvms.cc.buffalo.edu	html>
gudãna).	التدفق).
Kirista.	مسيحي.
sosai&gt;	جدا وGT.
(RvKampen)	(RvKampen)
karni.	القرن.
kafa.	مجموعة.
!!!!	!!!!
bangaskiya.	الإيمان.
Phil	فيل
unravel	كشف
yaushe	دائما
Kirista?	مسيحي؟
lasis.	الترخيص.
....&gt;&gt;&gt;&gt;	--- وطن؛ &amp; GT؛ &amp; GT؛ &amp; GT؛
(yawanci	(وعادة ما
banschbach@vms.ocom.okstate.edu	html>
Willis)	ويليس)
wutsiya,	الذيل،
ta)	)
ta,	،
labulen	ستارة
&quot;bude&quot;	على &amp; quot؛ فتح &amp; مثل؛
Turai.	أوروبا.
Damu	قلق
Turai,	أوروبا
PTO	PTO
bakes	يخبز
ta?	؟
bãyar	المنح
babban	عظيم
harkokin	أجنبي
dokoki,	قواعد،
addinai	ديني
(Tim	(تيم
bãyan	بعد
sauki	سهل
kaina,	شخصيا،
ta.	.
uneventful,	هادئ،
sauke	قطرة
^^^^^^^^^^^^^^^^^^&gt;	^^^^^^^^^^^^^^^^^^ وطن.
Sani)	تعرف)
Duniya&gt;	العالم &amp; GT؛
diamita,	قطر،
kaina.	نفسي.
babbar	عظيم
dormant	نائمة
ta:	:
dole&gt;	يجب &amp; GT؛
French	اللغة الفرنسية
HRB.	فرع الموارد البشرية.
crumbling	المتداعية
matsala.	المشكلة.
gabansa	قبل
shorted	قلل
abincin	طعام
14-19?	14-19؟
Ajiye	حفظ
View,	رأي
bautawa	إله
nake	أنا
Point	نقطة
nan.	.
nan,	ثم،
zobba	خواتم
toml@boulder.parcplace.com	html>
kenyee	kenyee
shekarar	عام
defenseless	العزل
ƙulli]	إغلاق]
bit	قطعة
20-39	20-39
key,	مفتاح،
(gregh@niagara.dcrt.nih.gov)	(Gregh@niagara.dcrt.nih.gov)
key.	المفتاح.
bin	بن
nan)	)
9.256	9256
....	....
ƙarfe-arziki	غني بالمعادن
yiwuwar,	الاحتمال،
Allah&gt;	الله &amp; GT؛
lankford,	lankford
kura	غبار
...:	...:
Munns)	مونس)
(39.95)	(39.95)
...?	...؟
amfilifa	مكبر الصوت
Roger.	روجر.
imbin	لا يحصى
zuriyarka	بذرة
(Tom	(توم
Italiya	إيطاليا
tamkar	كما
&quot;jargon&quot;,	على &amp; quot؛ &amp; المصطلحات مثل،،
albarkatun	موارد
shekara,	عام
binciken	مسح
kusa	قريب
dabara	خطة
kyakkyawan	خير
shekara.	السنة.
sassa	أجزاء
(Hãrũna	(آرون
keya	keyat
Allen	ألين
dabaru	تقنيات
masana	الخبراء
Goolsbey)	Goolsbey)
jikinsu	الهيئات
bob	تمايل
daya.	واحدة.
daya,	احد،
-Arlo	-Arlo
Florida	فلوريدا
Mutum	رجل
foda	مسحوق
kera	المصنعين
sifa	سمة
(mu	(
crack	صدع
talla	إعلان
bincike.	البحث.
&quot;90%	على &amp; quot؛ 90٪
(na	(
kirki.	جيدة.
kirki,	المعرض،
&lt;rauser.734062608@sfu.ca&gt;,	العلامة &amp; lt؛ rauser.734062608@sfu.ca&amp;gt،،
...)	...)
bmw	بي ام دبليو
...!	...!
yashwa.	تآكل.
balle	ولا
Ruhu-kai	Spirit-
tafiya&gt;	السفر وGT.
namu	لنا
(sabon)	(جديد)
Cuesta)	كويستا)
gwada	اختبار
(Frank	(فرانك
&lt;C5r60r.4ID@megatest.com&gt;,	العلامة &amp; lt؛ C5r60r.4ID@megatest.com&amp;gt،،
Detroit	ديترويت
gaske.	حقا.
gaske,	حقا،
Rasha,	روسيا،
wahayi.	إلهام.
nan?	هنا؟
wa&#39;adi	في حين
keta	انتهاك
zarar,	مرة واحدة،
dũkiyõyinsu	ممتلكات
falakinsu	مدارات
(ku	(
surveyed	شملهم الاستطلاع
jikinsa	هيئة
kuwa	و
Za&gt;	وطن.
whitsebd@nextwork.rose-hulman.edu	html>
Allah	الله
streaky	معرق
HITEN	HITEN
streaks	الشرائط
(ko	(أو
5.500	5500
benci.	مقاعد البدلاء.
Rauser@sfu.ca	html>
kuke	أنت
B433EI2.	B433EI2.
kuka	أنت
(bi	(اتبع
suna,	،
lura,	ملاحظة،
nuclei	نوى
4Runner	4RUNNER
(ba	(
RAM)	RAM)
hadari,	خطر،
nasu	خاص
yankunan	المناطق
kula	رعاية
1,000	1000
mũminai)	المؤمنين)
ban	أنا
computergenerated	computergenerated
bai	ليس
hujja	دليل
_your_	_your_
hadari.	العاصفة.
zamanin	عصر
&quot;Robert	على &amp; quot؛ روبرت
bad	سيئة
saukowa?	المقصودة؟
(as	(كما
kuma	و
mũminai.	المؤمنين.
bar	شريط
motherboard	اللوحة الأم
bincika.	البحث.
Imani	نعتقد
garken,	قطيع،
sunan	اسم
shirin.	برنامج.
&#39;sunlit	ومضاء بنور الشمس
niƙaƙƙun	فتات
flyby,	التحليق،
(bentz.e.puryear)	(Bentz.e.puryear)
flyby.	التحليق.
ƙarya,	كذبة،
yankuna.	المناطق.
ƙarya.	كسر.
Za&#39;a	يكون
Norway,	النرويج،
diyyar	السعر
spaceflight	رحلات الفضاء
dioxide	ثاني أكسيد
Norway:	النرويج:
Satumba	أيلول
haushi,	النباح،
cika.&quot;	ملء ومثل؛
Engineer	مهندس
Voyager	رحالة
gadon	قاع
Kunna	تفعيل
400,	400
***	***
saukowa	هبوط
matattu?	الأموات؟
ruwa	ماء
gchin@Eng.Sun.Com	html>
kamfanoni	الشركات
flybys	عملية تحليق
Rick.	ريك.
sabõda	إلى
House	منزل
Replica	طبق الاصل
illa	الآثار
clack	طقطقة
sana&#39;a&gt;	المهنية وGT.
bel	حزام
HIMEM.SYS	HIMEM.SYS
ilmi	تعليم
Colorado	كولورادو
matattu.	قتلى.
matattu,	ميت
(da	(
wajaba	مغلف
ammonia,	الأمونيا،
Zurfin	عمق
kididdiga	إحصائيات
kuna	أنت
matsalar	مشكلة
koyarwar	تدريس
Chryse	Chryse
ruwa-kankara,	المياه الجليدية،
domin	إلى
tsunduma	تشارك
ƙãga	منشئ
bi.	تلت ذلك.
dwarfs	الأقزام
play	لعب
Legge	يجي
nawa	لي
80111	80111
BAYANIN	حقائق
ƙayayuwa	الشوك
kusa-range	من مسافة قريبة
Goma	عشرة
ƙasa:	أدناه:
gays	مثليون جنسيا
ƙasa?	الأرض؟
pop	فرقعة
______________________________________	______________________________________
fariya	تباهى
Hukumar	وكالة
&quot;Turai	على &amp; quot؛ أوروبا
(Ya	(
sakonni?	الرسائل؟
Triton.	تريتون.
ilmin	تعليم
gaya	قال
kewaye	جولة
AntiSemitic	لا سامية
za&#39;a	يكون
Computer	كمبيوتر
kayayyakin	المنتجات
samfur	نتاج
la&#39;anta	مقاضاة
61153	61153
ƙasar	بلد
Yowel	جويل
(karanta	(اقرأ
kewaya	التنقل
Shapiro	شابيرو
Good	خير
boye-boye	التشفير
_him_	_him_
goma	عشرة
Tauraron	نجمة
kafin.	قبل.
motherboards,	اللوحات،
kawar	إزالة
kocin?	مدرب؟
electromechanical	الكهروميكانيكية
ilmi,	المعرفة،
kawai	فقط
kocin)	مدرب)
tafiyarwa	محركات
site	موقع
Items	البنود
ramummuka	فتحات
Wells,	الآبار،
ƙarfafa	تعزيز
Nunnally	يلال
kayayyaki,	التصاميم،
musanyãwa	تغيير
blomberg	بلومبرغ
tossing	القذف
gefe.	الجانب.
namiji	ذكر
Force	قوة
ƙasa,	أرض
583.&gt;	583. وGT.
Zagaye	جولة
sadarwa.	الاتصالات.
sito	مستودع
rigakafin	منع
kafin?	قبل؟
motherboards?	اللوحات الأم؟
ƙasa.	أدناه.
(Markus	(مارك
posters	ملصقات
1990s,	1990s،
experimentation.	التجريب.
mambobi	أعضاء
62,4	62.4
Laboratory	مختبر
su&quot;,	ومثل؛،
laushi	تليين
bep)	أفضل الممارسات البيئية)
busa	ضربة
ɗaya	واحد
Huhu)	الرئة)
ce:&gt;&gt;	وقال: &amp; GT؛ &amp; GT؛
promiscuous,	منحل،
Heart	قلب
six-	الست
Site	موقع
jirgin	طيران
&#39;^^^^^^&#39;,	^^^^^^
Gold&quot;)	الذهب ومثل؛)
workstation	محطة العمل
Ganymede	جانيميد
al&#39;ummai?	الأمم؟
saba.	المعتاد.
dans@uxa.cso.uiuc.edu	html>
Tambayar	مسألة
rumbun	من الصعب
-------------------	-------------------
daskare	تجمد
&quot;Sai	على &amp; quot؛
can	هناك
hali-kula	الحالات والشواهد
saba,	عادة،
hadarin	خطر
(fili)?	(من الواضح)؟
________)	________)
*******************	*******************
dawwama	لانهاية
shekaru,	سنوات،
san&gt;	تعرف &amp; GT؛
Company	شركة
shekaru.	سنوات.
ƙarya	زائف
karamin	صغير
NRA-bokan	سلطة المصادر الطبيعية معتمدة
(Microsoft	(مايكروسوفت
ayyana	معلن
Wings	أجنحة
siginar	إشارة
&#39;..:	..:
auku,	تمر،
alfarwansu,	الخيام،
X3153	X3153
tãguwar	أمواج
weightier	العلامه
goon	ثوب
giant,&quot;	عملاق، ومثل؛
Yahudu	اليهود
Goma?	عشرة؟
tasirin.	التسميات.
buga	نشرت
&lt;Fenton@Kaleida.Com&gt;	العلامة &amp; lt؛ Fenton@Kaleida.Com&amp;gt.
Chin)	الذقن)
bukukuwa.	كرات.
manufofin,	السياسات،
Bos)	بوس)
ƙãre	الانتهاء
Surgery,	جراحة،
buge	إضراب
gas.	الغاز.
gas,	الغاز،
expeditions,	البعثات،
karshe):&gt;	نهائي): &amp; GT؛
buy-bãyansu	شراء ظهورهم
Buyers	المشترين
Avenue	شارع
fatauci	تجارة
janar	الجنرال
Ĩsã	عيسى
gwaji	تجريب
(SF	(SF
Ishtar	عشتار
Pleiades,	الثريا،
Algeria	الجزائر
&quot;saya	على &amp; quot؛ شراء
(No	(لا يوجد
dubawa	تفتيش
zaben),	الانتخابات)،
(P.	(P.
Spiros	سبيروس
Foundation	أساس
fanareti	نهائي
B2:&gt;	B2: &amp; GT؛
geb@cadre.dsl.pitt.edu	html>
tattauna	بحث
(Juan	(خوان
ɗari	مركبات
makwabta	الجيران
Rubin	روبين
Kariya&quot;	حماية ومثل؛
(biyu	(اثنان
&quot;zumunta.&quot;	على &amp; quot؛ النسبية على &amp; quot؛
rage&gt;	تخفيض &amp; GT؛
itace	خشب
principally	أساسا
1Meg	1Meg
romantic	رومانسي
bel.	حزام.
bel,	حزام،
lowers&gt;	يخفض &amp; GT؛
gano	حدد
promiscuous?	منحل؟
Dabauá	THANX
gane	المعترف بها
Dokoki	قواعد
bude	فتح
Kentucky	كنتاكي
Titania	تيتانيا
Audio	سمعي
Arewa	شمال
gani	رؤية
386DX-40	386DX 40
bus	حافلة
ranked	المرتبة
Rauser)	Rauser)
mallaka!	تمتلك!
mutum-crewed	، يتكون طاقمها الإنسان
izni	ترخيص
Java	جافا
talla.	الإعلان.
maraba	ترحيب
healers	المعالجين
Medical	طبي
GMT&gt;	GMT &amp; GT؛
biyu-domin	اثنان ل
sarauta	ملك
tsanani!	على محمل الجد!
duwatsu.	الحجارة.
salula	الهاتف المحمول
tsanani)	شديد)
tsanani.	على محمل الجد.
bc744@cleveland.Freenet.Edu	html>
gadi).	مؤقتة).
Cirelli)	سيريلي)
Albertan,	Albertan،
ɗã&#39;a&gt;	مسار &amp; GT؛
caldwell8102@mtroyal.ab.ca	html>
amince,	متفق عليه،
sauransu	إلخ
rufe&quot;	مغلقة ومثل؛
cika?&quot;	كامل ومثل؛؟
gidana,	بيتي،
bege	أمل
vantage	أفضلية
toyota	تويوتا
Galant	جالانت
wayewa	حضارة
goyi	دعم
(Arthur	(آرثر
Welles	ويلز
sweeping	كنس
title-	title-
tsananin	حاد
abinci.	الغذاء.
deviants.	المنحرفين.
8.20).	8.20).
gare	إلى
jarraba	اختبار
jhardono@nickel.ucs.indiana.edu	html>
shiriya	توجيه
mallakar	قوة
quite	تماما
Energy	طاقة
kusurwa	زاوية
gchin@ssf.Eng.Sun.COM	html>
ARMM&quot;	مينداناو ومثل؛
ROM	ROM
aka	كان
taurãri.	النجوم.
ake	هي
bullshit	هراء
shan	مع الأخذ
matafiya	مسافرين
gaskiya.&quot;	صحيح ومثل؛
Shipper)	الشاحن)
aji	فئة
Verse	آية
matafiyi	مسافر
curly	مجعد
high-tsawo	ارتفاعات عالية
9.128	9128
Yarjejeniya	اتفاقية
mutane.	الناس.
posted,	نشرت،
mutane,	الناس،
dubban	الآلاف
laifuka	مجرم
yawansu	منهم
biyar,	خمسة
aika	أرسلت
AUTOEXEC.BAT	AUTOEXEC.BAT
image	صورة
baicin,	بدلا من ذلك،
Capacity:	القدرة:
jayayya	خلاف
akida,	مبادئ
tsirara	عري
Email	البريد الإلكتروني
batun&quot;	موضوع ومثل؛
Finney)	فيني)
*****************	*****************
Card)	بطاقة)
Tsakanin	بين
iko?&quot;	التحكم ومثل؛؟
Sha&#39;awa	ومن المثير للاهتمام
haihuwarka?	الدوائر؟
madigo?	مثليات؟
tamu.	بلدنا.
tamu,	لدينا،
Kada	فعل
Kristi.	المسيح.
haihuwarka,	الدوائر،
madigo.	السحاق.
8300	8300
-or-	أو-
Ta&#39;addanci	إرهاب
mutanen	الناس
recyle	تسمية recyle
wukake:	السكاكين:
VLB.	VLB.
daga&gt;	وGT.
quack,	الدجال،
Ilmin	تعليم
empiric&gt;	المجرب وGT.
engp2008@nusunix1.nus.sg	html>
Dokar	عمل
sadaukar	التزام
kwasfansu	قواعد
daban	مختلف
dabam	على حدة
wadãtar.	جدوى.
dabba	بهيمة
12-14)	12-14)
\&gt;	\ &amp; طن.
chilly	بارد
Lynn	لين
ne&gt;	وGT.
Alabama	ألاباما
amince	متفق عليه
&lt;1r1i7mINN4n4@cronkite.cisco.com&gt;,	العلامة &amp; lt؛ 1r1i7mINN4n4@cronkite.cisco.com&amp;gt،،
aminci	سلامة
wurin&gt;	وGT.
Tarayyar	اتحاد
^^^^^^^^^^^^^^^^^^^^^^^^^^^^^^	^^^^^^^^^^^^^^^^^^^^^^^^^^^^^^
Lyme	لايم
Isreal.	لي اهله.
powerbook.	بووربووك.
gwajin	اختبار
ana	هي
sabon	جديد
annabawa.	الأنبياء.
sharuddan),	المصطلحات)،
Hitter,	ضاربا
Repo	الريبو
shi,	،
Villanova	فيلانوفا
Orson	أورسون
amo	ضجيج
shi.	.
cutarwa,	ضارة،
zunubansu&gt;	خطايا وGT.
ANYI	تم
misinformed	معلومات خاطئة
---------------------------------	---------------------------------
kananan	أدنى
aiki	عمل
neman	بحث
P7625)	P7625)
darajõji	درجات
hadaddun	مجمع
leka	الممسوحة ضوئيا
aiko	أرسلت
Punjabi)	الشعور بالوحدة)
&quot;un-izini&quot;	على &amp; quot؛ برنامج الأمم المتحدة للأذن ومثل؛
gwaji.	الاختبار.
methane,	الميثان،
methane.	الميثان.
game	حول
rawaya	أصفر
raina	لي
;-)	؛-)
kankanin	صغير
500.	500.
daidai.	بالضبط.
+31	+31
S.)	S.)
daidai,	الحق،
kasuwa	سوق
gama	إلى
(nemi	(طلب
pacifist	مسالم
Alkawari,	المعاهدة،
overrepresented	ممثلة تمثيلا زائدا
Pluto	بلوتو
daidai!	بالضبط!
buga.	نشرت.
suma,	أيضا،
Tashin	الأعمال العدائية
dumi.	الحارة.
iƙirari	المطالبات
&#39;mu&#39;&gt;	&#39;&#39; وطن.
&#39;yan&#39;uwa	الاخوة
ƙasã	أرض
Ottawa,	أوتاوا،
abu	شيء
=============================	=============================
siffa	ميزة
Amurka.	الولايات المتحدة.
417-4101	417-4101
Randall	راندال
aibi	عيب
firist.	الكاهن.
tafiya.	المشي.
Timothawus	الثيموثية عشب
willisw@coe-nw.clemson.edu	html>
gyarawa	ثابت
magana&quot;.	الحديث ومثل؛
Karshen	نهاية
Micronics	MICRONICS
fam),	جنيه)،
tsananta	اضطهاد
Attaura&quot;?	القانون ومثل؛؟
Schuster)	شوستر)
musu,&quot;	لهم، ومثل؛
makonni.	أسابيع.
&lt;1993Apr21.182606.6798@ra.royalroads.ca&gt;	العلامة &amp; lt؛ 1993Apr21.182606.6798@ra.royalroads.ca&amp;gt.
Krista.	CHRISTIAN.
mota	سيارة
DR350S	DR350S
&quot;biya&quot;	على &amp; quot؛ دفع &amp; مثل؛
wayo!	ذكية!
nazari	بحث
**********	**********
Italian	الإيطالي
tawagar	فريق
daftarorin	الوثائق
Saturnian	زحل
gravitationally	الجاذبية
DMA),	اليمين)،
&quot;A	على &amp; quot؛ A
Fenton	فنتون
tafiyar	سفر
bindiga-dokokin.	القوانين بندقية.
darajar,	القيمة،
rayu&gt;	يعيش &amp; GT؛
zumunta	قريب
&quot;,	على &amp; quot؛،
Annabi	نبي
&quot;-	على &amp; quot؛ -
sunan,	اسم،
&quot;.	على &amp; quot؛.
m-it2691@cs.nyu.edu	html>
&#39;hanyar	&#39;السبب
Ishaku,	إسحاق،
ƙasa	أرض
Kana	أنت
malami.&quot;	. المعلم ومثل؛
inganci	فعال
Almajiran	التلاميذ
dlb@hudson.wash.inmet.com	html>
gaba	التالي
argon,	الأرجون،
dukiya,	الملكية،
dukiya.	الملكية.
SUPERVGA	SUPERVGA
watakila.	ربما.
ƙari	ملحقات
ƙare	حماية
ƙara	المزيد
Askew	منحرف
Kama	مزلاج
ainihi&gt;	الهوية وGT.
ka&gt;	وGT.
^^^^&gt;	^^^^ وطن.
daliban	طلاب
sauki&gt;	من السهل &amp; GT؛
quacks	والدجالين
Nitrogen	نتروجين
dalibai	طلاب
ado	مجوهرات
Ulysses,	أوليسيس،
moon	هلال
Lantarki	إلكتروني
&quot;asirai&quot;	على &amp; quot؛ أسرار ومثل؛
taron,	مؤتمر
Whitsell	Whitsell
KRISTI	المسيح
Asalin	الأصل
gadi	مؤقت
KASHE	OFF
jama&#39;a	جمهور
hanyoyi	الطرق
gada	جسر
Solar	الطاقة الشمسية
alternately	بالتناوب
++.	++.
warkar	شفاء
aiwatar&gt;	عملية وGT.
613)	613)
&lt;15378	العلامة &amp; lt؛ 15378
liwadi	المثلية
Costner	كوستنر
cinye	تستهلك
bene.	الكلمة.
har,	و،
hambidge@bms.com	html>
18:33	18:33
benci	مقعد
bene,	الكلمة،
hannu	يدويا
iko,	السلطة،
DBD@ICF.HRB.COM	html>
iko)	السيطرة)
(Clayton	(كلايتون
zãlunci	خاطئ
theists)	الخروج من الملة)
Guerke,	Guerke
Guerke)	Guerke)
Cant	رياء
theists,	الخروج من الملة،
masõyansa	أحباء
&#39;bude&#39;.	&#39;فتح&#39;.
tãyar	أثار
Project	مشروع
aza	حمل
cuta,	المرض،
mamaki:	مفاجأة:
cuta.	المرض.
Cape	كيب
(ya	(
gaisuwa	تحية
Kewaye	جولة
cyphers?)	كيبهيرس؟)
untimely	المفاجئة
madadin&gt;	النسخ الاحتياطي وGT.
waje.	خارج.
11:26),	11:26)،
kasuwanci&quot;,	الأعمال ومثل،،
Karl	كارل
addinĩna	ديني
Sabres,	السيوف،
filastik	البلاستيك
ciki	كآبة
3-8),	3-8)،
cike	كامل
Surveyor	مساح أراضي
kekuna	راكبي الدراجات
ci-gaba	متقدم
azurta	المقدمة
(Herman	(هيرمان
kãma	استولى
ai843@yfn.ysu.edu	html>
thomasp@ifi.uio.no	html>
spouts	ينبثق
garkuwa	درع
cutar	مرض
Three-Way	ثلاثي
cika	شغل
Quebec,&gt;	كيبيك &amp; GT؛
nema)&gt;	السعي) و GT.
gaskiya	حقيقة
Kasa	أرض
(Peter	(بيتر
ayi	تقع
iko?	السيطرة؟
mujalla	مراجعة
Proteus	بروتيوس
(21,648	(21648
Stone)	الحجر)
mutãnenta.	الناس.
damuwa,	قلق،
iko.	السيطرة.
mujallu	مجلات
sihirin,	السحر،
damuwa)	قلق)
diyya	تعويضات
yawanci	عادة
aya	الخامس
23-26,	23-26،
takarda	ورقة
hali	سلوك
ba,	،
alung@megatest.com	html>
yankin	منطقة
ba.	.
masanin	عالم
info.	معلومات.
ƙasƙanci	أدنى
baya-kofa	الباب الخلفي
FJ1200	FJ1200
gawawwakin	الهيئات
takardu	الوثائق
jami&#39;an	مسؤولون
coldest	أبرد
faruwa-fito-na-aiki	الذهاب-الخروج من العمل
haka	هكذا
(Dan	(دان
Thorson	Thorson
ikon	قوة
mu?&quot;	؟ ومثل؛
shakata&gt;	الاسترخاء وGT.
hockey	الهوكي
Pharasees	Pharasees
sace.	المسروقة.
eavesdropper	المتنصت
Stars	نجوم
ƙarfafawa	استقرار
dõmin	إلى
(1,100	(1100
juriya.	المقاومة.
--------------------------	--------------------------
kilomita	كم
Corolla	تويج
hana	منع
lasisi,	التراخيص،
Musulmi	مسلم
que	كيو
Nagle	Nagle
hadadden	مجمع
Moon	هلال
tabbas	ربما
wajen	إلى
Kowane	كل
==========================================	==========================================
&quot;Kaitona,	على &amp; quot؛ أوه،
Rauser	Rauser
leftist	يساري
2.5-kilomita	2.5 كيلومتر
kokarin	جهود
HAMZA	HAMZA
ma&#39;ana.	معنى.
(Nicki	(نيكي
abokai	أصدقاء
Firayim	عدد أولي
#&gt;	# &amp; طن.
abokan	أصدقاء
Barry-hadar	باري بوندز
sludge.	الحمأة.
Manzo	رسول
Ulysses	أوليسيس
canzawa	دون تغيير
Palestine	فلسطين
itraconazole	يتراكونازول
shekaru).	سنوات).
&quot;Kuma	على &amp; quot؛
415-688-8231	415-688-8231
Nobuaki	نوبواكي
Ammonia	غاز الأمونيا
kasance).	).
20Meg	20Meg
kasashen?	البلدان؟
Nowadys	Nowadys
Brooks	بروكس
murfin	غطاء
sheka	التحول
ribace-ribace	هوامش
hange	رصدت
sheki	لمعان
Pioneers	الرواد
Hello,	مرحبا،
Telematics	تقنيات المعلومات
daban.	مختلفة.
sashe	قسم
ship	سفينة
--------	--------
hazo	ضباب
Sunansa	اسم
JESUSCHRIST	JESUSCHRIST
Monitor	مراقب
cewa:&gt;	: &amp; GT؛
takarar	مرشح
kankanen	باختصار
chunks.	قطع.
haye	عبرت
(dutse),	(روك)
za&#39;ayi.	نفذت.
dabam.	بشكل منفصل.
takarce	خردة
nazarin	دراسة
Kokomo,	كوكومو،
ulterior	خفي
fetur,	البنزين،
shi?	ذلك؟
for?	ل؟
refering	اشارة ل
deduced	استخلص
ƙaho	بوق
cire	نزع
imani	نعتقد
(su	(
shakka	قطعا
(der	(دير
anti-fungal	المضادة للفطريات
Ottoman	عثماني
high-tsawo,	ارتفاعات عالية،
talakawa	فقير
Askew,	منحرف،
(ta	(
Chicago.	شيكاغو.
mamaki),	مفاجأة)،
reasonning	reasonning
tambaya	سؤال
inganta	تحسن
nazari,	مراجعة
lamiri	ضمير
awa	ساعات
imaged	تصوير
tambayi	تطلب
tambaye	طلب
unclumped	unclumped
Ma&#39;ana	وهذا يعني
(1,170	(1170
ma&#39;anar	معنى
Freq.	التكرار.
dabbobi	الحيوانات
images	الصور
ƙeƙasasshiya	غير فعال
Small	صغير
Palmer	مسعف
uban	الأب
multimillion	ملايين
gabãnin	قبل
Nunnally)	يلال)
Order	ترتيب
Alyosha	Alyosha
Makullin	مفاتيح
&quot;Wannan-da-irin	على &amp; quot؛ هذا من نوعها
Askew)	منحرف)
Lankford	Lankford
almajiransa	التلاميذ
RSEVERY	RSEVERY
Carl	كارل
boulders.	الصخور.
cikinta&gt;&gt;	حيث &amp; GT؛ &amp; GT؛
Card	بطاقة
(inda	(أين
wakilcin	ممثلة
ni,	لي
gangarawa,	الرأس،
Justification_,	Justification_
ni.	لي.
Tampa	تامبا
dangane&quot;	اتصال ومثل؛
pgf@srl03.cacs.usl.edu	html>
Natal&#39;,	الولادة،
detrimental	ضار
rawa	دور
UUNET:	UUNET:
Best!	أفضل!
ni)	I)
taron	مؤتمر
8.1,	8.1
homosexal	homosexal
saituna	الإعدادات
Kwayoyin	بكتيريا
Ruya	وحي
Yesu	يسوع
&quot;cika&quot;&gt;	على &amp; quot؛ كامل &amp; مثل؛ &amp; GT؛
zubar	سفك
ni?	لي؟
paradox	المفارقة
touch	لمس
incinerate	رمد
craters	الحفر
wata,	لذلك،
wata.	أ.
Sãɓãwar	تناوب
amsoshin	إجابات
&quot;sanyin	على &amp; quot؛ الراحة
AT)	AT)
sayarwa	بيع
Canadiens?	كنديينز؟
&quot;tattaunawa&quot;	على &amp; quot؛ المحادثات ومثل؛
_____	_____
net	شبكة
ganinsu	مشهد
ganinsa	رؤية
ra&#39;ayi&gt;	مفهوم &amp; GT؛
raya	تنمية
almajiran	التلاميذ
fursunoni	السجناء
Range	نطاق
ze&gt;	يبدو &amp; GT؛
Babu	لا
yesu	يسوع
Ira	اختراع
asteroid	الكويكب
&#39;yan&#39;uwanku	الاخوة
Daga:	من:
Masana	الخبراء
Ubangiji	سيد
Communications	الإتصالات
aji,	الصف،
040	040
Masani	معرفة
20X-60X60mm,	20X-60X60mm
wargajewa	إبادة
hetero	مغاير
dutse	جبل
Mutane	الناس
bandwith	عرض النطاق الترددي
Hakika,	وبطبيعة الحال،
ne,	،
ne.	.
ganina).	رأيي).
tsawon,	طول،
bakwai	سبعة
hanya	طريق
ultrahigh-ƙuduri	الفائق الدقة
ventured	غامر
ƙulli	إغلاق
fitila	مصباح
Yaren	لغة
AIAA	AIAA
fito.	من.
maza),	الرجال)،
antennas	هوائيات
kauce	تجنب
madawwama	الالتزام
_______________________	_______________________
rescinded.	ألغت.
Phobos	فوبوس
assirtar.	تعصف بها.
&lt;C5xxq0.18M@cs.columbia.edu&gt;	العلامة &amp; lt؛ C5xxq0.18M@cs.columbia.edu&amp;gt.
rayu	سكن
French-	بالفرنسية
Carlton	كارلتون
Karanta	قرأ
===============	===============
ne:	هو:
matsala	مشكلة
(shaho	(صقور
aikin.	.
kasassun	kasassun
nan	هنا
Orient	المشرق
maras	منخفض
Panoramic	طريقة إدارة آلة التصوير
Baseball	البيسبول
kunsa.	التفاف.
KAFIN	قبل
Hyundai	هيونداي
WinJPEG	WinJPEG
&quot;Yin	على &amp; quot؛ جعل
Magellan,	ماجلان،
faɗi	تمديد
Its	لها
(OO)	(OO)
faɗa	عراك
(ron	(رون
classic	كلاسيكي
tikiti	تذاكر
&quot;&gt;	على &amp; quot؛ &amp; GT؛
5vdc	5VDC
000	000
ayyuka	نشاط
watau	أي
watan	شهر
Humphreys	همفريز
3.1,	3.1
&quot;zana	على &amp; quot؛ رسم
Wucewa	يمر
Mystique&quot;	سحرها ومثل؛
na)	)
rani	الصيف
rana	يوم
na.	.
apps,	تطبيقات،
na,	،
ƙididdiga	إحصائيات
132,252	132،252
GABATARWA	مقدمة
belts	أحزمة
mulki	حكم
Active	نشط
toml@boulder.ParcPlace.COM	html>
Herman,	هيرمان،
rami	حفرة
shelar	أعلن
maganar?	الكلمة؟
^^^^^^	^^^^^^
Zabura	ترنيمة
oxygen	أكسجين
al--92-186,	AL - 92-186،
Yesu.	يسوع.
kumbon	السفينة الفضائية
Yesu?	يسوع؟
minti.	دقيقة.
ma&#39;ana	معنى
(Romawa.	(رومية.
Felix	فيليكس
movie	فيلم
&quot;yin	على &amp; quot؛
duka&gt;	كل وGT.
Yesu,	يسوع،
hasken.	ضوء.
Claudio	كلاوديو
Yesu)	يسوع)
sãɓã	عصيان
chipset	شرائح
square	مربع
3.1?	3.1؟
guguwa-kamar	مثل الإعصار
iska,	الهواء،
gudana	جارية
Amirkawa).	الأميركيون).
taimake!)	مساعدة!)
(Bill	(بيل
rasa	ضائع
&quot;Ya,	على &amp; quot؛
rare	نادر
Yesu&gt;	يسوع وGT.
hira	مقابلة
suka&gt;	وGT.
zarar	مرة
|&gt;&gt;	| &amp; طن؛ &amp; GT؛
tsayi	توقف
TranslateCoordinates	TranslateCoordinates
farmaki	هجوم
al-/	آل /
marly	مارلين
TIFF	TIFF
yamma	غرب
Timmons	تيمونس
zahiri&gt;&gt;	حرفيا &amp; GT؛ &amp; GT؛
Fisher	الصياد
apple	تفاحة
tsaye	مكانة
tsaya	موقف
&quot;suka&quot;,	على &amp; quot؛ &amp; مثل؛،
12-shekara	12 عاما
waxanda	التي
memory.	الذاكرة.
makonni	أسابيع
samuwar	تشكيل
6/92,	6/92،
mwm	MWM
daina	توقف
Shi&gt;	وطن.
hanya:&gt;	الطريقة: &amp; GT؛
mutuwar	الموت
Photos	الصور
mlee@post.RoyalRoads.ca	html>
tsãge	إيجار
kauna	حب
budurwa.	صديقة.
v124p7kk@ubvmsc.cc.buffalo.edu	html>
Aikin	عمل
neccacery	neccacery
kabilanci	عرقي
Canza	تغيير
tsawo	ارتفاع
Akwai&gt;	هناك &amp; GT؛
kunshe	شمل
siffofi	ملامح
kunshi	يحتوي على
fitar	خارج
zarce	تجاوز
____________________________________________	____________________________________________
1992/93	1992-1993
Perturbations	الاضطرابات
Jet	طائرة نفاثة
Inc.	شركة
curable	قابل للشفاء
Date:	تاريخ:
matsayi	حالة
feedback	ردود الفعل
kunnawa	لاعب
kasuwanci	عمل
Triantafyllopoulos)	Triantafyllopoulos)
karami	الأصغر
rana.	اليوم.
rana,	يوم
Safety	سلامة
Mitchum)	Mitchum)
discoverer,	مكتشف،
da&gt;&gt;	وGT؛ &amp; GT؛
yayin	في حين
zagayowar	دورة
Attaura	القانون
Englewood,	إنجلوود،
wato,	وهي،
Bayani)	معلومات)
tambayoyi.	الأسئلة.
al&#39;umma	مجتمع
daban-daban	مختلف
muradi	الدوافع
Adam.	آدم.
(CRAF)	(CRAF)
shugabanci	قيادة
Adam,	آدم،
Japan,	اليابان،
Bari	السماح
Flying	طيران
binne	مدفون
ƙanƙanta	الأقل
knifes	سكاكين
Track	مسار
(Hans	(هانز
jaskew@spam.maths.adelaide.edu.au	html>
Pasadena,	باسادينا،
radioisotopes.	النظائر المشعة.
Jay	جاي
Duniya-Moon	الأرض والقمر
Vancouver	فانكوفر
Faehl)	Faehl)
dioxide.	ثاني أكسيد الكربون.
photovoltaic	الضوئية
gwamnati	حكومة
tsarin.	نظام.
bindigogi.	البنادق.
gaba.	المقبل.
(Yahudawa).	(اليهود).
zabin.	الخيار.
tsarin,	نظام،
bindigogi,	البنادق،
watsi	الانبعاثات
ƙi	كي
totur	مسرع
(AIR)	(AIR)
Bayanan	معطيات
dashi	فوق
College,	كلية،
resistors	المقاومات
nutse	بالوعة
sake))	مرة أخرى))
sigogi	المعلمات
nufin	الوسائل
Back)	الخلفي)
&quot;electroglow.&quot;	على &amp; quot؛ electroglow على &amp; quot؛
lokaci-lokaci	أحيانا
Adams	آدامز
Masters,	الماجستير،
wadannan	هؤلاء
maƙiyi	العدو
Lore	تقاليد
wutsiya	ذيل
Inda	حيث
email	البريد الإلكتروني
maƙiya	الأعداء
Sakamakon	النتائج
^),	^)،
haši	الموصل
hurawa	تهب
wanzu&#39;	الوجود &quot;
zinariya	الذهب
Yahudawa	اليهود
(303)488-6120	(303)488-6120
gaban	قبل
[386enh]	[386enh]
(_______________________)	(_______________________)
yi.&quot;	. ومثل؛
hanyoyin	طرق
nagari	خير
gabas	الشرق
(Matt	(مات
Gudun	سرعة
damina	ممتص الصدمات
Low.	منخفضة.
interactions	التفاعلات
burge	رعشة
fungal	الفطرية
(sai	(
nufi.	النقطة.
Viking	الإسكندينافي
harshen	لغة
general	عام
Nagle)	Nagle)
ranar	في
tsarin?	النظام؟
gaba?	في المرة القادمة؟
watsa	انتقال
Galilei,	غاليلي،
atraction	atraction
Tarihi,	التاريخ،
laetril	laetril
(National)	(الوطني)
scan	تفحص
Info	معلومات
kaddarorin	عقارات
high	ارتفاع
Saukake	بسهولة
tsarin;	النظام؛
MacRae)	ماكراي)
Baya	فيما بعد
surface	سطح
zuwansa,	مجيئه،
&lt;1993Apr17.125545.22457@rose.com&gt;	العلامة &amp; lt؛ 1993Apr17.125545.22457@rose.com&amp;gt.
abokina	صديق
AIR	AIR
^^^^^^^^^^^^^^^^^^^^^^^	^^^^^^^^^^^^^^^^^^^^^^^
hanyoyi.	طرق.
Horus	حورس
yammacin	غرب
(ailin	(Aili
definition,	تعريف،
kamance,	التشابه،
Kiristoci,	المسيحيين،
Akwai	هناك
Kiristoci.	المسيحيين.
rigths	rigths
al&#39;amurra	قضايا
xx155@yfn.ysu.edu	html>
Joseph	يوسف
karatu	قارئ
al&#39;amurran	قضايا
deriving	اشتقاق
KO.	OR.
tẽku	بحر
Microsystems	مايكروسيستمز
Galileo,	غاليليو،
Equatorial	استوائي
(437	(437
(Rick	(ريك
abokin.	صديق.
nisa.	المسافة.
Bloomberg,	بلومبرغ،
fayil	ملف
Management	إدارة
placebos	مهدئات
range	نطاق
zukatan	قلوب
******************	******************
tashi	ارتفاع
watanni.	أشهر.
tashe	أثار
watanni,	أشهر
arzikin	اقتصاد
100&gt;	100 &amp; GT؛
Firaministan	عدد أولي
Ayyuka&quot;	آخر ومثل؛
mine	منجم
alloli	الآلهة
(Brian	(بريان
soyayya	حب
mini	لي
volts&gt;	فولت &amp; GT؛
lowers	يخفض
rediyo	راديو
803-654-8817	803-654-8817
dizzying	مذهلة
British	البريطانيون
jinsi.	بين الجنسين.
gidan-sized	منزل الحجم
Science	علم
gudãna	تدفق
girma)	عظيم)
&quot;wuya	على &amp; quot؛ الصعب
maƙwabcinsa	الجيران
Kuri&#39;a	الكثير
girma,	عظيم،
Yanar-gizo:	الإنترنت:
ƙoƙarin	جهود
2,400	2400
rotational	التناوب
jannati	رائد فضاء
semiconductor	أشباه الموصلات
arziki!	الأغنياء!
(kawai	(فقط
rufe&quot;?	أغلقت ومثل؛؟
kalmar?	الكلمة؟
girgije-kamar	سحابة مثل
kunshi,	يحتوي على
bangaren,	عنصر،
laifi.	الجريمة.
Basu	باسو
Radio-Shack-iya	راديو شاك-
34,839	34،839
&quot;Wannan	على &amp; quot؛ هذا
girman	حجم
sci.crypt	sci.crypt
lissafi	حساب
furta	دولة
Arizona.	ولاية اريزونا.
(Greek	(اليونانية
Jon	جون
(447	(447
Island	جزيرة
inept	غير كفؤ
ganina,	رأيي،
Joe	جو
Adawa	معارضة
-club	-club
rubũta	سجل
Bay,	الخليج،
Kafin	قبل
[LDS]	[LDS]
40Meg	40Meg
minutes	دقيقة
kunshin	صفقة
molesters	جرائم الاعتداء
unacceptable	غير مقبول
Delco	دلكو
tabbacin	ضمان
burbushi	آثار
Infiniti?	إنفينيتي؟
total	مجموع
Things&gt;	أشياء &amp; GT؛
Ju)	جو)
rayuwata	حياة
KOWANE	أي
bari),	السماح)
15:	15:
radar-zana	رادار التعادل
Harvey)	هارفي)
150	150
free	حر
Kawai	فقط
muku,	أنت
15,	15،
Stanley	ستانلي
``.&#39;	`` &#39;.
bbs:	BBS:
tuna,	تذكر،
Kodayake	رغم أن
sayar	تباع
&quot;jin	على &amp; quot؛ يشعر
sayan	شراء
92,8	92.8
Apple	تفاحة
flyby	التحليق
primeval	في أول الزمان
infusions	ضخ
Wizzard	يزارد
Tick	علامة
RKBA.	Rkba.
zunubansu.	الخطايا.
kawai&gt;	فقط &amp; GT؛
(215)645-6463	(215)645-6463
16,	16،
jira?	الانتظار؟
ƙasar.	البلد.
dangantaka.	العلاقة.
ƙasar,	البلد
masana&#39;antu	تصنيع
176	176
17:	17:
170	170
Yanzu,	الآن،
warmer	مسخن
_hard_	_hard_
marasa	المرضى
sane	بدراية
rendezvous	موعد
sani	تعرف
saya,	شراء،
X-Window	X-النافذة
(Brian@gab.unt.edu)	(Brian@gab.unt.edu)
tunani.	أعتقد.
kansa.]	نفسه.
sabunta	التحديث
tunani,	فكرت،
Mafi	أكثر
tunani!	أعتقد!
NCI.	NCI.
johnson	جونسون
sami	وجدت
guntu	شريط
(David	(ديفيد
sama	الجنة
(post	(المشاركة
lokaci.	الوقت.
mike	مباشرة
lokaci,	الوقت،
dangantakar	العلاقات
address.	عنوان.
mika	عرض
yaɗuwar	انتقال
ganganci	عمدا
1984&gt;	1984 &amp; GT؛
Mai,	A،
11.	11.
lambobin	أرقام
NA&#39;URA	DEVICE
Noring)	Noring)
samu	وجدت
20850	20850
sayen	شراء
Shaci	الخطوط العريضة
&quot;Amma	وquot؛ كما
cramer@optilink.COM	html>
san,	أعرف،
122	122
Shack	كوخ
mil)	ميلا)
hikima)	الحكمة)
sale	بيع
wasa,	لعب،
(aka	(
wasa.	اللعب.
Ibraniyawa	الرسالة إلى العبرانيين
jiya	أمس
tunanin	تخيل
arab,	عرب،
120	120
12)	12)
12,	12،
haka&gt;	وGT.
Quinn)	كوين)
Phone	هاتف
saki	إطلاق
ma&#39;anarta	معنى
sake	ثانية
Healers	المعالجين
saka	أدخل
(408)	(408)
kaddamar	أطلقت
molestation	التحرش الجنسي
ainihin	حقيقي
halaye	الخصائص
Orbiter	المتتبع
Palestine?	فلسطين؟
sickening,&gt;	مقزز، وGT.
myslef)	ميسليف)
Camary	Camary
13,	13،
Clark.	كلارك.
Mail	بريد
taga&gt;	نافذة &amp; GT؛
------------------------------	------------------------------
&lt;timmbake@mcl.ucsb.edu&gt;&gt;&gt;	العلامة &amp; lt؛ timmbake@mcl.ucsb.edu&amp;gt؛ &amp; GT؛ &amp; GT؛
ba&#39;a	مرح
jiran	انتظار
149	149
14:	14:
rabawa	موزع
annabta	تنبأ
********	********
kamfani	شركة
ƙanƙan	ضيق
wasan	مباراة
14,	14،
cryptoanalysis.	cryptoanalysis.
la&#39;akari	نظر
asteroids,	الكويكبات،
duka)	جميع)
duka,	كل
Torre	توري
hadari	عاصفة
Chemical	مادة كيميائية
perturbed	قلق
yanke	قطع
Sashen	قسم
yanki	منطقة
kasuwanni	الأسواق
Bamediye	متوسط
saya	شراء
ɗan&#39;uwansa,	شقيق،
saye	شراء
sayi	شراء
wagner@mala.bc.ca	html>
Latonia)	Latonia)
kirawo.)	ودعا).
(Noring	(Noring
Fadada-muguwar	التوسيع قاسية
Ikilisiya	كنيسة
lambobi.	الأرقام.
streaks,	الشرائط،
bitamin&gt;	فيتامين &amp; GT؛
al&#39;amuran	أحداث
hadar.	السندات.
zuriya	بذرة
LA,	LA
yawo,	الجري،
CRAF	CRAF
kwatanci	خيال
(audible	(مسموع
ɓãta	باطل
&lt;93095@hydra.gatech.EDU&gt;,	العلامة &amp; lt؛ 93095@hydra.gatech.EDU&amp;gt،،
yanka	قطع
readiing	readiing
martian	المريخ
haramta,	المحظورة،
gungu	مجموعات
cuta	مرض
Bell-Northern	جرس الشمالية
19,	19،
nufa?	يعني؟
mouse@thunder.mcrcim.mcgill.edu	html>
Fraering	Fraering
(Oh,	(أوه،
Mayans	المايا
VESA	VESA
RA&gt;	RA &amp; GT؛
pitching	نصب
yawon	سياحة
19?	19؟
shugaban.]	الرئيس.
&#39;Wanda	&#39;من
19:	19:
&quot;misali&quot;	على &amp; quot؛ ستاندرد اند مثل؛
rãyuwar	حياة
fuskar	وجه
tsararru	مجموعة
Comments?	تعليقات؟
Halley	هالي
Cututtuka	أمراض
Kai	رئيس
trillionth	تريليون
makullin.	مفاتيح.
tausayin	تافه
&quot;Idan	على &amp; quot؛ إذا
Mercury	زئبق
katin	بطاقة
pointers	مؤشرات
VE7GDA	VE7GDA
---------------	---------------
dukan	كل
Boats	معدات
seafarers	البحارة
Resp.	التركيب.
LDS	LDS
nagartaccen	راقي
Antarctica.	القارة القطبية الجنوبية.
gaba-hadar	سندات القادمة
LED	الصمام
lafiya&quot;	الصحة ومثل؛
lakabi	لقب
karrama	مرتبة الشرف
~~~	~~~
iya,	يمكن،
direba,	سائق،
(Is&#39;hãƙa	(إسحاق
zargi	المتهم
haifar	خلق
filaye	أساس
sa&gt;	وGT.
Ken	كين
wajibi	إلزامي
rage	مخفض
maraice	مساء
saita	مجموعة
rago	خروف
matukar	في حين
rai.	الحياة.
karanta	قرأ
floppies	مرنة
Matt	مات
shida.	ستة.
wutsiyoyi.	ذيول.
ragu	نقصان
wutsiyoyi,	ذيول،
&#39;al&#39;ada	&quot;طبيعي
bambancin	فرق
gravitacional	gravitacional
&lt;1993Apr4.221228.17577@bsu-ucs&gt;	العلامة &amp; lt؛ 1993Apr4.221228.17577@bsu-ucs&amp;gt.
noma.	الزراعة.
korau.	سلبية.
Shi,	ذلك،
ziyartar	زيارة
&#39;Theos&#39;	&quot;ثيوس&quot;
Masu	ال
itatuwa,	الأشجار،
rubuce-rubucen	كتابات
haife,	ولد،
niyyar	نية
matsaloli	المشاكل
ƙura	غبار
fitarwa?	تصدير؟
(Gordon	(جوردون
(510)	(510)
Scandinavians	الدول الاسكندنافية
(kishili	(مثلي الجنس
Pan-Turai	لعموم أوروبا
Washington	واشنطن
fada	عراك
plausible	معقول
duwatsu	الجبال
samu&gt;	تجد &amp; GT؛
factor	عامل
astein@israel.nysernet.org	html>
canje-canje	التغييرات
(Keith	(كيث
rafi	رافي
collisions	اصطدام
Shin	سواء
mutuwa.	الموت.
gasar	مسابقة
mutuwa,	الموت،
faci	بقع
100,000	100،000
Rufe	مغلق
travesty	صورة زائفة
kyan	الجمال
Express	التعبير
Sports	الرياضة
northerly	شمالي
Infiniti	إنفينيتي
fadi	تمديد
shaida	الشاهد
tudu	جبل
kwashe.	إخلاؤها.
vacsc0qe@VAX.CSUN.EDU	html>
keybd	keybd
scott@asd.com	html>
index	مؤشر
zababben	انتقائي
1-26	26/01
ilimin	تعليم
Ofishin:	المكتب:
Kipling	كيبلينغ
launukansa&gt;	الألوان وGT.
dialup	الطلب الهاتفي
shekaru	سنوات
propulsion	دفع
Dawuda.	ديفيد.
starowl@rahul.net	html>
kyau	خير
playoffs!	التصفيات!
taba,	التبغ،
tuba	تم تحويله
motsi	حركة
annabci	نبوي
tube	أنبوب
motsa	خطوة
anti-gun,	مكافحة بندقية،
shekara	عام
juriya	مقاومة
&quot;Borshevshky&quot;.	على &amp; quot؛ Borshevshky ومثل؛
sanyaya	تبريد
(Alan	(آلان
Gordon	جوردون
Weiss)	فايس)
ciphertext	النص المشفر
injin)?	الجهاز)؟
Michael	مايكل
5.0.	5.0.
Benedikt	بينيدكت
Maza	الرجال
PB170	PB170
syria.	سوريا.
M.)	M.)
Man,	النفط،
migrating	الهجرة
plumes	أعمدة
karya-malami?	كسر والمعلمين؟
mine!	الألغام!
Ko,	أو،
kakar,	الموسم،
Pittsburgh,	بيتسبرغ،
haƙuri	المريض
mine.	الألغام.
akan	في
cover	غطاء
Barman)	بارمان)
akai	أساس
warkewa	شفاء
cipher?	الشفرات؟
wasu.	البعض.
Folta	Folta
Palestine.	فلسطين.
wasu,	آخرون
1.3	1.3
Male	رجل
1.1	1.1
Shafi	ذات
wakilta.	ممثلة.
tsarin	نظام
akai-akai	كثيرا
bep1@cbnewsg.cb.att.com	html>
5-minti	5 دقيقة
&lt;lsj4ruINNl7o@saltillo.cs.utexas.edu&gt;	العلامة &amp; lt؛ lsj4ruINNl7o@saltillo.cs.utexas.edu&amp;gt.
gashi	شعر
masa?	له؟
1-2	1-2
10.	10.
10,	10،
0,14	0،14
relays?	التبديلات؟
encrypting	تشفير
ceton	إنقاذ
fasara:&gt;&gt;	إعادة صياغة: &amp; GT؛ &amp; GT؛
gaske	حقا
shãmaki	حاجز
(Malcolm	(مالكولم
intollerent	intollerent
fam)	جنيه)
volcanoes.	البراكين.
wakiltar	يمثل
Kou	كو
saing	سينج
100	100
sayi.	اشترى.
tashoshi	القنوات
ofishin	مكتب
faku	غائب
Edmonton	ادمونتون
shawarwari	مناقشة
Vica	كاهن
kwatanta	مقارنة
ionosphere,	الأيونوسفير،
fan.	مروحة.
1/2	02/01
tsarki	نقاء
myopic,	قصر النظر،
(Gasa	(خبز
Bure,	تحميل مجاني،
on-line	على الخط
fama	ضحايا
clueless	جاهل
(Gary	(غاري
Adams.	آدامز.
radiated	يشع
Adams)	آدامز)
ceto,	حفظ،
rabu	فصل
tuna	تذكر
Mulkin	حكم
Tiff	شجار
Bernard)	برنار)
_National	_National
thermocouples	المزدوجات الحرارية
MIniVas	MIniVas
Watsin	انتقال
sheka&gt;	التبديل &amp; GT؛
zahiri,	في الواقع،
Tambayoyi	الأسئلة
tsaro,	أمن
mummuna	قبيح
tsaro.	الأمن.
duniyoyi.	الكواكب.
kufai	أطلال
littattafai	الكتب
Bures	بوريش
&quot;T&quot;	على &amp; quot؛ T &amp; مثل؛
assult	assult
Mars	المريخ
sauransu&gt;	الخ &amp; GT؛
zobba,	حلقات،
allon	شاشة
tuki	قيادة
zobba.	حلقات.
&quot;tsaro	على &amp; quot؛ والأمن
tranfer&gt;	يمكنك نقل وGT.
Mark	علامة
Marc	مارك
ajiye	احتياطي
rabo	حصة
GIF.	GIF.
namu.	بلدنا.
Rule	حكم
GIF,	GIF،
namu,	بلدنا،
rabi	نصف
mini?	لي؟
gases	الغازات
short-rayu.	لم يدم طويلا.
far,	العلاج،
far.	العلاج.
ƙawãta	جمل
raba	حصة
thermocouple,	الحرارية،
Singapore	سنغافورة
stargazers	مراقبوا النجوم
ExposureMask	ExposureMask
duniyoyin	المجالات
bara	العام الماضي
kasa.	أدناه.
sayarwa?	بيع؟
taimako,	مساعدة
saman-hagu	من أعلى إلى اليسار
raɗaɗin	آلام
Pluto),	بلوتو)،
relays	التبديلات
sayarwa.	بيع.
Neal	نيل
Bicentennial.	المائتين.
bari	السماح
barrantar,	مسح،
vshield	vshield
wasiyya	وصية
sa&#39;a	ساعة
...	...
Fang)	فانغ)
tambayar	سؤال
kiyasta	مقدر
Tsauni	جبل
Eurosport	يوروسبورت
lokatan	TIMES
sakamako.	تأثير.
tsammani	تخمين
sakamako,	مكافأة
sakamako:	مكافأة:
kuma&gt;	و &amp; GT؛
phosphorus)	الفوسفور)
kasar	بلد
kwamfuta;	الكمبيوتر.
Cipriani)	تشبرياني)
taimakon	مساعدة
bata	خطأ
competently	بكفاءة
basu	ليس
ciyar	قضاء
jargon	رطانة
kwamfuta?	الكمبيوتر؟
Matiyu	ماثيو
fax:	الفاكس:
&#39;a&#39;	&#39;&#39;
magana).	الحديث).
cryptanalysis.	تحليل الشفرات.
fax.	الفاكس.
tsibirin	جزيرة
cancanta	مستحق
makãmashin&gt;	الوقود وGT.
sauyawa	بديل
sakamakon	النتائج
ciniki	تجارة
oozed	أووزيد
fadin,	عبر،
kwamfuta.	الكمبيوتر.
taga	نافذة
kwamfuta,	الكمبيوتر،
bamu	لنا
precursor	نذير
photographed	صورت
fata	بشرة
bane	هلاك
Canadians	الكنديين
software	البرمجيات
band	فرقة
(Afrilu	(أبريل
tana	غير
lumpy	محفر
iyaye	الآباء
tap,	الاستفادة،
mota.	سيارة.
tamu	لنا
kira	المكالمات
ppm,	جزء في المليون،
sa&#39;a.	ساعة.
fasa	تمثال نصفي
dukan.	جميع.
bisexual.	المخنثين.
dukan,	كل
dukan)	جميع)
NOBODY	لا أحد
laifi	مذنب
kisankai&#39;	القتل &quot;
&quot;wani	على &amp; quot؛
Amirkawa,	الأميركيون،
ko&#39;	أو
rubuce.	مكتوب.
-Karl	-Karl
rubuce,	الكتابة،
duniya.	العالم.
launi,	لون،
haddasa	مما تسبب في
duniya,	عالم
Amirkawa:	الأميركيون:
nickel-core	النيكل النواة
allo	شاشة
jũna	آخر
[mutãne]	[الشعب]
fara	بداية
basira	المهارات
audio.	الصوت.
tabbatar.	بالتأكيد.
fari	جفاف
tabbatar,	بالتأكيد،
faru	أحداث
lan	الشبكة المحلية
iyawa	مقابض
Consulting,	الاستشارات،
&lt;15464@optilink.COM&gt;	العلامة &amp; lt؛ 15464@optilink.COM&amp;gt.
bar,	اليسار،
Pittsburgh	بيتسبرغ
audio,	الصوت،
snowball.	كرة الثلج.
sa&#39;an	و
tunanin.	تخيل.
wadda	التي
Ilmantar	تعليم
sanarwa.	بيان.
sanarwa,	بيان،
Kaldis	Kaldis
&#39;SRESURRECTION::::	SRESURRECTION ::::
Mariner	بحار
matasa-Leith)	شباب ليث)
orbiter	المسبار
taka	لعب
orbited	تدور
take	لقب
asibiti	مستشفى
Hikimar	حكمة
taki	سماد
volts.	فولت.
launin	اللون
sa&#39;ad	عندما
muhimman	مهم
fuska&gt;	شاشات &amp; GT؛
duniyar	عالم
zauna&gt;	الجلوس وGT.
kashe	بعيدا
rabo&gt;	نسبة &amp; GT؛
Lines.	خطوط.
kashi	في المئة
taro	مؤتمر
sauran	البعض
Tug-na-yaƙi	لعبة شد الحبل من الحرب
Miranda	ميراندا
tare	مع
tanã	هو
yaki.	الحرب.
mažalli	مفتاح
iyali	عائلة
bindiga.	بندقية.
tasa	زبدية
&#39;fassarar&#39;	&quot;التفسير&quot;
kun	أنت
bindiga,	بندقية،
togiya.	استثناء.
taru	معا
wutsiyoyi	ذيول
naman	لحم
itãcen	كف
promiscuity&gt;	الاختلاط وGT.
Hauwa&#39;u	حواء
mls@panix.com	html>
Daidaitacce	قابل للتعديل
Gnomes	التماثيل
tozarta	استغلال
iyalinsu	عائلة
dadewa.	زيادة.
Lee	لي
tara	تسعة
matsayi.	الموقف.
&lt;C4vG3F.Kx3@apollo.hp.com&gt;,	العلامة &amp; lt؛ C4vG3F.Kx3@apollo.hp.com&amp;gt،،
Shawarwari	مناقشة
Price	السعر
iyaka	محدود
baya	فيما بعد
kara).	المضافة).
sanarwar	بيان
shimfiɗa	انتشار
England	إنجلترا
Thorson)	Thorson)
yakin	حرب
Allahn	الله
Shapiro)	شابيرو)
ku?	لك؟
kabila	سباق
fahimtar	فهم
Dr.Banzai	Dr.Banzai
hankalta	فهم
planetology.	الكواكب.
ku,	،
(0,0)	(0،0)
Law	القانون
........	........
ku.	.
Support)	الدعم)
Yana&gt;	وطن.
MDs	حركة الديمقراطيين الاشتراكيين
yanayin,	الوضع،
yanayin.	واسطة.
arziki	توفير
motif	عزر
.45	0.45
dbd@icf.hrb.com	html>
Turanci	الإنجليزية
yanayin:	الوضع:
matsayin	كما
1-800-344-4539.	1-800-344-4539.
Mouse	فأر
tsibiran	الجزر
yake.	.
yake,	،
cewa&gt;&gt;	وGT؛ &amp; GT؛
400&gt;	400 &amp; GT؛
MC)	MC)
Canadians:	الكنديين:
gurbin	استبدال
rebooted	تمهيد
Rubin)	روبين)
yake:	هو:
minti	دقيقة
oOOO	OOOO
tsabar	نقد
FJ1200&gt;	FJ1200 &amp; GT؛
rikitarwa	مضاعفات
Rubin.	روبين.
Rubin,	روبين،
X11R5	X11R5
X11R4	X11R4
hamadar,	الصحاري،
ethane,	الإيثان،
&quot;kasuwanci&quot;	على &amp; quot؛ &amp; الأعمال مثل؛
&quot;Casa&#39;in	على &amp; quot؛ تسعون
kuskure	الأخطاء
&#39;surface,	&quot;السطح،
seeded	المصنف
aikatãwa	فعل
batu	قضية
kmac@cisco.com	html>
jimlar	مجموع
tsari&gt;	عملية وGT.
halayyar&gt;	سمة &amp; GT؛
Neon	نيون
firistoci	الكهنة
Agnosticism	اللاأدرية
McDonnell	ماكدونيل
range.	مجموعة.
suranta	الأشكال
hal@cco.caltech.edu	html>
Administration	إدارة
Honda,	هوندا،
Flown	جوا
(38.8	(38.8
shirya	أعدت
dept.	قسم.
ruwa-kankara	مياه الجليد
taso	عوامة
shirye	استعداد
faye	وصف
&quot;lura	على &amp; quot؛ ملاحظة
matsa	خطوة
narkar	الذائبة
excoriate	ننتقد
joshuaf@yang.earlham.edu	html>
SETVER.EXE	SETVER.EXE
munns@cae.wisc.edu	html>
kungiyar	مجموعة
Model	نموذج
&lt;19613@pitt.UUCP&gt;,	العلامة &amp; lt؛ 19613@pitt.UUCP&amp;gt،،
e-mail	البريد الإلكتروني
liwadi&gt;	المثلية و GT.
jima&#39;i	جنس
Steve.Shapiro@f440.n101.z1.fidonet.org	html>
Nesa	بعد
jiki	هيئة
&quot;lasisi	على &amp; quot؛ رخصة
karon	مرة
Siemon	Siemon
tunani	إشارة
rigorous	دقيق
daidai&gt;	الحق وGT.
jiko	التسريب
XR250L	XR250L
Andreas	أندرياس
Latsa-Democrat,	الصحافة الديمقراطي،
saboda&gt;	ل&amp; GT؛
ganin),	رؤية)،
Terra	تيرا
karni	قرن
low	منخفض
girmamawa	شرف
Luis&gt;	لويس &amp; GT؛
dual-iska	المزدوج الهواء
Tsohon	سابق
madauwari	دائري
Patricia	باتريشيا
rubutun	مخطوطات
Tauraro	نجمة
lengthy	طويل
p.s.	سكرتير خاص
baby	طفل
International	دولي
kan&gt;	وGT.
babu	لا
taimaka!	مساعدة!
tayi	العروض
yakan	يرتفع
cosmic	كوني
lmh	LMH
&lt;Apr.9.01.09.22.1993.16580@athos.rutgers.edu&gt;	العلامة &amp; lt؛ Apr.9.01.09.22.1993.16580@athos.rutgers.edu&amp;gt.
sabis.	الخدمة.
tsara-in	صممت في
(yisti)	(الخميرة)
&quot;Proper	على &amp; quot؛ السليم
bada	إعطاء
sabis,	الخدمة،
MLS	MLS
hunturu.	فصل الشتاء.
torre	توري
ƙwalo,	رئيس الوزراء،
aikata.	القيام به.
musamman	خاص
Cisco	سيسكو
ziyarci.	زيارة.
bimbinin	search-
beleive	يعتقدن
ethane-methane	الايثان غاز الميثان
karanta&gt;	قراءة &amp; GT؛
uucp:	UUCP:
(wannan	(هذا
ayyukan	الأنشطة
Korenek	Korenek
(Ryan	(ريان
kwayoyi	المخدرات
karin	أكثر
nicad	nicad
Rocket&quot;	الصواريخ ومثل؛
_ARE_	_ARE_
Comets	المذنبات
Yahudawa?	اليهود؟
&quot;gun	على &amp; quot؛ بندقية
hadaya	عرض
Cibiyar	مركز
192.100.81.100	html>
&quot;placebo	على &amp; quot؛ همي
3&quot;,	3 ومثل،،
kyawawa	جميل
lmh@juliet.caltech.edu	html>
outright.	صريح.
mother-	من الأم
hula	كاب
fasali	ملامح
fassarori.	التفسيرات.
bazai	لا يجوز
Sauti	صوت
Davis	ديفيس
Internet:	الإنترنت:
daure	مقيد
henry	هنري
(Af,	(بالمناسبة،
repopulation	إعادة تعمير
daura	BIND
Mail:	البريد الإلكتروني:
Stalin?	ستالين؟
David	ديفيد
jinin	دم
Duwatsu	الجبال
Kadina	الكرادلة
taimake!	مساعدة!
(starowl@a2i.rahul.net)	(Starowl@a2i.rahul.net)
muhimmiyar	مهم
Basic	الأساسية
akalla	على الأقل
PCX,	PCX،
???	؟؟؟
Institue	مؤسسة
5-7)	5-7)
&lt;May.7.01.08.16.1993.14381@athos.rutgers.edu&gt;	العلامة &amp; lt؛ May.7.01.08.16.1993.14381@athos.rutgers.edu&amp;gt.
kuma&#39;	و
Mormonism	المورمونية
gabata	سابق
.....)	.....)
tunawa	نصب تذكاري
ka&#39;ida	تنظيم
Prism	موشور
faduwar	الشفق
&quot;Buy	على &amp; quot؛ شراء
(225	(225
kawai.	فقط.
crews	أطقم
baje	مستوى
capacitive	بالسعة
CAS.	CAS.
Ezekiel)	حزقيال)
kawai,	فقط
dalilin	سبب
dama&quot;	عدة ومثل؛
NatLamp	NatLamp
komawa	عودة
mata;	المرأة؛
Bucky	بوكي
stats.	احصائيات.
mata,	النساء،
5-6.	5-6.
rinjãya	وحدات التحكم
Fasaha,	التكنولوجيا،
N81	N81
Canaveral	كانافيرال
baki	أسود
interested,	مهتمة،
fatara	مفلس
pixel	بكسل
...&gt;	... وطن.
ambato	تلميح
lair.	مخبأ.
zafin	حرارة
fairly	بعدل
Sent	أرسلت
orbital	مداري
sell	بيع
&quot;mayalwaci	على &amp; quot؛ كاف
nesa.	المسافة.
uwar	أم
karya	زائف
tashi-canza	يطير التغيير
ball	كرة
post	بعد
cache	مخبأ
ran).	اليوم).
(Life	(الحياة
tiriliyan	تريليون
amintattu	تأمين
fagen	حقل
Nuwamba	تشرين الثاني
jira	انتظر
ambata	ذكر
bautãwa)	إله)
m-it2691@DOC.CS.NYU.EDU	html>
Cloud,	سحابة،
bautãwa,	الله،
bautãwa.	الله.
Mouse)	الماوس)
zafi.	الحرارة.
zafi,	الحرارة،
garin	مدينة
wasan!	لعبة!
NASA,	وكالة ناسا،
Cuta	مرض
hakkoki	حقوق
wasan.	اللعبة.
Roman	الروماني
badi	يوم الأربعاء
bags)	أكياس)
18th	18
---------------------------&gt;	--------------------------- وطن.
wasan?	اللعبة؟
folta@well.sf.ca.us	html>
lokacin	مرة
zuwa:	إلى:
shuɗe,	أزرق
gabas)	الشرق)
price.	السعر.
zuwa.	ل.
Landmann)	Landmann)
facade	مظهر زائف
price,	السعر
Sauya	استبدل
recedes	يتراجع
Itace	خشب
daga.	من.
symbolisms	symbolisms
daga,	من
Watakila	ربما
Mutanen	الناس
zuwa,	إلى
zuwa)	)
TIDSA	TIDSA
(muna	(نحن
Triton	تريتون نصف إله عند الإغريق
tambaya?	السؤال؟
algorithm?	الخوارزمية؟
Kirista	مسيحي
1742a	1742
hudu	أربعة
Halley,	هالي،
asalin	الأصل
Kiristi	يسوع المسيح
Loc	لوك
tambaya,	السؤال،
tambaya.	المسألة.
1.00	1.00
===================================	===================================
(wadanda	(
dauka	اتخذت
(800)	(800)
digiri	درجة
algorithm,	الخوارزمية،
bukukuwa	كرات
dalili.	سبب.
Magellan	ماجلان
jini	دم
jannati.	رائد فضاء.
cibiyar	مركز
dauki	رد فعل
jannati,	رائد فضاء،
dauke	حمل
welshed	welshed
zažužžukan	خيارات
na&#39;urorin	الأجهزة
gubar.	قيادة.
ƙaddara	تحديد
Schaufenbuel)	Schaufenbuel)
Taimako:	مساعدة:
Harkokin	أجنبي
LM350T	LM350T
launukansa	الألوان
lantarki?)	الإلكترونية؟)
thread	خيط
ma,	أيضا،
gawarwakin	الهيئات
ma.	أيضا.
1759,	عام 1759،
launukansa,	الألوان،
qasar	بلد
demokraɗiyya	ديمقراطية
tipped	يميل
wanzu?	الوجود؟
kayyadewa,	منظم،
18EB	18EB
kocin	مدرب
versa&quot;	بالعكس ومثل؛
gefe	جانب
takardun	الوثائق
Yanzu	الآن
Postbus	Postbus
asirai	أسرار
{uunet,	{UUNET
likita.	الطبيب.
fortay	fortay
mac	لجنة الهدنة العسكرية
-km	-km
///	///
Subject:	الموضوع:
kawasaki	دراجة نارية
MC05A	MC05A
mai	ل
likita?	الطبيب؟
saƙon	رسالة
Makan	مكان
ayoyi.	الآيات.
yi&gt;	وGT.
sha&#39;awa	ومن المثير للاهتمام
River	نهر
man	نفط
daukar	مع الأخذ
duhu,	الظلام،
Finnish,	الفنلندية،
(Billy	(بيلي
daukan	يأخذ
diddige,	كعب،
kickback	رشوة
diddige.	كعب.
Salibiyyar	الصليبيين
janar&gt;	عام &amp; gt؛
adadin	عدد
unscrupulous	عديم الضمير
rarraba	التوزيع
camfin	الأساطير
(kalubalanci	(متحدى
rarrabe	مميز
15-The	15-إن
(Makan	(مكان
10--	10--
gt4417a@prism.gatech.edu	html>
biyu&gt;&gt;	اثنين وGT؛ &amp; GT؛
tsada	غالية
Borland	بورلاند
harba	تبادل لاطلاق النار
amma	لكن
Agency)	وكالة)
harbi	إطلاق نار
Agency.	الوكالة.
&quot;bayyana	على &amp; quot؛ اضحة
kudin	عملة
karãtun	يتلون
shipping.	الشحن.
alhakin	مسؤولية
Gwamnatin	حكومة
**************************************************	**************************************************
gwaje-gwaje	اختبارات
Gregory	غريغوري
-------------------------------------------------	-------------------------------------------------
sakawa	وضع
shipping)	الشحن)
nitrogen	نتروجين
(Elaine	(إلين
guru	المعلم
kudi:	معدل:
vents	فتحات
mine)?	الألغام)؟
sikelin	نطاق
hikima	حكمة
kudi,	المال،
&#39;juyawa	&quot;دوران
alherin	صلاح
sanarwa	بيان
shugaba	رئيس
cewar	وفقا ل
___________________	___________________
amsa	إجابة
hukunta	القاضي
micrometeorites,	الجسيمات النيزكية الدقيقة،
ambaci	تذكر
lmh@shakes.caltech.edu	html>
MS-Windows?	MS-ويندوز؟
gode!	شكرا لك!
Joshuaf	Joshuaf
Me?	لماذا؟
23:17:25	23:17:25
halaka.	الدمار.
..:.&#39;	..:. &#39;
Cl056@cleveland.Freenet.Edu	html>
gode.	شكرا لك.
gode,	شكرا لك،
[saka	[إدراج
Yahudawa,	اليهود،
ceto	حفظ
ziyarci	زيارة
Yahudawa.	اليهود.
Great	عظيم
debating	مناقشة
kwana?	الأيام؟
bayan-kashe	بعد الخروج
ruwan	ماء
Meg	ميج
ƙarni,	قرن،
astronomical	فلكي
cewa.	أن.
cewa,	أن
NHL	NHL
sattellite	sattellite
ƙafafunsa.	قدم.
karfe	معدن
cewa:	ما يلي:
Toronto	تورونتو
karfi	قوة
Florida.	ولاية فلوريدا.
Mariners	البحارة
fuskanci	تجربة
Parsli	Parsli
Guthrie	غوثري
Chronology.	التسلسل الزمني.
Kristanci.	المسيحية.
asiri.	الغموض.
kari,	المكافآت،
kari)	ملحقات)
Windows	نوافذ
rukuni	مجموعة
uku&gt;	ثلاثة &amp; GT؛
ruwa.	المياه.
arcs,	أقواس،
kwayoyin	بكتيريا
cliffs	المنحدرات
Williams	ويليامز
SMARTDRV.EXE	SMARTDRV.EXE
Greg,	جريج،
ofishin,	مكتب،
^^^^^^^^^^^^^^^^^^^^^^^^^^^^^	^^^^^^^^^^^^^^^^^^^^^^^^^^^^^
ganganci.	عمدا.
knapsack	حقيبة ظهر
gun.	بندقية.
km@cs.pitt.edu	html>
Kevin	كيفن
Phillip)	فيليب)
Man	نفط
percentages.	النسب المئوية.
fuska	شاشات
Wayar	هاتف
adadi.	الرقم.
Dayton	دايتون
Mai	A
Hakika	في الواقع
wuyar	صعب
Mac	ماك
wuyan	العنق
hutu	عطلة
Yorker,	نيويوركر،
sulfuric	كبريتي
months)	أشهر)
swirling	دوامات
Impedance	مقاومة
rubuce	كتابي
kuzarin	طاقة
rls@uihepa.hep.uiuc.edu	html>
Faransa	فرنسا
cewa	أن
guje	طيران
fractured.	التصدع.
kwance	الكذب
May	مايو
wanzu.	الوجود.
kidaya	عد
wanzu,	الوجود،
ethan@cs.columbia.edu	html>
kadan	القليل
NET	NET
takamaiman	خاص
jihohin	الدول
kwanan	مؤخرا
&#39;ya&#39;ya	الأطفال
list	قائمة
Waya:	الهاتف:
(Benedikt	(بينيدكت
&#39;blue	أزرق
irin.	اكتب.
kadai	فقط
rumfa-tushen	استنادا الظاهري-
spins	يدور
karbi	تلقى
fushi	غاضب
wuya,	من الصعب،
--------------------------------------------------	--------------------------------------------------
cancanci	مستحق
daidai	بالضبط
&gt;&gt;&gt;&gt;&gt;	وطن؛ &amp; GT؛ &amp; GT؛ &amp; GT؛ &amp; GT؛
shack	كوخ
firearm.	سلاح ناري.
NOW	الآن
1975	1975
(Re:	(إعادة:
firearm?	سلاح ناري؟
aikace.	التطبيق.
zaton	اعتقد
1977	1977
1979	1979
Catalog	فهرس
wasiya&quot;	شهادة ومثل؛
Fisher)	فيشر)
buckling	التواء
C.O.D.	الدفع عندالتسليم
cell	خلية
lasafta	محسوب
Masani,	العليم،
_____________________________________________________________________	_____________________________________________________________________
-&gt;&gt;	- وطن؛ &amp; GT؛
stacks	مداخن
dafa,	طبخ،
1990	1990
alyoung@kiwi.ucs	alyoung@kiwi.ucs
dafa.	كوك.
batun,	المسألة،
7,00.	7.00.
486/33	486/33
Dauka	اتخذت
Deimos.	ديموس.
sunansa.	الاسم.
Amma	لكن
siyasa	سياسي
unrivaled.	منقطعة النظير.
kwangila	عقد
reprehensible	الشجب
nasarorin	الإنجازات
cika,	شغل،
motherboard.	اللوحة الأم.
Karamazov	كارامازوف
qarami.	SMALL.
1991	1991
composing	تركيب
1992	1992
mafiya	معظم
zukatansu.	القلوب.
Ganymede,	جانيميد،
1993	1993
1994	1994
LM350K.	LM350K.
NRA	سلطة المصادر الطبيعية
1999	1999
|&gt;	| &amp; طن.
motsi.	الحركة.
tsari	اقتراح
Yaya	كيف
mũnin	بؤس
tsaro	أمن
tare.	مع.
Annabãwa	الأنبياء
ZENON	زينو
kasance?	يكون؟
Note	مذكرة
kifi	سمك
tsara	تصميم
skateboard	لوح التزلج
shaft	رمح
tsare	حارس
wani&gt;	و&amp; GT؛
co-ordinates	الإحداثيات
Alicea,	أليس،
iskõki	الرياح
3:31	03:31
shafa	تتأثر
sarrafa,	مدير،
tuki.	القيادة.
&lt;1993Apr22.153000.1@vms.ocom.okstate.edu&gt;&gt;	العلامة &amp; lt؛ 1993Apr22.153000.1@vms.ocom.okstate.edu&amp;gt؛ &amp; GT؛
kasance.	.
shafi	ذات
kasance,	،
Koyi	تعلم
shafe	القضاء
haƙiƙa	في الواقع
------------------------------------------	------------------------------------------
(360	(360
(baya)	(العودة)
samuwa	متاح
MacRae	ماكراي
sana&#39;a,	المهنية،
zunubanmu	الخطايا
&#39;doping&#39;	&quot;المنشطات&quot;
Mix	مزيج
tuki?	القيادة؟
bombarded	قصف
ordering	تنظيم
tafasa	دمل
baya)	العودة)
sassauta	أدنى
baya,	في وقت لاحق،
baya.	العودة.
kida	موسيقى
lafiya	الصحة
gorges,	الوديان،
extrapolation	استقراء
guda	وحيد
(HAU)	(NIV)
&lt;thomasp@ifi.uio.no&gt;	العلامة &amp; lt؛ thomasp@ifi.uio.no&amp;gt.
quality?	الجودة؟
mu,	ونحن،
matattu	ميت
shaho	ODDS
mu.	لنا.
fita,	خارج
hedkwatarsu	مركز
carl_f_hoffman@cup.portal.com	html>
Kowa	كل شخص
jodfishe@silver.ucs.indiana.edu	html>
shapiro@sofbas.enet.dec.com	html>
gudu	جولة
mu?	نحن؟
batun.	القضية.
Allaha	يستريح
&lt;1993Apr16.173252.7393@asd.com&gt;,	العلامة &amp; lt؛ 1993Apr16.173252.7393@asd.com&amp;gt،،
(yamma	(الغربية
extrapolating	استقراء
thriving	مزدهر
Tilastawa	قوة
bice&gt;	إطفاء &amp; GT؛
sama.&gt;	. فوق &amp; GT؛
muni,	الأسوأ من ذلك،
bushe	جاف
bayar	المقدمة
muni.	ما هو أسوأ.
Kawaguchi,	كريسويل،
haihuwa.	العمر.
bayan	بعد
tabbatarwa,	صيانة،
....&gt;	--- وطن.
yadudduka	طبقات
sãmu	وجدت
photochemistry	الكيمياء الضوئية
-----------------------------	-----------------------------
(Larry	(لاري
Steve.	ستيف.
mun	نحن
theist,	المؤمن
riƙe	عقد
kadan.	قليلا.
slegge@kean.ucs.mun.ca	html>
riƙi	اتخذت
sãme	وجدت
NASA	وكالة ناسا
linzamin	فأر
justifications	المبررات
tawagar,	فريق،
tawagar.	فريق.
Allah,	الله،
ɗaya,	احد،
Allah.	الله.
hey,	مهلا،
rahotannin	تقارير
(wani	(A
aikatawa	فعل
makiya	الأعداء
Brooklyn,	بروكلين،
shari&#39;a	عدالة
flowed	تدفقت
Uranian	أورانوس
Ctrl-Alt-Del	السيطرة، البديل، ديل
1200-1500.	1200-1500.
Ɗari	مركبات
mace,	أنثى،
Mun	نحن
cece	حفظ
wadanda	هؤلاء
(323	(323
tsaga	انقسام
high-gudu	عالية السرعة
yanzu-yanzu&gt;	لحظة وGT.
ceci	حفظ
cũta&quot;.	المرض ومثل؛
Tattaunawa	مناقشة
shugabannin	القادة
Kou)	كو)
acid.	حامض.
Ariel,	ارييل،
netters,	netters،
====================================	====================================
tsagi	أخدود
Duniya	عالم
Amsa	إجابة
tsage	إيجار
Steven	ستيفن
sammai,	السماوات
&lt;wnk.734824081@aquifer.geology.uiuc.edu&gt;,	العلامة &amp; lt؛ wnk.734824081@aquifer.geology.uiuc.edu&amp;gt،،
tarin	جمع
ɗebe	ناقص
theists	الخروج من الملة
culmination	أوج
5,25	5.25
Nicji,	Nicji
Cewa	أن
-dk	-dk
fãsiƙai	منحرف
nisa-jẽfa	غاب عن النظر
tabbatar	أكد
KRISTI&#39;S	المسيح
tebur.	الجدول.
version	نسخة
;-).	؛-).
ubiquitous	كلية الوجود
mil	ميل
labeled	وصفت
Ƙarƙashin	تحت
yanzu?	الآن؟
taba	أبدا
baturi	بطارية
(818)	(818)
tarko	فخ
qara	زيادات
batura	بطاريات
[shi	[
yanzu,	الآن،
...&quot;	... &amp; قووت]؛
yanzu)	الآن)
tabo	بقعة
Kor.	كور.
yanzu.	الآن.
tace	مرشح
kila	ربما
Qasa.	الأرض.
lafiya&gt;	الصحة و GT.
kadai.	وحده.
rubutu	نص
martin	مارتن
dacewar	أهمية
rubuta	إرسال
&#39;Magnetic	مغنطيسي
Gravitational	الجاذبية
rubuta:	كتب:
1947	1947
1949	1949
Babur	دراجة نارية
Sa&#39;an	و
takardar	ورقة
haƙĩƙa	بالتأكيد
Aikace-aikacen	تطبيقات
Mr.	سيد
kilo	كيلو
rubuta.	مكتوب.
rubuta,	الكتابة،
Technology	تكنولوجيا
cẽto	شفاعة
1959	1959
yadda&gt;	وGT.
darajar).	القيمة).
Mummunan	سلبي
share	حصة
denser	أكثر كثافة
gunkin	صورة
Barry	باري
jelly	هلام
INFJ	INFJ
reparented,	reparented
Mai-Tsarki&gt;	الكتاب المقدس و GT.
===========================	===========================
takarda:	ورقة:
haukan	عقلية
kika	أنت
1969	1969
kotun.&#39;	المحكمة.
1962	1962
1964	1964
[Yesu]	[يسوع]
sarrafawa	الخدمات اللوجستية
(wasu	(بعض
jihãdi	نسعى جاهدين
fadin.	عبر.
(Ray	(راي
INF)	الوقود النووي المشع)
tafi	اذهب
(310	(310
-----------------&gt;&quot;	----------------- وطن؛ &amp; مثل؛
