XR650L	XR650L
(Erik	(Erik
daya?!?	one?!?
saman.	top.
535	535
samu,	found,
Surface	Surface
samu.	found.
jet	jet
#	#
&quot;hujja-Tsara	&amp; Quot; proof-Format
laifuffuka	Criminal
matakin.	level.
James	James
$	$
%	%
*	*
airlifted	airlifted
+	+
(Jon	(Jon
(	(
)	)
.	.
isa!	enough!
Team	Team
/	/
,	,
-	-
isa.	enough.
3	3
2	2
dawo	return
1	1
7	7
6	6
5	5
4	4
cafe	cafe
:	:
9	9
retrograde	retrograde
8	8
&lt;94318@hydra.gatech.EDU&gt;	&amp; Lt; 94318@hydra.gatech.EDU&amp;gt;
=	=
Gauche	Gauche
D	D
E	E
tushen.	based.
F	F
SetWUTime	SetWUTime
tushen,	based,
@	@
Kattai	Giants
A	A
B	B
lokaci.&quot;	time. &amp; quot;
sped	sped
C	C
L	L
M	M
MATATTU	ACCOUNTS
H	H
I	I
J	J
Dangantaka	Relationships
U	U
T	T
muka	we
hukumar	Agency
(713)	(713)
Q	Q
S	S
daruna	bowls
\	\
_	_
^	^
yankinka	area
X	X
1846	1846
mmm@cup.portal.com	html>
g	g
d	d
Feb	Feb
e	e
Tambayoyi:	Questions:
a	in
daya	one
bayani	solution
slated	slated
&lt;1r10jcINNt1g@lynx.unm.edu&gt;	&amp; Lt; 1r10jcINNt1g@lynx.unm.edu&amp;gt;
kunshe-kunshe&quot;	packages &amp; quot;
o	o
m	m
tsananin.	Stern.
h	h
i	i
w	w
hakikanin	real
520	520
p	p
Optilink!	Optilink!
isar	conveying
~	~
|	|
&quot;Re-bayyana?&quot;	&amp; Quot; Re-appear? &amp; Quot;
&#39;Ina	&#39;I
x	x
kankara	ice
karanta,	read,
(KJV)	(KJV)
zambiyõyin	footsteps
(ciki	(Including
agressive	agressive
mallakar.	owned.
Melnick)	Melnick)
updated	updated
Duniya-a	World-in
JPEG,	JPEG,
azuzuwan	classes
ocom.okstate.edu	html>
580	580
Adam	Adam
paralleled	paralleled
helium,	helium,
firamare	Primary
tsalle	Jumping
FAQ.	FAQ.
Gida	Home
farfaganda.	propaganda.
helium.	helium.
FAQ,	FAQ
(sorry	(Sorry
&quot;yi	&amp; Quot;
hadar	Bonds
(haɗa	(Including
update	update
ƙunshi	contains
Halitta	Created
Ma&#39;aikatan	Staff
tekuna.	seas.
(__)	(__)
Kasar	Country
&#39;yan&#39;	&#39;&#39;
samu]	found]
&quot;mun	&amp; Quot; we
dalilai:	reasons:
(Wannan	(This
XBell	XBell
YI.	DO.
dangane	connection
samun	access
Yunkurin	Attempt
Sugar	Sugar
lpt1	lpt1
azaba.)	punishment.)
Fir	Fir
3rd	3rd
Godiya	Thanks
pgf@srl02.cacs.usl.edu|Like	pgf@srl02.cacs.usl.edu|Like
Division	Division
Fit	Fit
dalilai.	reasons.
addini	religious
karya-koyaswa?	false doctrine?
Tasco	Tasco
DR250ES	DR250ES
&quot;ko	&amp; Quot;
Kashi	Percent
vesterman.	vesterman.
ishe	enough
redefined	redefined
&gt;&gt;	&amp; Gt; &amp; gt;
jobs.	jobs.
labarai-taron	news-conference
kanta.	itself.
burodi.	bread.
miles)	miles)
&lt;C51nLs.7As@boi.hp.com&gt;,	&amp; Lt; C51nLs.7As@boi.hp.com&amp;gt ;,
noiseless	noiseless
cewa&quot;	that &amp; quot;
tafi,	Go,
Detriot,	Detriot,
m-ja	m-red
cryptography	cryptography
comets	comets
faruwa	going
hange.	spotted.
masu&gt;	&amp; gt;
zanga-gun	anti-gun
freezes,	freezes,
frosted	frosted
tambayar.	question.
kãfirta.	reject.
samfurori.	products.
Intanet	Internet
tun&#39;	since &#39;
tafi?	go?
hunturu	winter
internet:	internet:
ciniki,	trade,
(Blaise	(Blaise
010-A	010-A
luwadi,	homosexuals,
Juyin	Revolution
Annabawa.	Prophets.
4H7	4H7
Annabawa,	Prophets,
&quot;hakikanin&quot;&gt;	&amp; Quot; real &amp; quot; &amp; gt;
Irin	Such
Norway	Norway
&quot;ja	&amp; Quot; red
indepth	indepth
Norway):	Norway):
dutsen	mountain
tarurruka&gt;	meetings &amp; gt;
Algorithms	Algorithms
GIDA.	HOME.
jin	feel
bayanai.	information.
bayanai,	information,
Douglas	Douglas
Liwadi	Homosexuality
Neptune	Neptune
Toyota,	Toyota,
tranfer	tranfer
50.	50.
50,	50
DOUBLE_BUFFER	DOUBLE_BUFFER
ciwon	having
500	500
--------------------------------------------	--------------------------------------------
yanayi	conditions
muke	we
opti	opti
12:26	12:26
tangent	tangent
kyau&quot;	good &amp; quot;
maria,	maria,
Edmond	Edmond
&quot;kai&quot;	&amp; Quot; &amp; quot;
&quot;mu	&amp; Quot;
&quot;na	&amp; Quot;
bukata	required
gashi&quot;	hair &amp; quot;
dunes.	dunes.
launuka	colors
muni	worse
5.7	5.7
accusors.	accusors.
LOVE	LOVE
tattaunawa	talks
Stein)	Stein)
hasãrar	lost
meteoroids.	meteoroids.
5.0	5.0
ambaliya	flooding
1870	1870
muna	we
zobe	ring
ciwo)	Syndrome)
Wolves	Wolves
&lt;1r9j33$4g8@hsdndev.harvard.edu&gt;,	&amp; Lt; 1r9j33$4g8@hsdndev.harvard.edu&amp;gt ;,
2,000	2,000
^^^^^^^^^^^^^^^^^^^^^^^^^^^^^^^^^^^^^^^^^^^^^^^^^^	^^^^^^^^^^^^^^^^^^^^^^^^^^^^^^^^^^^^^^^^^^^^^^^^^^
rooting	rooting
huce.	chill.
m-grained	fine-grained
763-5889	763-5889
saman	top
tursasawa	compelling
84-shekara	84-year
bazara	summer
duk&gt;	all &amp; gt;
samar	production
mulkin.	rule.
timmbake@mcl.ucsb.edu	html>
Window	Window
&quot;cika&quot;	&amp; Quot; full &amp; quot;
Cyrix	Cyrix
mulkin)	rule)
amana.	confidence.
Jamus	Germany
16-169	16-169
ita	it
Katange	Blocked
sama)	above)
ɗan&#39;uwãna	brother
1ff,	1ff
sama,	above,
sama.	above.
Cyric	Cyric
helium	helium
NUETZMAN	NUETZMAN
sama?	Heaven?
ayyuka.	functions.
joules	joules
escalating,	escalating,
FTP	FTP
Domin&gt;	For &amp; gt;
gumakan.	gods.
likita&quot;	medical &amp; quot;
&lt;sl3b+@andrew.cmu.edu&gt;	&amp; Lt; sl3b+@andrew.cmu.edu&amp;gt;
ɗ	d
Kwana	Days
Popup	Popup
magance	deal
gabatar	presented
tsunkule	pinch
Honda	Honda
Back&quot;	Back &amp; quot;
superencipherment	superencipherment
&lt;1rbn60$gs7@usenet.INS.CWRU.Edu&gt;	&amp; Lt; 1rbn60$gs7@usenet.INS.CWRU.Edu&amp;gt;
sababbin	new
al&#39;umma,	community,
irin	such
chipset.	chipset.
al&#39;umma)	community)
&#39;jin	&#39;Hearing
musu	them
kiwon	health
bautawarku.	god.
naushe	blows
(82,178	(82,178
daban-daban,	different,
Maɗaukaki,	High,
kansu.	themselves.
Technology,	Technology,
seconds.	seconds.
kansu,	themselves,
Craters	Craters
&quot;yisti	&amp; Quot; yeast
Muka	We
noring@netcom.com	html>
mutu	die
&quot;Developing	&amp; Quot; Developing
688-8231	688-8231
Tsarin	System
tunaninka,	intellegence
XXX	XXX
gigice	Shocked
kodadde,	pale,
hays@ssd.intel.com	html>
vata	waste
...........	...........
subsystems	subsystems
wanzu	exist
Muna	We
iri	brand
haske	light
isa	enough
littattafai,	books,
Tsai)	Tsai)
&lt;_Atheism:	&amp; Lt; _Atheism:
Godiya!	Thanks!
iconified).	iconified).
karye.	snap.
methane	methane
jiragen	ships
kwamfuta	computer
ra&#39;ayin,	idea,
kwaro	bug
11:25	11:25
Tsarki	Purity
al&#39;umma:	community:
magani,	treatment,
inã	I
(604)	(604)
watsi.	emissions.
magani.	treatment.
ra&#39;ayin?	idea?
kwari	insects
gravitational	gravitational
giant	giant
gargajiya	Traditional
Almasihu	Christ
Palasdinawa	Palestinian
Shugaba	President
Fe&gt;	Courier &amp; gt;
(Kusan	(Almost
rãyuwar,	life,
Dalilin	Reason
PowerPC	PowerPC
hakkin.	right.
yawan.	population.
nitrogen,	nitrogen,
paperwork?	paperwork?
nitrogen.	nitrogen.
(SKELTON,	(SKELTON
&lt;rauser.734062608@sfu.ca&gt;	&amp; Lt; rauser.734062608@sfu.ca&amp;gt;
interrupts.	interrupts.
Crawford)	Crawford)
southeners,	southeners
autoexec.bat	autoexec.bat
============ECHO	============ Echo
dangantaka	relationships
premade	premade
ɓullo	developed
tattaunawa,	discussion,
nan.&quot;	. &amp; quot;
tattaunawa.	discussion.
Misira	Egypt
gaskata	believe
kusanci	approach
launuka.	colors.
cokula,	shovels,
kwana	days
jeri	placement
wargi.	joke.
NEA.	Nea.
resisters	resisters
nassi	passage
jere	row
soke	cancel
jera	Listed
caje	search
addini&gt;	Religion &amp; gt;
jaskew@spam.maths.adelaide.edu	html>
caji	search
nufin,	means,
iya	can
Clint	Clint
Technologies,	Technologies,
Hockey	Hockey
gajeren?	short?
littattafan:	books:
Jordan	Jordan
rumfa	awning
ultraviolet	ultraviolet
sunã	they
Daidai,	Exactly,
&quot;Kirista&quot;,	&amp; Quot; &amp; quot ;, Christian
Marty,	Marty,
1.770	1,770
samfurin	product
maganar	word
percieved	percieved
-391	-391
&#39;watanni	Months
can.	there.
sadaka.	charity.
Columbia	Columbia
babba	great
Original	Original
surveyed.	surveyed.
post.	post.
anti-dogara	anti-trust
post,	post,
fun.	fun.
rangadin	tour
tashinsa	resurrection
matafã	receding
&amp;	&amp; Amp;
rscharfy@magnus.acs.ohio-state.edu	html>
magana,	Speaking,
magana.	Speaking.
can?	there?
mafaka	resort
G20	G20
Kristi&gt;	Christ &amp; gt;
watsa,	transmission,
mujalloli	newsletters
tuntube&gt;	Contact &amp; gt;
ikon,	power,
Fasaha&gt;	Technology &amp; gt;
daɗi	comfortable
kwafe	copy
Suka	And
kamanta	comparative
bidiyo	video
(saman	(Top
.4ID	.4ID
salon	salon
atmospheres	atmospheres
Louis	Louis
Shell	Shell
Chance	Chance
Sun!	Sun!
ALLAH	GOD
meteoroid	meteoroid
mafarkai,	dreams,
inda&gt;	where &amp; gt;
354-1333,	354-1333,
#:	#:
401	401
Charon	Charon
jimla	sentence
400	400
henling	henling
&quot;wadanda	&amp; Quot;
kusa,	close
&quot;New	&amp; Quot; New
Cryptologia	Cryptologia
&quot;^^^^^^^^^^^^^^^^^^^^^^^^^^^^^^^^	&amp; Quot; ^^^^^^^^^^^^^^^^^^^^^^^^^^^^^^^^
1.610	1.610
kalmomi	words
bazuwar	random
bege?	hope?
Larabci	Arabic
170,	170
MUSU	THEIR
2nd	2nd
watakila	maybe
Kumbon	Spaceship
suna	are
securital	securital
!!	!!
kofa&quot;	door &amp; quot;
nukiliya	Nuclear
sabobin	servers
yarda	agree
karfe.	steel.
artmel@well.sf.ca.us	html>
(______	(______
siffar	shape
Littafi	Book
************	************
Elvis	Elvis
suma	spot
reponse	reponse
14-19	14-19
(Karl	(Karl
yarda,	agree,
Martin,	Martin,
kiyaye	keep
barin	leave
yarda.	agree.
&lt;RVESTERM@vma.cc.nd.edu&gt;	&amp; Lt; RVESTERM@vma.cc.nd.edu&amp;gt;
engp2008@nusvm.nus.sg	html>
yarda?	agree?
ken	ken
CETO	SAVING
farashin	price
rinjayar	influence
key	key
35.789	35,789
&quot;mu&quot;	&amp; Quot; &amp; quot;
majalisan	Council
Attaura.&quot;	Law. &amp; Quot;
dama&gt;	Several &amp; gt;
tantanin	cell
100&gt;&gt;	100 &amp; gt; &amp; gt;
Leafs	Leafs
ƙamus	dictionary
($	($
dookie!&quot;	dookie! &amp; quot;
8:31	8:31
gwaje-gwaje.	tests.
mamaki	surprise
bargo	blanket
suke	they
Boston	Boston
gwamnatin	Government
fuskantar	facing
suka	they
mutane&gt;	people &amp; gt;
Sun,	Sun,
rinjaye.	majority.
firearm	firearm
placid-neman	placid-looking
Sun.	Sun.
shaidan	Satan
decrypt	decrypt
Laifuka	Criminal
Shirya	Prepared
ke,	,
dogayen	tall
pizza-canza	pizza-change
barga	stable
Sun;	Sun;
shaidar	witness
nisa	width
Stassen	Stassen
barjat	littered
audio	audio
Suna	Are
ake&gt;	&amp; gt;
funny	funny
gyara.	repair.
ƙiren	fabrication
sightings	sightings
kafin&gt;	before &amp; gt;
kowa.	everyone.
467	467
waje	Foreign
-&gt;	- &amp; Gt;
schematics.	schematics.
tafi&gt;	Go &amp; gt;
zurfi.	deep.
rodents	rodents
lander	lander
Kiyãma&gt;	Judgment &amp; gt;
shaida,	witness
shaida.	witness.
ringlets	ringlets
themself	themself
Driver	Driver
Fayiloli	Files
shaida)	Witness)
bunkasa	Development
(m	(M
**	**
Kwafa	Copy
Wai	Wai
Sue,	Sue,
ku)	)
photochemical	photochemical
mil).	miles).
Shirin	Program
mil),	miles),
Iska	Air
Johnson,	Johnson,
Purchase	Purchase
iri.	types.
+1	+1
++	++
rabin	half
&quot;gabatarwa&quot;	&amp; Quot; promotion &amp; quot;
(A	(A
phj@remus.rutgers.edu	html>
stats:&gt;&gt;	stats: &amp; gt; &amp; gt;
*************************************	*************************************
look-	look-
plexiglassso	plexiglassso
4.094	4,094
¡uraishi	Showered
algorithm	algorithm
(2	(2
lawfully	lawfully
CSHOW	CSHOW
samaniya.	universe.
ƙarshe	final
(1	(1
jarrabawa.	examination.
War	War
(7	(7
zahiri	actually
jarrabawa,	examination,
()	()
kasance	be
cikinsu.	them.
samaniya,	universe,
(a	(
&#39;real&#39;	&#39;Real&#39;
Magic	Magic
hijira	AH
fringes	fringes
(\	(\
abubuwan	events
arewa	North
ritley@uimrl7.mrl.uiuc.edu	html>
&quot;madadin&quot;	&amp; Quot; alternative &amp; quot;
(I	(I
),	)
Cometary	Cometary
tarkace	debris
abũbuwan	gods
Puryear	Puryear
Menene	What
wuri.	place.
preps	preps
hardcore	hardcore
..	..
gonzaled@ucsu.Colorado.EDU	html>
(korenek@nmti.com)	(Korenek@nmti.com)
Altima	Altima
kwanaki,	days,
lalata	damage
kwanaki)	days)
lamba	contact
dokar,	Act
ruxani	puzzled
eroded,	eroded,
league	league
kwanaki.	days.
//	//
&quot;Babu	&amp; Quot; No
abubuwa,	items
exhibiting	exhibiting
abubuwa.	items.
idan&gt;	If &amp; gt;
shirye-shirye.	programs.
babur	motorcycle
Kalmar	Word
wurin	place
Abun	Content
ge!severy%severy@uunet.UU.NET	html>
MAX641,	MAX641,
[Gen	[Gen
tectonics	tectonics
iri-iri	variety
impedance	impedance
tsakanin	between
e-mail:	e-mail:
colder	colder
faɗaɗa	expansion
dakatar	suspended
ergo	Ergo
ILV20078@UDELVM.UDEL.EDU	html>
fãce	but
Gay	Gay
sharudda	criteria
451-0815	451-0815
banza.	vain.
hushi	Angry
4.6	4.6
Cramer	Cramer
Gas	Gas
nike	digest
-.	-.
raster	Raste
maneuvering	maneuvering
duration	duration
kungiyar.	group.
up&quot;	up &amp; quot;
kungiyar,	group,
midsummer.	midsummer.
Ɗan	Son
Kloo	Kloo
walwala	liberty
hadewa	link
karya-likita	break-doctor
sirri	personal
namelplate	namelplate
Morocco	Morocco
35	35
Wata	A
waya	Phone
Tug-na-yaki	Tug-of-war
ansu	other
3:	3:
&lt;1993Apr21.170403.22855@yang.earlham.edu&gt;	&amp; Lt; 1993Apr21.170403.22855@yang.earlham.edu&amp;gt;
4.	4.
4,	4,
Wasu	Other
42	42
40	40
jirgin.	Ark.
(613)	(613)
2:	2:
(128.149.6.2);	(128.149.6.2);
anti	anti
22	22
severy	severy
23	23
24	24
befor	befor
kurakurai.	errors.
PowerBooks?	PowerBooks?
25	25
Rowland	Rowland
tura	push
26	26
1W	1w
kwararru.	specialists.
dashi.	disposal.
3,	3,
tsarkakewa	purification
3.	3.
30	30
1m	1m
Ishii,	Ishii,
31	31
PowerBooks,	PowerBooks
greenhouse,	greenhouse,
3)	3)
isasshe	enough
19	19
1:	1:
dakunan	rooms
17	17
wawa	fool
18	18
15	15
Abin	What
16	16
13	13
14	14
11	11
12	12
21	21
20	20
kimanin	about
2.	2.
Lalle	That
2,	2,
mamaye	dominated
2)	2)
21-22:	21-22:
2%	2%
teku,	the sea,
teku.	sea.
wucewa	passing
taga.	window.
taga,	window,
watã	moon
erikb@idt.unit.no	html>
1.	1.
cututtuka&quot;	diseases &amp; quot;
10	10
lokacin.	time.
1)	1)
lokacin,	time,
1%	1%
maroƙi	supplier
unaccepted	unaccepted
Swartz	Swartz
Linjila?	Gospel?
7:	7:
Sulfur	Sulfur
78	78
West.	West.
Bugu	Printing
7.329.	7,329.
prohipiting	prohipiting
(gaskiya),	(True),
compatable	compatable
jarumi,	brave,
8,	8,
ZUWA	TO
minutes.	minutes.
butterscotch	butterscotch
(waxanda	(Which
6:	6:
Lunar	Lunar
hukuma	official
7)	7)
zur	zur
ce:&gt;	said: &amp; gt;
!!!!&quot;	!!!! &amp; Quot;
7,	7,
kurakurai	errors
generated	generated
70	70
72	72
rasa!	lost!
76	76
modem	modem
model	model
5:	5:
martyj@uiuc.edu	html>
Solomita)	Solomina)
56	56
Update	Update
dũbi	see
55	55
5?	5?
dũba	Look
6,	6,
girma	great
&#39;yan&#39;uwa,	Brothers,
rigor.	rigo.
12,00	12,00
lambar,	number,
mahallin.	context.
60	60
narke	melt
kudancin	Southern
^^^^^^^^^^^^^^^^^^^^^^^^^^^^^^^^^^^	^^^^^^^^^^^^^^^^^^^^^^^^^^^^^^^^^^^
4:	4:
1980s.	1980s.
makirci.	scheme.
4th?	4th?
makada.	bands.
feda,	pedal,
______	______
Wane	Which
70,000th	70,000th
WW2	WW2
maniyyi	drop
5,	5,
haye-duba	cross-check
Wani	A
Clipper	Clipper
subsystem	subsystem
Arewacin	North
pcx,	pcx,
5.	5.
Torre:	Torre:
50	50
damar	access
(508)	(508)
Sheen	Sheen
Azzam)	Azzam)
486	486
*************************************************	*************************************************
lalle	that
99,86	99.86
namiji,&gt;	male, &amp; gt;
kulawa	care
482	482
&lt;a	&amp; Lt;
kasashen	countries
sakamakon,	result,
&lt;/	&amp; Lt; /
kar	do
kan	on
Madrid	Madrid
baucoci	Coupons
kai	head
Aikace-aikace	Applications
gwaje-gwajen	experiments
cakulan	chocolate
Lankform,	Lankform
::	::
10:39:15	10:39:15
gurbata	contaminated
turɓaya	dust
grounded.	grounded.
rududdugaggu	rotten
ƙila	Maybe
wani	a
dama?	right?
:)	:)
gawawwaki	bodies
Madogararsa.	Source.
fitila,	Lamp,
ka.	.
sbp002@acad.drake.edu	html>
kasanta	perpetrated
93	93
90	90
misinformed.	misinformed.
ka,	,
followup	followup
[Kiristoci]	[Christians]
daman	right
==================================================	==================================================
88	88
azzãlumai?	wrong?
kamfanin,&gt;	company &amp; gt;
da&#39;ira	Cycle
ce&gt;	&amp; gt;
wato	the
madadin	Alternatively
Kardon	Kardon
codify	codify
Sama.&quot;	Above. &amp; Quot;
??	??
kusurwa)	corner)
Watã	Moon
MacRae):&gt;&gt;&gt;	MacRae): &amp; gt; &amp; gt; &amp; gt;
mishap,	mishap,
wahala?	difficulty?
prescient	prescient
dama,	Several
?!	?!
fassara	translation
manufacturer	manufacturer
sa-saukar	put-down
na&gt;	&amp; gt;
dansa.	son.
Moon.	Moon.
tsohon	former
kimiyyar	science
sabobin.	servers.
kusan	almost
Moon,	Moon,
daruruwan	hundreds
Leong,	Leong,
dũka	strike
laifi-line	fault-line
faranta	please
kuri&#39;a	lots
X11	X11
(LGV	(LGV
faranti	plates
wahala.	difficulty.
Bure	Free download
wahala,	difficulty,
(Ken	(Ken
For	For
graphics	graphics
Erik	Erik
gt4417a@prism.gatech.EDU	html>
wasa	play
WNI	WNI
wasu	other
halicce	created
Fahrenheit)	Fahrenheit)
jita-jita	rumor
wata	a
bishara	gospel
tsoho,	default,
hattara	beware
motherships	motherships
Da	And
yoghurt	yoghurt
Glance	Glance
bukatan	need
labari	Article
ethane	ethane
4,850	4.850
aiki?	work?
daidaitattun	standard
bukatar	need
&#39;taimako	Help
E.	E.
aiki,	operation,
Land,	Land,
DE	DE
jihar,	state,
Galatiyawa	Galatians
(korenek@nmti.com)&gt;&gt;&gt;	(Korenek@nmti.com) &amp; gt; &amp; gt; &amp; gt;
aiki.	work.
DH	DH
shafukan	sites
jihar.	state.
Ci	Eat
bisharar	gospel
Bures&gt;	Bures &amp; gt;
California.	California.
virus..It	virus..It
340	340
knowledgable	knowledgable
Ta&#39;addanci)	Terrorism)
manajoji	managers
Kiristanci	Christianity
falsafa	philosophy
fitilar	Lamp
GE	GE
Fe	Fe
Wen-Cheng	Wen-Cheng
outlaws	outlaws
babbar,	great
Spaceflight	Spaceflight
mutu-karshen	dead-end
wadãta	prosperity
handbooks	handbooks
tẽkun.	Ocean.
kwaruruka,	valleys,
tẽkun,	Ocean,
IO.	IO.
G.	G.
FM	FM
IO,	IO,
kanmu	ourselves
FI	FI
HG	HG
Place	Place
mahadi	Compounds
Ga	To
samfurin.	product.
&lt;C5t7Gs.7v3@news.iastate.edu&gt;	&amp; Lt; C5t7Gs.7v3@news.iastate.edu&amp;gt;
Almasihu.&quot;	Christ. &amp; Quot;
Incorporated	Incorporated
IP:	IP:
proportionally,	proportionally,
763-2626	763-2626
Larabawa	Arab
teku	sea
suKe	they
mutane?&quot;	people? &amp; quot;
GP	GP
GO	GO
H.	H.
GM	GM
fata)	skin)
(Paul	(Paul
recomendations	recomendations
oddball	oddball
volts	volts
Systems,	Systems,
itself_	itself_
jima&#39;i.	sex.
Secondaries	Secondaries
manufa	target
hau	ride
5:17	5:17
jima&#39;i)	sex)
jusgement	jusgement
Oort	Oort
har	up
cruise	cruise
&quot;Ɗan	&amp; Quot; Dan
yaya	How
fafitikar	struggling
Titan	Titan
spirochetal,	spirochetal
Yadda	How
Johnson,&gt;	Johnson &amp; gt;
1930,	1930,
yayi	offers
A.	A.
======================================&gt;	====================================== &amp; Gt;
AT	AT
300	300
ɗan	son
rana-generated	sun-generated
amfãni	benefits
BA	BA
gabatarwar	introduction
30%	30%
lokacin&gt;	When &amp; gt;
III	III
AM	AM
B.	B.
Sweden	Sweden
30,	30,
Hi,	Hi,
IMMMMMMMMMMMMMMMMMMMMMMMMMMMMMMMMMMMMMMMMMMMMMMMMMMMMMMMMMMM.	IMMMMMMMMMMMMMMMMMMMMMMMMMMMMMMMMMMMMMMMMMMMMMMMMMMMMMMMMMMM.
AN	AN
BV	BV
C:	C:
frame,	frame,
&lt;C5qsBF.IEK@ms.uky.edu&gt;	&amp; Lt; C5qsBF.IEK@ms.uky.edu&amp;gt;
As	AS
Ba	Not
CA	CA
ƙaunar	love
BF	BF
aikin	work
BI	BI
Extraterrestrial	Extraterrestrial
BC	BC
Ad	Ad
wuce.	ago.
An	An
wuce,	ago
(2,147	(2,147
C,	C
C.	C.
Al	Al
3.0	3.0
By	By
3.1	3.1
Eastwood	Eastwood
3.8	3.8
sarari	space
DB	DB
DA	AND
yanzu	now
gabatarwa.	promotion.
3.5	3.5
zai	will
&#39;Allah.&quot;	&#39;God. &amp; Quot;
Jovian	Jovian
zan	I
CD	CD
kanka	yourself
D.	D.
dakin	room
Ku	You
!!)	!!)
(Ibraniyawa	(Hebrews
Assad	Assad
IDE	IDE
!!!	!!!
M.	M.
haihuwa	old
Ko	Or
Twin	Twin
hey	hey
(NASA	(NASA
cratered	cratered
gwiwa	cooperation
wuski	whiskey
Leonard	Leonard
LITTLE	LITTLE
ɗaure	bound
MD	MD
MB	MB
kõguna	rivers
kananan,	U there,
da&gt;	&amp; gt;
162,	162,
reformatting	reformatting
yanayi.	conditions.
N.	N.
yanayi,	conditions,
Gilkey	Gilkey
keyboard,	keyboard,
SOSAI	DEEP
MS	MS
Me	Why
kirki.&quot;	good. &amp; quot;
sandare	condense
NI	NI
bauta	worship
riverbeds	riverbeds
NA	NA
dlb@fanny.wash.inmet.com	html>
NE	NE
tef.	tape.
My	My
Mu	We
Electronics,	Electronics,
Homo	Homo
---------------------------	---------------------------
Zai	Will
NO	NO
Zan	I
&lt;ekdfc.14.0@ttacs1.ttu.edu&gt;,	&amp; Lt; ekdfc.14.0@ttacs1.ttu.edu&amp;gt ;,
P.	P.
(6,200	(6,200
ON	ON
Ni	Me
amaryar	bride
Ne	Is
(&quot;sararan	(&amp; Quot; Plains
Multi-da	Multi-
Na	I
zo,	come,
farantin,	plate,
star	star
P5	P5 +
OP	OP
yanayin	case
lei@rtsg.mot.com	html>
Ok	OK
On	On
(Wen-Cheng	(Wen-Cheng
Oh	Oh
sulfur	sulfur
musun	denied
PA	PA
PB	Pb
PC	PC
pseudo-	pseudo-
I,	I,
yanar-gizo.	Internet.
tsakiya,	Central,
kirkiro	create
al&#39;amari	matter
Barringer	Barringer
wucin	Interim
domin,	because,
(idan	(If
Yankee	Yankee
jawabi	Addressing
meteor.	meteor.
meteorites	meteorites
hit	hit
ID	ID
domin:	to:
IF	IF
II	II
nuet_ke@pts.mot.com	html>
Tom&gt;	Tom &amp; gt;
Hi	Hi
J.	J.
fatan	hopes
IN	IN
quack	quack
IO	IO
fatar	skin
IT	IT
canza	change
dh782@cleveland.Freenet.Edu	html>
sitiriyo	stereo
Club.	Club.
musu,	them,
PLEASE	PLEASE
ɗaukar	taking
sana&#39;a	Professional
Hz	Hz
Network	Network
EGALON)	EGALON)
Larabawa,	Arab,
&quot;),	&amp; Quot;),
gudu-na-da-niƙa&gt;	run-of-the-mill &amp; gt;
christian	christian
In	I
taimake	help
flexing	flexing
misinformation	misinformation
volcanic	volcanic
taimaka	help
JT	JT
validating	validating
tsakiyar	middle
meteorite.	meteorite.
meteors	meteors
(Hamaza	(Hamaza
IBM	IBM
yayan.	constituents.
taimako	help
st1ge@Elroy.UH.EDU	html>
Toyota	Toyota
promiscuous	promiscuous
(Joseph	(Joseph
KO	OR
taswira	map
L.	L.
jagoranci	LED
your	your
bombardment	bombardment
Hal	Hal
ID.	ID.
Ka	You
Nereid	Nereid
LH	LH
1938,	1938,
Kimiyya	Science
Har	Up
ƙunci	thicket
FROMTHEDEAD:	FROMTHEDEAD:
Afirka	Africa
haskakawa,	shines,
swirl	swirl
stephen.guerke@mvs.udel.edu~~V	stephen.guerke@mvs.udel.edu
&lt;C5w5CB.Ct4@rahul.net&gt;,	&amp; Lt; C5w5CB.Ct4@rahul.net&amp;gt ;,
VL	VL
W.	W.
juya	turn
yayata	speculate
jagoran	Leader
Lebannon.	Lebannon.
&quot;Ga	&amp; Quot; For
ashin	heading
hotunan	photographs
diferential	diferential
Yesu&quot;.	Jesus &amp; quot ;.
kasuwanci.	business.
almajiri	pupil
To	Then
wasanni	Sports
shigar	input
Ta	By
abokiyar	partner
&quot;Bã	&amp; Quot; They
TX	TX
TV	TV
Su	To
Kundin	Volumes
wnk@aquifer.geology.uiuc.edu	html>
waɗannan	these
XT	Seats
inconsistency	inconsistency
dogara	trust
Norton	Norton
Landmann	Landmann
hotuna.	pictures.
low&gt;	low &amp; gt;
(Fir)	(Portable)
canja	change
canji	change
Larabawa?	Arab?
gogayya	friction
------------------------	------------------------
Jun&#39;ichiro	Jun&#39;ichiro
dogaro	liable
gabatar.	presentation.
Larabawa.	Arab.
tubalan	Blocks
Mene	What
Open	Open
Sysops)	Sysops)
wuce	ago
shari&#39;a,	legal,
mutane&#39;	people &#39;
Pathfinder&gt;&gt;&gt;	Pathfinder &amp; gt; &amp; gt; &amp; gt;
S.	S.
Yakubu&#39;?	Jacob &#39;?
Gun	Gun
Lahadi	Sunday
Saita	Set
Folta)	Folta)
sarari.	space.
haramun	haram
Guy	Guy
&quot;wucin	&amp; Quot; ad
kimiya	Science
(daban-daban),	(Various)
dacewa	fitness
R.	R.
alin@nyx.cs.du.edu	html>
al&#39;amarin	case
(1.5-mil)	(1.5-mile)
rundunar	host
ka&#39;idodinta	principles
mãsu	are
ka&#39;idojin	theoretical
yancin	right
lemu.	oranges.
Bayahude	Jew
kwari.	bugs.
kirki&quot;	good &amp; quot;
ganewar	complexity
TO	TO
juyin	Revolution
makãmashin	fuel
sararin	space
SS	SS
hawaye	tears
surface,	surface,
tattali	prepared
Chin	Chin
TA	TA
T)	T)
mutunci.	integrity.
SI	SI
surface.	surface.
liscened	liscened
-120	-120
&quot;bindiga	&amp; Quot; gun
RR	RR
DH-kamar	DH-like
ka&#39;idoji.	regulations.
ma&#39;aunan	balances
gwaje-gwajen,	experiments,
fatally	fatally
Sarkar.	Chain.
///////	///////
al&#39;amari:	matter:
franjion@spot.colorado.edu	html>
SA	SA
Driver&gt;	Driver &amp; gt;
Bayahude,	Jew,
&quot;alamar	&amp; Quot; sign
Yã	O
​​daga	from
za,	,
Refayawa.	Giants.
site,	site,
(Etan	(Ethan
N3JXP	N3JXP
ruwa-ruwa	Aqueous
Sale	Sale
planetary	planetary
^)	^)
Severy	Severy
waving	waving
\\	\\
argon	argon
CONFIG.SYS	CONFIG.SYS
=============================================	=============================================
Sam.	Sam.
zuwa&gt;	&amp; gt;
Saki	Release
geyser-kamar	geyser-like
unsympathetic	unsympathetic
zabi&gt;	choice &amp; gt;
mutãne	people
Sake	Again
jure	resistance
&#39;madawwama	&#39;Forever
a,	,
a.	a.
__	__
block	block
&#39;haƙiƙa	&#39;Sure
a!	in!
rayuwa	life
izinin	permission
ekweita	equator
MouseWare	MouseWare
dbernard@clesun.Central.Sun.COM	html>
Oktoba	October
.signature.	.signature.
Hutchison&quot;	Hutchison &amp; quot;
cikinsu	them
talauci	poverty
aiko.	sent.
ainihi	real
r&gt;	r &amp; gt;
[2]	[2]
^^	^^
Yahaya	John
Bayani	Solution
umurni	bid
gun	gun
3-8),&gt;	3-8), &amp; gt;
Press	Press
ZA	WILL
wuta.	fire.
-183	-183
binciko,	exploring,
382	382
halittu	Worlds
Ya	To
game,	about
Renaissance,	Renaissance,
tarihi	history
littafin	book
Renaissance.	Renaissance.
Bincike	Research
Yi	Do
tattare	resolves
tattara	Collection
-179	-179
dukkan,	all
halitta	created
sabawa.	adjustments.
kanta	itself
tsautsayi	depleted
catagories	catagories
Lokacin	Time
Italiya,	Italy,
(Douglas	(Douglas
yankinka,	area,
375	375
YI	DO
saki)	release)
Shin&gt;	Do &amp; gt;
dala}!	$!
juna	another
craters.	craters.
sosai	very
remnants	remnants
kansa	himself
Masters	Masters
sake,	again,
[a	[
Nanaimo,	Nanaimo,
magoya	fans
360	360
Uranus.	Uranus.
Uranus,	Uranus,
rantsuwa,	By,
Dogarin	ADC
Sũ	They
kansu	themselves
Isra&#39;ila.	Israel.
karbar	receiver
zurfin	depth
HRB	HRB
biliyan	billion
Samo	Found
Za	Will
Sams	Sams
apriori.	apriori.
&quot;quack&quot;	&amp; Quot; quack &amp; quot;
Chris	Chris
\)	\)
mummunan	negative
\.	\.
¡iyãma	Judgment
ga&gt;	&amp; gt;
abyss	abyss
YESU	JESUS
48?)	48?)
K1Y	K1Y
jefa	throw
Land	Land
al&#39;adar	custom
Tsaya	Stand
tsallake	skip
(nan	(
ga	to
&lt;1qksc2$2mr@fido.asd.sgi.com&gt;	&amp; Lt; 1qksc2$2mr@fido.asd.sgi.com&amp;gt;
bisexual	bisexual
bikin	celebration
rayuwa,	life,
bã	not
IRIN	KIND
JPL	JPL
fi	more
rayuwa.	life.
zafi-livered	hot-livered
bangaskiya	faith
Paul	Paul
Iraki?	Iraq?
203	203
bulala	whip
200	200
koyar	teach
201	201
20:	20:
dã	Had
Serbian	Serbian
mutane	people
ita.	her.
Dutsen	Mountain
SLEGGE@kean.ucs.munc.ca	html>
rahotannin.	reports.
Yin	To
20%	20%
wutar	fire
kyamarori	cameras
tsarkake	cleanse
miliyoyin	millions
cikinku	you
20-	20-
idan	if
20,	20,
zaunanniya	lasting
Uba,	Father,
Uba.	Father.
Beta	Beta
yiwuwa	probably
Rantsuwa	By
ra&#39;ayoyin	opinions
&quot;...	&amp; Quot; ...
recklessly	recklessly
akwai	there
thrusters	thrusters
facade?	facade?
ailin	Aili
&quot;nasan	&amp; Quot; I know
Banks	Banks
key&quot;	key &amp; quot;
21)	21)
rayuwar	life
Iftccu:	Iftccu:
21,	21,
tacky,	tacky,
Hanyar	Through
look	look
ĩmãni,	Faith
su).	).
ĩmãni.	believe.
Ina	I
delusional&gt;	delusional &amp; gt;
Advanced	Advanced
gagarumin	significant
(UNT-Tech	(UNT-Tech
matar,	wife,
bãya	back
Apollo	Apollo
2,300	2,300
en	en
murna	delight
Fraering)	Fraering)
jadawalin.	schedule.
(babu	(No
nassoshi	references
vuya,	disappears,
by	by
Lantz)	Lantz)
(Dostoevsky)	(Dostoevsky)
d,	d,
Yuni	June
jikin	body
(62-mile)	(62-mile)
etching	etching
(objectivity,	(Objectivity,
bi	Follow
idanu	eyes
talakawa,	poor,
1610,	1610,
da	and
talakawa.	ordinary.
Teemu	Teem
ya?	?
&quot;haƙiƙa&quot;	&amp; Quot; objective &amp; quot;
(Shin,	(Do
fassarar	Translation
talakawa:	ordinary:
(da&gt;	(&amp; Gt;
wuri	location
ci	eat
ya.	.
ce	said
&#39;mai	&#39;
ya,	,
blank&quot;.	blank &amp; quot ;.
XT350	XT350
ab245@cleveland.Freenet.Edu	html>
Ihu	Beep
Jama&#39;a	Public
batutuwa	topics
statistics	statistics
geb@cs.pitt.edu	html>
cibiyoyin	centers
magana	Speaking
falaki	astronomers
ice	ice
sace	stolen
mataki	action
ƙananan	lower
``	``
halittu,	Worlds
magani	treatment
Yuli	July
Azancin	Logically
talakawan	average
&quot;mayar	&amp; Quot; back
wuta	fire
ba	not
tattalin	prepared
at	at
saba	usual
ido	eye
transfering	transfering
Law,	Law,
c:	c:
National	National
franjion@spot.Colorado.EDU	html>
ƙaryata	denied
memory	memory
zalunta	treating
c.	c.
JKN	JKN
Tarho	Telephone
ai	ai
yau	today
yar	daughter
Janairu,	January,
A&#39;a,	No,
an	an
yan	s
[1]	[1]
annabce-annabce	prophecies
bijirar	expose
realy	realy
manufa!	target!
Cadillac&quot;	Cadillac &amp; quot;
California	California
da&#39;awar	claim
of	of
manufa.	target.
tsĩrar	delivered
mayar	return
on	on
manufa,	target,
batun	issue
schuster@panix.com	html>
Wannan	This
yafi	more
texts	texts
jinkirin	slow
wuccin	occasional
dutse-sized	mountain-sized
Bilatus	Pilate
Lippard)	Lippard)
kõ	or
ni),	I),
gyare-gyare,	repairs,
Jiki	Body
pe	pe
&quot;Na	&amp; Quot;
pc	pc
pl	pl
fledged	fledged
amps,	amps,
pm	pm
amps.	amps.
comment	comment
tashoshin,	stations,
radiation	radiation
Member	Member
psyrobtw@ubvmsb.cc.buffalo.edu	html>
Yan	Yan
dos.	dos.
myselfe	myselfe
jiki.	body.
meteor	meteor
yadu	widely
Yau	Today
batu:	point:
daji,	wild,
&quot;Ni	&amp; Quot; I
Yar	Daughter
novices	novices
manufar	purpose
yada	throw away
sinusitis	sinusitis
ma	too
mb	mb
jiki,	body,
uku.	three.
duniya-sized	world-sized
ƙulli,&gt;&gt;	Closure &amp; gt; &amp; gt;
me	Why
Ditto.	Ditto.
batu,	point,
ido,	eye,
Messier	Messier
46904	46904
shipper	shipper
ms	ms
mu	we
inning	inning
garwaya	tangled
&quot;kammala&quot;	&amp; Quot; complete &amp; quot;
tawada	ink
na	I
ne	is
tafiya	travel
ni	me
p.	p.
makamai,	weapons,
Fahrenheit),	Fahrenheit),
ra&#39;ayin	idea
nagarta	good
waɗannan,	these,
Fahrenheit).	Fahrenheit).
Orbiters	Orbiters
yabo	praise
wuka	knife
mock@watt.support.Corp.Sun.COM	html>
P.S.	P.S.
doke	beat
motoci	cars
doka	law
kama,	like,
XQueryTree	XQueryTree
m,	surgical,
Corollas,	Corollas,
ki	ki
yi)	)
ni.)	me.)
ke	to
yi.	.
ina	I
yi,	,
ka	you
Kimanin	About
Bressler)	Bressler)
Urushalima	Jerusalem
ku	you
yi?	?
ko	or
m.	m.
gida	home
Rubenfeld)	Rubenfeld)
sako-sako	loose
tsaunuka	Highlands
&quot;cantaloupe&quot;	&amp; Quot; cantaloupe &amp; quot;
low.	low.
&quot;mai	&amp; Quot;
murmurs	murmurs
Baftisma	Baptism
kamar	as
iko	power
===========	===========
catastrophic	catastrophic
Orbiter,	Orbiter,
ra&#39;ayi.	opinion.
tsammani.	anticipated.
Orbiter.	Orbiter.
da&#39;	&#39;
hi	hi
&gt;&gt;&gt;?	&amp; Gt; &amp; gt; &amp; gt ;?
alt.psychology.personality!	alt.psychology.personality!
shafi.	page.
Dukan	All
amounted	amounted
ila	ila
ra&#39;ayi:	opinion:
yin	to
matasa	young
ra&#39;ayi?	opinion?
daga&quot;	from &amp; quot;
livesey@solntze.wpd.sgi.com	html>
Xelion	Xelion
rauser@sfu.ca	html>
puck	puck
____	____
tsoho	default
&quot;Ka	&amp; Quot;
kida.	music.
down.	down.
disclaimer]	disclaimer
Kasashen	Countries
dole	must
in	in
je	go
disclaimers	disclaimers
blue	blue
ji	Hearing
kallon	watching
daftarin	draft
jinginar,	pledge,
ja	red
warkarwa	healing
COEGALON@LARC.NASA.GOV	html>
Sharma)	Sharma)
&lt;imani	&amp; Lt; belief
&quot;yarda&quot;	&amp; Quot; allowed &amp; quot;
al&#39;adu.	culture.
YYY	YYY
xt	Seats
Tambayata	Question
mazauni	seat
Trondheim	Trondheim
&#39;yana	&#39;
Powerbook	PowerBook
Schaufenbuel	Schaufenbuel
bading@cs.tu-	bading@cs.tu-
vv	VV
upperleft	upperleft
&quot;Zan	&amp; Quot; I
ɗauka	taken
wa	to
ɗauke	carrying
sunana,	my name,
Lantz	Lantz
nodrog@hardy.u.washington.edu	html>
&lt;C4Hyou.1Iz@mentor.cc.purdue.edu&gt;	&amp; Lt; C4Hyou.1Iz@mentor.cc.purdue.edu&amp;gt;
Pull	Pull
vs	vs
malaman	teachers
inshora	insurance
airlift	airlift
cẽwa,	that,
jima&#39;i&quot;.	sex &amp; quot ;.
Kira	Calls
iska	air
kaɗawa&#39;	wave &#39;
(James	(James
11-15,	11-15,
yana	is
kasancewar	existence
(huluna,	(Hats,
matrix	matrix
mũ	we
deportes	deportes
Kinsley	Kinsley
sassa,	parts,
up	up
rethorical.	rethorical.
dabbobi?	animals?
part	part
&quot;Minnesota	&amp; Quot; Minnesota
nĩ	I
to	to
v.	v.
ISA.	ISA.
(bari	(Let
des,	des
Kefas,	Cephas
roƙonka	Please
ISA)	ISA)
(Marcus	(Marcus
des)	des)
gaskiya,	Actually,
pre-amp&gt;	pre-amp &amp; gt;
te	te
yake	is
gaskiya.	true.
crustal	crustal
gaskiya)	Truth)
yaki	fight
ta	by
su	to
markings	markings
sakewa	cancellation
maza,	men,
asiri	mystery
sm	sm
maza.	men.
kaifin	smart
Delaware,	Delaware,
so	wills
hte	hte
mahara	multiple
Texas	Texas
canji.	change.
zurfi	deep
brenner@ldgo.columbia.edu	html>
sa	makes
labarai.	news.
gano,	identify,
gano.	identified.
fashe	cracked
nã	I
&#39;Yan	The
watanni	months
kwashe	copying
Nereid,	Nereid,
powerbook	PowerBook
Krista	CHRISTIAN
System	System
&quot;da	&amp; Quot;
Kristi	Christ
gasar.	competition.
mirgina	rolling
-221	-221
flocking	flocking
bressler@iftccu.ca.boeing.com	html>
mikawa	extending
bridgehead	bridgehead
birane,	cities,
iko&quot;&gt;	control &amp; quot; &amp; gt;
bukatun	requirements
&#39;&#39;	&#39;&#39;
Banks)	Banks)
octagonal	octagonal
sarƙoƙi,	chains,
Arewa&quot;	North &amp; quot;
sakonni	messages
Ayyukan	Activities
orbiting	orbiting
tilasta	forced
silicate	silicate
280	280
rahoton	report
Brooks)	Brooks)
Arab	Arab
yawo	Streaming
Janairu	January
bãbu	no
28:	28:
gani,	see
yayatawa	Rumored
mutãnen	people
amsa:&gt;	answer: &amp; gt;
&quot;Bure&quot;	&amp; Quot; Bureau &amp; quot;
yawa	many
27,	27,
NHL.	NHL.
koguna	rivers
kabilar	tribe
engp2008@nusunix.nus.sg	html>
winfrvk@dutiws.twi.tudelft.nl	html>
bindiga	Rifle
40-22k	40-22k
willisw@willisw.ENG.CLEMSON.edu	html>
Systems	Systems
sneakers	sneakers
&quot;Yã	&amp; Quot; O
fitina)	trial)
propter	propter
hitter	hitter
583.	583.
Egalon	Egalon
azumi-motsi	fast-moving
zã	will
drum-dimbin	drum-shaped
&quot;Mene	&amp; Quot; What
zanga-TRUST	ANTI-TRUST
abubuwa	items
ganin	see
gina	building
shahara	famous
Watts	Watts
gini	building
karatu,	reading,
hadin	Cooperation
Bulus:	Paul:
29,	29,
hanyar	through
logo	logo
&lt;BADING.93Apr23105229@athene.cs.tu-berlin.de&gt;	&amp; Lt; BADING.93Apr23105229@athene.cs.tu-berlin.de&amp;gt;
talk.politics.guns	talk.politics.guns
ƙungiyoyin!	groups!
leveling	leveling
City	City
(memory	(Memory
wuya	hard
darajõji,	degrees
Jerin	List
sanda.	rod.
&quot;a,	&amp; Quot;
pubinfo.jpl.nasa.gov	html>
katantanwa	Snail
fitina.	trial.
shahararren	prominent
wa&#39;adin	Promise
Qarshen	End
24,	24,
gani&gt;	Seeing &amp; gt;
caltech.edu	html>
falalarSa	Bounty
240	240
lankwasa	Flex
haƙĩƙa,	indeed,
little	little
gist	gist
safiya,	morning,
malami.	teacher.
Journal	Journal
raunata	wounded
yau.	today.
243	243
Ming)	Ming)
Prescribing	Prescribing
Hays)	Hays)
(5.25	(5.25
perpetuate	perpetuate
kalmar	word
hanya:	way:
yau,	today,
hanya.	way.
&quot;mafi	&amp; Quot; more
juyawa	Rotation
24-bit	24-bit
hanya,	way,
likitoci,	doctors,
Shopper)	Shopper)
ISA	ISA
ummiyan	gentile
yaro	boy
sũ	they
kludgy	kludgy
&lt;basu	&amp; Lt; not
ze	match
yara	children
Bloom	Bloom
za	will
taimakawa	help
&quot;MAGIC&quot;&gt;&gt;	&amp; Quot; MAGIC &amp; quot; &amp; gt; &amp; gt;
Japan&gt;	Japan &amp; gt;
(Walter	(Walter
zo	come
250	250
(Henling,	(Henling
J23	J23
farantin	plate
25,	25,
ya	to
*****	*****
mutãne,	people,
(mai	(
kalma,	word,
Winding.	Winding.
rufaffen	encrypted
[&quot;Mutanen	[&amp; Quot; People
White	White
wannan	this
dukansu,	all
berlin.de	html>
&lt;1r0vk6INNaft@cronkite.Central.Sun.COM&gt;	&amp; Lt; 1r0vk6INNaft@cronkite.Central.Sun.COM&amp;gt;
yi	do
Brenner	Brenner
GetGeometry	GetGeometry
kõme.	nothing.
Iaccoca	Iaccoca
Shopper	Shopper
muhimmancin	seriousness
kore	green
Matrix	Matrix
mafi	more
sakamako&quot;	effect &amp; quot;
&#39;Ba	&#39;No
jagororin	guidelines
Mitsubishi	Mitsubishi
**************	**************
amatuer	amatuer
smudges	smudges
(Phil	(Phil
Spot,	Spot,
comic	comic
Pathfinder	Pathfinder
kisan	murder
hydrogen,	hydrogen,
hydrogen.	hydrogen.
Hiroki	Hiroki
sunan&gt;	name &amp; gt;
App	App
Hard	Hard
Apr	Apr
Sport	Sport
shawarar	recommended
kamfanin,	company,
guntu.	chip.
Tsarki-masoya	Pure-lovers
saran	expected
tabbas,	probably,
PowerBook)?	PowerBook)?
&lt;1993Apr20.102756.1709@mala.bc.ca&gt;,	&amp; Lt; 1993Apr20.102756.1709@mala.bc.ca&amp;gt ;,
Turai	Europe
xa&#39;a	ethics
Stony	Stony
fara,	start,
floppy..BURN	floppy..BURN
shawara:	advice:
(watau,	(Ie,
Weiss	Weiss
shawara,	advice,
hallaka	destroyed
filin,	field,
developer	developer
hall@boi.hp.com	html>
91%	91%
pharvey@quack.kfu.com	html>
fi.	more.
fi,	more
shawara.	advice.
kona	burning
fastball	fastball
lippard@skyblu.ccit.arizona.edu	html>
(kusan)	(Almost)
Zbib)	Zbib)
2000,	2000
ƙiyayya	hatred
ƙayyadaddu	specifics
(GIF,	(GIF,
jawo	drawing
Brian	Brian
halitta.	created.
iyakar	border
sirri-kwamfuta	personal-computer
Hawk	Hawk
na&#39;ura	Device
lamba:	contact:
North	North
walƙiya	lightning
Amurka&quot;	US &amp; quot;
maki	points
mazan	older
abada,	ever,
fax	fax
Posting	Posting
lambar	number
luck	luck
far	therapy
mako	week
fan	fan
974	974
Summary	Summary
jihar	State
cututtuka.	diseases.
maka	you
(872	(872
duniya	World
Store	Store
PROOFOF::::	PROOFOF ::::
tashin	hostilities
banschbach	banschbach
Amerika	Amerika
johnson)	johnson)
atomic	atomic
thread,	thread,
mags	mags
halittar	Creation
Sun	They
Bayahude&quot;	Jew &amp; quot;
(842	(842
Sharuddan	Terms
mail	mail
140.	140.
Toronto,	Toronto,
lamba.	number.
main	main
Nissan	Nissan
Europa	Europa
pre-amp	pre-amp
billq@ms.uky.edu	html>
KASANCE	HAD
Uban.	Father.
akwatin	box
Haka	So
Shadow	Shadow
farauta	Hunting
Kanun	Headline
zaba	selected
jihohi	states
zabe	poll
664-6354	664-6354
zabi	selected
meteorology	Meteorology
ba&gt;	&amp; gt;
-This	-This
fuskantarwa	orientation
Fiction	Fiction
echoed	echoed
Kwakwalwan	Chips
iyaka.	limit.
#From	#From
tururi.	steam.
========	========
idanuna.	eyes.
ƙwarai	very
Brothers	Brothers
Intanit:	Internet:
frank@D012S658.uucp	frank@D012S658.uucp
core-zafin	core-temperature
DMA.	Right.
as-ne	as-is
Krsek)	Krsek)
Uranus	Uranus
Halo	Halo
Hutchison	Hutchison
yanar-gizo	Internet
kalma	Word
Bukata	Required
Venus	Venus
kuskure?	mistake?
1959,	1959,
9:31	9:31
Noring	Noring
ƙãre,	exhausted,
alhẽri).	good).
kuskure,	mistake,
kuskure.	mistake.
boye-boye&gt;	encryption &amp; gt;
kalla	least
O&#39;Dwyer)	O&#39;Dwyer)
&quot;nameplates.&quot;	&amp; Quot; nameplates. &amp; Quot;
Sauran	Other
=========================	=========================
kowa	everyone
1958,	1958,
lambobi	Contacts
Jihar	State
rarrabe,	distinctive,
kallo	looking
forming	forming
mace	woman
Hans	Hans
Boston?	Boston?
sukar	critics
gafarta	forgive
uu.net	html>
koyarwar&gt;	teaching &amp; gt;
Na&#39;am	Yes
_CRAZY_?	_CRAZY_?
Ban	I
dabaru,	techniques,
dabaru.	techniques.
Disclaimer!	Disclaimer!
&quot;babur,&quot;	&amp; Quot; motorcycle, &amp; quot;
&quot;Terminator&quot;,	&amp; Quot; terminator &amp; quot ;,
94550	94550
jingina	security
Frmwrks	Frmwrks
Glance&quot;	Glance &amp; quot;
Kida	Music
Babbar	Great
&quot;healers&quot;	&amp; Quot; healers &amp; quot;
rippled	rippled
haihuwarka	Circuits
diagnoses?	diagnoses?
Galileo	Galileo
(317)	(317)
Galilei	Galilei
koya	learn
[namiji]	[Male]
Disclaimer?	Disclaimer?
Knowles&quot;	Knowles &amp; quot;
David.	David.
airless,	airless,
koyi	learn
koyo	learning
Babban	Great
aberrant	aberrant
&#39;shaida&#39;.	&#39;Witness&#39;.
Statistics	Statistics
punjabi@leland.Stanford.EDU	html>
binciken:	study:
miliyan	million
haske,	light,
sharhi	comment
haske.	light.
jita-jita.	dishes.
binciken.	study.
09:02:48	09:02:48
Yamakawa,	Yamakawa,
alkawuran&gt;	Promises &amp; gt;
Gwada	Test
&lt;Wannan	&amp; Lt; This
sauƙi	easy
ashirin	twenty
Clayton	Clayton
filayen.	fields.
rediyoaktif	radioactive
SuperVGA	SuperVGA
hypersensitivity	hypersensitivity
Koyi.	Learn.
roth)	Roth)
Isra&#39;ila	Israel
somwhere,	somwhere
Abu	Abu
wuya,)	difficult)
Shi	It
Malaspina	Malaspina
Ibraniyawa],	Hebrews]
ziyara	visit
V-Mail:	V-Mail:
hasken	light
&quot;fararen	&amp; Quot; white
style,	style,
ya&gt;	&amp; gt;
dabara,	technique,
comparatively	comparatively
e_mail:	e_mail:
Craig	Craig
m-magana	m-word
gamuwa	Meeting
ambata.	mentioned.
Sir	Sir
marubucin	author
tidal	tidal
mulki,	power,
vms.	VMS.
--------------------	--------------------
mata	women
BIOS	BIOS
darn,	darn,
rayuwarsu,	lives
zama	be
bindiga-kulob	gun-club
Bitrus&gt;	Peter &amp; gt;
AMINCI	Reliability
THE	THE
(daga	(From
salla.	prayer.
(Chris	(Chris
memba	Member
faru,	events,
dski.	pitied.
kewayon	range
inji	machines
orange	orange
photocell	photocell
zafi	hot
mahallin	context
outposts.	outposts.
sabon,	new,
sci.med	sci.med
(Darryl	(Darryl
mulkin	rule
Kammalawa	Conclusion
vfintd.386	vfintd.386
Zaka	You
maza	men
Macworld	Macworld
Bitnet	Bitnet
faɗi.	wide.
Denning	Denning
overriding	overriding
&#39;::	::
maye	replacement
wispy	wispy
devide	devide
tsakaninka	between
share,	delete,
----------------------------------------------	----------------------------------------------
manyan,	large,
faru?	happened?
warware,	resolve,
kowace	each
misalai.	examples.
sys.ini	sys.ini
pro-gun	pro-gun
direbobi,	drivers,
dare.	night.
misalai,	examples,
cikasa	complete
wancan	that
kewaye.	around.
Sanin:	Know:
Richard	Richard
TTL	TTL
info	info
St.	St.
:-)	:-)
falakin	astronomers
kabarin	tomb
boasted	boasted
fari,	white
Muhimman	Important
janareto	generators
kalamai&gt;	statements &amp; gt;
en,	en,
mani	me
sharri	bad
bincike	research
mana	us
oak.oakland.edu:pub/msdos/windows3/winjp210.zip	html>
Air	Air
Shaidar	Witness
zai&gt;	&amp; gt;
bincika	search
kewayawa	navigation
sauransu)	etc.)
tashi.	rise.
bayãnin	distinguishing
agaji	aid
Cuesta	Cuesta
Activity	Activity
bayyanar,	appearance,
dogon	long
Gaskiya	Truth
C.)	C.)
Dodson)	Dodson)
binciko	exploring
amsar.	answer.
translation	translation
daren	night
jari	stock
star,	star,
star.	star.
aikatãwa.	do.
kome	nothing
fallacious	deceitful
koma	return
&#39;NF&#39;	&#39;NF&#39;
zasu	will
Koyar	Teaching
shawarwari.	recommendations.
zaunar	Lodge
farin	white
&lt;188@ky3b.UUCP&gt;	&amp; Lt; 188@ky3b.UUCP&amp;gt;
BMP	BMP
TSC	TSC
zato	fancy
Tidal	Tidal
son&gt;	love &amp; gt;
Giotto	Giotto
Heights	Heights
tsiro	grows
gidansa,	house
volcanoes	volcanoes
freeware.	freeware.
(akwai	(There
bangare	part
rayuwata,	life,
amfani.	use.
Barton)	Barton)
farka	wake
zane	design
daraja	notch
dabaran	wheel
amfani,	use,
zana	draw
masa	his
tsira	survived
All	All
masu	the
zamu	we
parody	parody
farko	First
maso	Southeast
Ami	Ami
Formats,	Formats,
Formats.	Formats.
Genie:	Genie:
high-gudun	high-speed
kowane	each
rijista	Register
saboda	because
rafke	Shattered
E-mail	E-mail
Davis)	Davis)
wanzuwa?	lasting?
Crash	Crash
Nice	Nice
ka&#39;idar	theory
shipping).	shipping).
zargin	charges
C2.	C2.
Sol	Sol
Ana	Are
transistor?	transistor?
kofa	door
1-301-340-4543	1-301-340-4543
gyara	repair
amfanin	benefits
kewayen	around
().	().
resistive	resistive
likita&gt;&gt;	medical &amp; gt; &amp; gt;
lokaci	time
Alane	Alane
inda	where
(10-105	(10-105
fili&gt;	compound &amp; gt;
cikas,	obstacles,
dukkan	all
&gt;&gt;,	&amp; Gt; &amp; gt ;,
Road	Road
kogi	river
Delaware	Delaware
samaniya	heavenly
&#39;ya&#39;yan	Children
Finland	Finland
email:	email:
755-8742	755-8742
tashar	station
email.	email.
&gt;&gt;?	&amp; Gt; &amp; gt ;?
Galant,	Galant,
1970s.	1970s.
da-tsare	and programs
Layer	Layer
&#39;girgije	&#39;Clouds
cover,	cover,
wanzuwar	Existence
jmilhoan@magnus.acs.ohio-state.edu	html>
Tsarki,	Pure,
Madogararsa	Source
bijiro	incidences
gt7469a@prism.gatech.edu	html>
mutu.	died.
1312	1312
fararen	white
mutu,	die,
kimiyya	Science
altitudes.	altitudes.
mutãnensa	family
Attaura&quot;	Law &amp; quot;
thyroid	thyroid
1949.	1949.
Buy	Buy
(zuwa	(
high&gt;	high &amp; gt;
Juliet.	Juliet.
fito	out
kyau&#39;	good &#39;
Replay	Replay
(6)	(6)
Jami&#39;ar	University
shakka,	of course,
fita	out
(59	(59
arcs	arcs
1948:	1948:
Adaptec	Adaptec
musamman,	especially,
shirts,	shirts,
8.6	8.6
THERMOCOUPLE	Thermocouple
gif	gif
1948,	1948,
shekara-dogon	year-long
arab	arab
(5)	(5)
jiya,	yesterday,
gamuwa,	Meeting,
Umbriel,	Umbriel
mutum	man
jarrabawa	Examination
tasiri	effective
Amirka,	American
.com&gt;	Lions &amp; gt;
Asteroids	Asteroids
Page)	Page)
Mafarki.	Dream.
(sunã	(
Barton	Barton
nahiyar.	continent.
gaishe	greeted
(4)	(4)
Landmann&gt;	Landmann &amp; gt;
tangents.	tangents.
yanzu-yanzu	Momentary
Kwanaki	Days
hydrogen	hydrogen
mãkirci	plots
Ubangijinku,	Lord
Harman	Harman
(32	(32
manya-manyan	very large
abar	closed
(3)	(3)
Ru?	Ru?
eccentricity	eccentricity
variaty	variaty
[26]	[26]
theories	theories
karshen,	end,
&quot;Pink	&amp; Quot; Pink
(27	(27
matsanancin	outer
ƙarfe	metal
ƙarfi	strength
misali.	example.
lokatai,	Sometimes,
kiyasin.	estimates.
misali,	for example,
(2)	(2)
maida	recovery
binne,	buried,
Miranda,	Miranda,
======================	======================
Majagaba	Pioneer
Miranda.	Miranda.
Celsius	Celsius
82:	82:
(1)	(1)
windows,	windows,
dokokin,&gt;	laws, &amp; gt;
windows.	windows.
(6,118	(6,118
jps&gt;	jps &amp; gt;
turbaya	dust
============================================	============================================
(745	(745
[23]	[23]
cinikayya,	trade,
Dancing	Dancing
LaStrange)	LaStrange)
karkata	crookedness
daki-daki.	detail.
goaltender	goaltender
hasashe	imagery
fix.	fix.
[24]	[24]
misalin	example
lantarki	electronic
Kiristoci	Christians
dattawan	Elders
Ƙasã,	Earth
Tsarki.	Pure.
zauna,	stay,
[25]	[25]
zauna.	sat.
wanda,	which,
kosad	satisfies
Iraki	Iraq
jawabai	speakers
ka&#39;idodin	principles
wasika	letter
ƙuduri?	resolution?
&quot;Pavel	&amp; Quot; Pavel
X11R4.	X11R4.
godiya.	thanks.
I3150101@dbstu1.rz.tu-bs.de	html>
jh6r@andrew.cmu.edu	html>
bambanta	vary
biyar	five
IBM?	IBM?
James,	James,
godiya,	thanks,
nema	Quest
dalibai,	students,
gargaɗi	warning
Sai	And
godiya!	thanks!
Sam	Sam
nemi	sought
kwamfutarka	computer
ragowar	imprints
Franjione)	Franjione)
Cramer)	Cramer)
(?)	(?)
Triantafyllopoulos	Triantafyllopoulos
kai&quot;	&amp; quot;
nauyi.	weight.
nauyi,	weight,
plutoneon,	plutoneon
gas	gas
kammala	concluded
gay	gay
IBM.	IBM.
Yahudawa&gt;	Jews &amp; gt;
&lt;id.XNFZ.VJ8@nmti.com&gt;	&amp; Lt; id.XNFZ.VJ8@nmti.com&amp;gt;
al&#39;umma&quot;,	community &amp; quot ;,
gan	see
fiye	more
hander	hander
kyau.	good.
ramummuka,	slots,
=====================================	=====================================
9,846	9.846
posted	posted
kyau,	good
hobbiest	hobbiest
nickel.	nickel.
lalatar	incest
(Richard	(Richard
c23st@kocrsv01.delcoelect.com	html>
acetylene,	acetylene,
sauran&gt;	other &amp; gt;
6x9	6x9
wasannin,	Games,
karɓar)	receiver)
tushe,	base,
Sau	Times
kaɗawa	wave
ware.)	exceptions.)
sabo-sabo	newer
San	San
(Scott	(Scott
albarkatun,	resources,
hadiri	storm
Q4ayata,	Q4
liyãfa.	entertainment.
jari,	investment,
Canadiens	Canadiens
ɗora	attaches
weather,	weather,
biyan	subscription
aure,	marriage,
weather.	weather.
kyaun	beautiful
wa.	.
batirin	battery
Khan	Khan
Kinsey	Kinsey
zirga-zirga?	traffic?
&quot;kiwon	&amp; Quot; health
abin	what
riqo	The guardian
xterm	xterm
Mafarki&quot;	Dream &amp; quot;
753-3245,	753-3245,
duba,	view,
shorelines,	shorelines,
lalata.	damage.
&quot;sai	&amp; Quot;
Rosa	Rosa
Rockville,	Rockville,
ganina	I suppose
&#39;zobba	&#39;Rings
Research	Research
kyawawan	pretty
tsallake.	omitted.
(95	(95
(93	(93
tushen	source
ammonia	ammonia
tsattsarkar	exclusive
etiologic	etiologic
shawarta	advise
biya.	paid.
fili,	Apparently,
cj195@cleveland.Freenet.Edu	html>
karshe	final
stylizied	stylizied
Agency	Agency
Ancient	Ancient
uunet.	uunet.
(88	(88
ESPN	ESPN
Car	Car
makamashi	Energy
billa?	bounce?
uunet!	uunet!
Bashing?	Bashing?
jawabin	speech
tsayar).	stop).
Inshora	Insurance
1,200	1,200
nuna,	show,
nuna.	show.
untreatable	untreatable
filin	field
comic,	comic,
misalai	examples
ed&quot;,	ed &amp; quot ;,
korenek@nmti.com	html>
SHI	HE
Hadi	Accessories
Shin,	Whether
lura	Note
gaɓãɓuwa	particles
windowed	windowed
halayyar	characteristic
hagu	left
takan	used
Harumph.	Harumph.
&quot;bari	&amp; Quot; let
constraints	constraints
fallasa	exposed
sosai),	very),
daskararre	frozen
shi).	it).
Nelson)	Nelson)
kiyaye.	maintained.
damar.	access.
A&gt;	A &amp; gt;
Zbib	Zbib
raga,	goals,
whirling	whirling
VanHeyningen	VanHeyningen
baƙo	guest
bangaskiyarku	faith
baƙi	black
baseball.	baseball.
(Ba	(No
kyale	allowing
fus	fuse
waɗanda	those
SKS	SKS
godiya	thanks
duhu	dark
muted	muted
Ikkilisiyar	Church
leonard@aix3090b.uky.edu	html>
cuce,	hurt,
riga	already
filayen	fields
paperwork	paperwork
(matata).	(My wife).
falalen	rock
Kwayoyin.	Bacteria.
00ecgillespi@leo.bsuvc.bsu.edu&gt;	00ecgillespi@leo.bsuvc.bsu.edu&amp;gt;
sabuwar	new
abu,	thing,
artistically	artistically
hada	including
hade	combination
burodi	bread
tare&gt;	&amp; gt;
Citizen	Citizen
duka	all
415-	415-
banza	worthless
agressive.	agressive.
parented	parented
gidanmu	Our family
&quot;jargonese&quot;	&amp; Quot; jargonese &amp; quot;
Kirk.	Kirk.
yarjejeniyar	Agreement
barbashi,	particles,
&lt;jh6r+@andrew.cmu.edu&gt;	&amp; Lt; jh6r+@andrew.cmu.edu&amp;gt;
gamsarwa	satisfactory
size	size
hitter.	hitter.
duk?	all?
abun	content
Robert	Robert
nuni,	display,
[wata	[
hitter)	hitter)
tayin	offer
hitter,	hitter,
lõkacin	When
iya&gt;	&amp; gt;
SER	SER
SET	SET
jituwa&quot;)	compatible &amp; quot;)
haɗa	including
rawar	role
ĩmãni	believe
Re:	Re:
take,	title
kunya	shame
Red	Red
rayuwarsu	lives
dukiya	property
saɓani	outs
Afrilu	April
riko	Acting
posts,	posts
Dokokin	Laws
Cikakken	Full
dokoki	rules
karkace	spiral
megatest.com&gt;,	megatest.com &amp; gt ;,
miliyoyin).	millions).
rike	hold
lurk	lurk
nesa	distance
guntu-sa	chip-set
&quot;Jonathan	&amp; Quot; Jonathan
html>	html&gt;
flash	flash
SPL	SPL
via	via
ƙirƙirar	create
for	for
&quot;Home	&amp; Quot; Home
biyu)	two)
Kamar	As
biyu.	two.
biyu,	two,
foo	Foo
dabi&#39;u	values
da).	).
kwakwalwa	Memory
biyu:	two:
COD	COD
---------------------	---------------------
York	York
Shida	Six
biyu?	two?
tilted	tilted
POBox	POBox
(tvtwm).	(Tvtwm).
fil.	pin.
tayin,	offer,
bambanci	difference
Ron	Ron
DAGA:	FROM:
tushe	base
high-matsa	high-pressure
Aeronautics	Aeronautics
amfana	benefit
(Mike	(Mike
aikata	do
bugun	speed
yiwu,	Perhaps,
(martin	(Martin
HITTER	HITTER
Crawford	Crawford
manzanni.	messengers.
manzanni,	messengers,
dual	Dual
(Ka	(
yarmulke	yarmulke
sallama,	Submit
PowerBook	PowerBook
bindiga&gt;	Rifle &amp; gt;
Lyme,	Lyme,
jiyya	Treatment
(Ko	(Or
800mA.	800m.
(Family	(Family
Grounding	Grounding
sarkin.	king.
phrases	phrases
ƙarin	more
Spot	Spot
amfani	use
yawa.	lot.
&quot;Personal	&amp; Quot; Personal
dubu	thousand
(musamman	(Especially
na&#39;urar	device
Jupiter	Jupiter
riba	profit
yawa)	many)
(J.	(J.
274-5357	274-5357
tabbata	sure
&lt;1993Apr21.234159.1206@ualr.edu&gt;	&amp; Lt; 1993Apr21.234159.1206@ualr.edu&amp;gt;
gudun	speed
ƙarni	century
tsiwirwirinsu	Gained
&quot;Drakula&quot;	&amp; Quot; Drakula &amp; quot;
flank	flank
motoci.	cars.
...]]	...]]
asara.	loss.
gwamnoni.	regulators.
alhãli	and
(Edward	(Edward
yawa?	Many?
duba	view
gaba&gt;	next &amp; gt;
dubi	Look
dokokin,	laws,
yawan	population
fil	pin
tauraro	star
cikakken	full
manyan	great
Manzanni	Messengers
Matsuo,	Matsuo,
Baftisma&gt;	Baptism &amp; gt;
makirci	scheme
zažužžukan.	options.
fis	fuse
takwarorinsu	counterparts
abokan.	partners.
taurari	stars
fix	fix
shakatawa	park
abokan,	partners,
gudu.	run.
gudu,	run,
da&quot;	and &amp; quot;
Columbia&gt;	Columbia &amp; gt;
fili	Apparently
karshe&gt;	Finally &amp; gt;
Bos	Bos
90%	90%
video,	video
Jupiter,	Jupiter,
aikawa	Exporting
cewa:&gt;&gt;	: &amp; gt; &amp; gt;
BUFFERS	BUFFERS
aiwatarwa	Implementation
90,	90,
Jupiter.	Jupiter.
Advancements	Advancements
Jupiter;	Jupiter;
tsarawa	Planners
Herschel.	Herschel.
dabam-dabam	different
Inc.,	Inc.,
Vehical	Vehical
ɓawon	shell
sharma@tiger.vill.edu	html>
line?	line?
su&gt;	&amp; gt;
horo	training
yãƙi	fight
rauni	weak
wannan:	this:
takwarorina).	peers).
27,6	27.6
asymmetric	asymmetric
faulting	faulting
kaya	inventory
boye-boye&quot;	encryption &amp; quot;
wannan?	this?
auku	pass
bisa	above
wadda,	which,
video	video
(&lt;o&gt;	(&amp; Lt; o &amp; gt;
kayyade	fixing
animation	animation
wannan.	this.
^^^^^^^^^^^^^^^^^^^^^^^^^^	^^^^^^^^^^^^^^^^^^^^^^^^^^
kawayeniya	illusions
wannan,	this,
Maras	Low
sauransu&gt;&gt;	etc. &amp; gt; &amp; gt;
xelion!	xelion!
rigima	Controversial
Neptunian	Neptunian
&quot;akwai	&amp; Quot; there
73,	73,
Friedman	Friedman
Scarring	Scarring
KRISTI:	CHRIST:
baicin	instead
bayyanar	appearance
&lt;pgf.735012282@srl03.cacs.usl.edu&gt;,	&amp; Lt; pgf.735012282@srl03.cacs.usl.edu&amp;gt ;,
da?	?
Callsign:	Callsign:
hoto	picture
Station	Station
sunayen	names
27.2	27.2
tabbatar&gt;	proven &amp; gt;
(Detroit,	(Detroit,
tekun	Ocean
&quot;smog&quot;	&amp; Quot; smog &amp; quot;
Far!	Therapy!
da,	and,
DISKs	Disks
auna	measured
da)	)
Lampoon_	Lampoon_
Asteroid	Asteroid
1,500	1,500
Selannes	Selannes
LURA.	Recognition.
kawo	bring
da!	!
tuntubi	contact
Yunƙurin	Attempt
N-8-1.	N-8-1.
tuntube	contact
&quot;wanda	&amp; Quot;
electronically	electronically
line.	line.
da.	.
410-34-1	410-34-1
fayiloli	files
Software	Software
Yammacin	West
sihiri	magic
alkawuran	promises
700	700
alloli.	gods.
703	703
kwata&gt;	quarter &amp; gt;
G20,	G20,
Shekaru	Years
dutse-pocked	stone-pocked
dai	However
Microsoft	Microsoft
Maplewood	Maplewood
code	code
dc)	dc)
G20.	G20.
DX)	DX)
recharge	recharge
cigaba	carry on
wannan&gt;	&amp; gt;
dan	son
shakka&gt;	course &amp; gt;
Fax:	Fax:
Lee)	Lee)
kare	protect
fasara:	paraphrase:
speculating	speculating
kari	Extensions
Hiroshi	Hiroshi
sci.med,	sci.med
wayar:	phone:
Nanaimo	Nanaimo
&lt;o&gt;)	&amp; Lt; o &amp; gt;)
kara	further
Wadannan	These
Almasihu,	Christ,
halarci	Attend
Almasihu.	Christ.
7.5	7.5
karo	time
Kennedy	Kennedy
indistinct	indistinct
cl056@cleveland.Freenet.Edu	html>
(Spiros	(Spiros
&lt;sarari&gt;	&amp; Lt; space &amp; gt;
kasa	ground
alkyabbar	cloak
&lt;1APR199313404295@skyblu.ccit.arizona.edu	html>
200uf	200uf
alfijir,	dawn,
Turawa,	Pushing,
Brenda	Brenda
(61302	(61302
Ave.	Ave.
redrawn	redrawn
tsare-tsaren	plans
Henry	Henry
Whitten	Whitten
ƙarfi.	strong.
zbib@bnr.ca	html>
millitary	millitary
betel@camelot.bradley.edu	html>
&quot;Wasi-wasi	&amp; Quot; Skepticism
ra&#39;ayi	views
Shipping	Shipping
&lt;,	&amp; Lt ;,
iyakacin	desperately
Lines	Lines
(azurta	(Provided
McCord,	McCord,
zuwa	to
saman&quot;	top &amp; quot;
Turawa:	Pressure:
ta?]&quot;]	? &amp; quot;
jesus	jesus
kungiyoyin,	groups,
Amurka	US
24:46,	24:46,
auto	auto
DOSKEY	DOSKEY
Yiwuwar	Possibility
al&#39;amura	events
Pentium	Pentium
_outside_	_outside_
Medicare	Medicare
(1,430	(1,430
rauser@fraser.sfu.ca	html>
hotuna	pictures
empiric	empiric
League,	League,
&lt;na	&amp; Lt;
League.	League.
Colorado,	Colorado,
ƙarfin	power
akayi	involved
HMMMMMMMMMMMMMMMMMMMMMMMMMMMMMMMMMMMMMMMMMMMMMMMMMMMMMMMMMMM	HMMMMMMMMMMMMMMMMMMMMMMMMMMMMMMMMMMMMMMMMMMMMMMMMMMMMMMMMMMM
al&#39;amurran.	issues.
hakkokin	rights
biya	payments
bitar.	review.
(severy)	(Severy)
Voyagers	Voyagers
(kasance	(
tambaya,)	question)
articles	articles
Maibaftisma	Baptist
Alhãli	And
links	links
Farashin	Price
zone,	zone,
Oberon	Oberon
brenner)	brenner)
shi.....	it .....
.....	.....
Van	Van
biyu	two
partially	partially
&lt;2958804@QUCDN.QueensU.CA&gt;	&amp; Lt; 2958804@QUCDN.QueensU.CA&amp;gt;
sunlit	sunlit
Wai-Ming	Wai-Ming
Majalisun	Legislature
gida,	home
related	related
gida.	home.
1979,	1979,
&#39;makamai&#39;	&#39;Arms&#39;
bayyana,	stated,
1979.	1979.
Taimakon:	Help:
bayyana.	clear.
miƙa	offered
mabukaci	consumer
firinta	printer
(Yuro-Bashing?)	(Euro-bashing?)
frameworks	Frameworks
gt7469a@prism.gatech.EDU	html>
Frank	Frank
canjawa	switch
TASHIN	MUSCLE
Nice.	Nice.
622121	622121
Digi-Key	DiGi-Key
bindiga-lasisi	gun-license
magani,&gt;	treatment &amp; gt;
circling	circling
1978,	1978
&quot;haƙiƙa	&amp; Quot; objective
placebo	placebo
1978.	1978.
Kreiling)	Kreiling)
Dan	Son
kasa&gt;	less &amp; gt;
Regio	Region
&quot;arab?&quot;	&amp; Quot; arab? &amp; Quot;
fadada	expansion
gidan	house
low-yawa	low-density
zunubanku.	sins.
Indonesia.	Indonesia.
zunubanku,	sins,
orbiters	orbiters
girmama	honored
Hiram	Hiram
goolsbey@cs.utexas.edu	html>
&#39;yanayi	&#39;Conditions
dozin	dozen
hujjoji	facts
rikodin	record
ƙarƙashinsu	flow
unsa	involve
&quot;Kai	&amp; Quot; You
Faehl	Faehl
1976,	1976
Friedman:	Friedman:
Fasaha	Technology
aure	marriage
Karshe	Final
faifai,	disk,
nauyi	weight
bara,	Last year,
VLB	VLB
32-bit	32-bit
fadin	across
1974.	1974.
1974,	1974,
shafewa	Deletion
kankara.	ice.
king@reasoning.com	html>
kankara,	ice,
486DX-33	486DX-33
4.0-4.3	4.0-4.3
Martian	Martian
auna.	measured.
Mars?	Mars?
undocumented	undocumented
Mars,	Mars,
Steve	Steve
Mars.	Mars.
VLX	VLX
karfi,	strong,
Mataki	Action
1975,	1975
hukumomin	agencies
kai?	?
R&gt;	R &amp; gt;
DLC	DLC
manzo,	messenger,
blaisec@sr.hp.com	html>
Uku	Three
uwa	mother
rajistan	check
Sarki)	King)
bangaren	component
mahaliccin	creator
Um,	Um,
fadi,	wide,
yankuna	regions
Huygens,	Huygens,
1972,	1972,
kubuta	escape
Mocker)	Mocker)
DMA	Right
1970s	1970s
&quot;taimaka	&amp; Quot; help
kai,	,
Samun	Access
kai.	.
1973,	1973,
daya&gt;	&amp; gt;
cewa&gt;	&amp; gt;
mallaki	possession
(Hal	(Hal
Mitsubushi	Mitsubushi
zane.	design.
Montreal,	Montreal,
coma	coma
mallaka	own
zance	reference
----	----
kafa	set
(Henry	(Henry
up).	up).
bangare.	part.
belts,	belts,
boye-boye&quot;&gt;	encryption &amp; quot; &amp; gt;
Mexico,	Mexico,
&#39;to	&#39;
______________________________________________	______________________________________________
(amma	(But
barci	sleep
&lt;May.12.04.27.47.1993.9935@athos.rutgers.edu&gt;	&amp; Lt; May.12.04.27.47.1993.9935@athos.rutgers.edu&amp;gt;
zubi	molten
ron.roth@rose.com	html>
Formats	Formats
haɗin	Cooperation
amsar	answer
dalĩli	authority
unethical	unethical
ƙarshe.	Finally.
7.3.	7.3.
amsa:	answer:
&quot;nameplate&quot;	&amp; Quot; nameplate &amp; quot;
ƙarshe,	Finally,
tabarau	specs
1971,	1971,
modified	modified
kadi	spinning
guda.	single.
&#39;93).	&#39;93).
guda,	single
Manufar	Purpose
kada	do
husũma	dispute
sabani	outs
alhẽri	good
kwakwalwan	chips
(317)743-1394	(317)743-1394
(kuskure),	(Error),
yadda	how
kirki&gt;	integrity &amp; gt;
Mike	Mike
(2,544	(2,544
ƙarfi&gt;	strong &amp; gt;
&#39;ve	&#39;Ve
Multi-kabilanci	Multi-ethnic
140-165	140-165
sun4nl!	sun4nl!
(Claudio	(Claudio
saurari	listen
lokuta	cases
Gaisuwa,	Greetings,
karfin	power
Computers	Computers
ƙarshen	end
batman@cisco.com	html>
zuba	pour
cometa,	Comer,
(-290	(-290
drive,	drive,
Duniya-sized	Earth-sized
kafofin	sources
(-298	(-298
core	core
DATE:	DATE:
Sarkin	King
ce:	said:
kashe,	off,
[misali	[Example
Maris	March
aiwatar	implementation
kyalkyali	glitter
fitar,	out,
Engineering	Engineering
ce,	said,
ce.	said.
Diffie-Hellman	Diffie-Hellman
tiff	tiff
matakin	level
8.1	8.1
hours	hours
up.	up.
duniya&gt;	World &amp; gt;
up,	up
bambance-bambance	differences
Rosenau)	Rosenau)
daidaito.	accuracy.
jama&#39;a-key	public-key
&quot;Kun	&amp; Quot; You
fegi,	peg,
uku	three
babur.	motorcycle.
_____________	_____________
Club	Club
ra&#39;ayoyi	views
ɓangare	part
gode	Thanks
Allah.)	God.)
shawara	advice
boye-boye,	encryption,
kayan.	materials.
Mouting	Mouting
boye-boye)	encryption)
(5,000	(5,000
likita	doctor
arewacin	North
alane@microsoft.com	html>
hit&gt;	hit &amp; gt;
afronted	afronted
Rhode	Rhode
Theodore	Theodore
ciyayi	vegetation
kana	you
Japan	Japan
kome.	nothing.
Church.	Church.
gauraya	blend
asteroids	asteroids
mamba	Member
kamu	addicted
landiroba	SUV
radar	radar
DEVICEHIGH	DEVICEHIGH
babura	motorcycles
Springs,	Springs,
sauran.	other.
kama	catch
fetur	oil
hidima	service
&#39;le	Le
kwarewa.	experience.
impedance.	impedance.
Clr	CLR
kan?	on?
kwarewa,	experience,
gibba,	gaps,
uje	bruise
com1	com1
sanyi,	cool,
Power	Power
Stein	Stein
(kamar	(As
format	format
&lt;1993Apr21.032427.22464@leland.Stanford.EDU&gt;,	&amp; Lt; 1993Apr21.032427.22464@leland.Stanford.EDU&amp;gt ;,
boye-boye.	encryption.
matsakanci	mediator
(-235	(-235
Gretzky	Gretzky
komai	nothing
559.	559.
powered	powered
zanen	designer
Ingila	England
ƙanana	small
DOS	DOS
(Leonard	(Leonard
&lt;1qvb5aINNmoi@darkstar.UCSC.EDU&gt;,	&amp; Lt; 1qvb5aINNmoi@darkstar.UCSC.EDU&amp;gt ;,
Attaura,&gt;	Law &amp; gt;
akafi	clicks
kasida,	article,
kula,	care,
kula.	care.
fama&gt;	Coping &amp; gt;
(har	(
kusantar,	draw,
Magangara	Lowest
microsoft	microsoft
veneer	veneer
ɗã&#39;a	Path
kaka	autumn
Deptt.	Deptt.
Canucks)	Canucks)
cin	eating
sanyin	comfort
definition	definition
general.	general.
zane],	design,
(Michael	(Michael
Sanyi.	Cool.
Alkawari	Promise
ko&#39;ina,	everywhere,
adam	human
zazzabi	fever
chances	chances
(Spain)	(Spain)
[ped]	[Ped]
Safety&quot;	Safety &amp; quot;
dadi	comfortable
Gaza	Gaza
nufi	means
ragowa	bits
utzoo!	utzoo!
adawa	opposition
nufa	address
Magnetic	Magnetic
:-)&gt;&gt;	: -) &amp; Gt; &amp; gt;
images.	images.
FAQ	FAQ
jam&#39;iyyun	parties
sguerke@brahms.udel.edu	html>
koutd@hiramb.hiram.edu	html>
lu&#39;ulu&#39;u	Pearl
katin,	card,
katin.	card.
Jahannama&gt;	Hell &amp; gt;
Flyby	Flyby
makami	weapon
batu-na-view.	point-of-view.
V9R	V9R
mutumin	man
mangolawa	Mongols
&quot;karshe&gt;	&amp; Quot; last &amp; gt;
mažalli&quot;.	key &amp; quot ;.
Stalin	Stalin
kishili	homosexual
sarrafa	manager
maganganun	statements
league!	league!
matakai	steps
league.	league.
layi	Online
23-25).	23-25).
&quot;kishili	&amp; Quot; homosexual
dace	suitable
korenek)	korenek)
committ	committ
tsaye.	standing.
makircinsu	Schemes
kwanaki	days
kunsasshen	packaged
kwafin	copy
alama&gt;	feature &amp; gt;
Cleopatra.	Cleopatra.
daki-daki	detail
gawarwakin,	bodies,
miscommunication.	miscommunication.
asali,&gt;	original &amp; gt;
wanda	which
low-matsa	low-pressure
halaka&quot;	destroyed &amp; quot;
dade	long
lmouse	lmouse
dada	increase
&quot;kulle	&amp; Quot; lock
(misali,	(For example,
Kusan	Almost
(misali)	(Eg)
birnin	city
mataki.	stage.
Newtonian	Newtonian
99.9	99.9
(29.95)	(29.95)
tsayar	Establish
fahimci	understood
kansa,	himself,
maraba&gt;	welcome &amp; gt;
Mariners.	Mariners.
kunshi&gt;	contains &amp; gt;
nelson_p@apollo.hp.com	html>
kamara	Camera
(932	(932
Dorothy	Dorothy
bututu.	pipe.
.indiana.edu	.indiana.edu
Resources	Resources
6-7	6-7
dansa	son
lafiya-tune	fine-tune
tsaya,	stand,
&quot;Konstantinov&quot;	&amp; Quot; Konstantinov &amp; quot;
lashe	won
6.4	6.4
uba	Father
maki,	points,
Radio	Radio
wani,	a,
tsakiya	Central
SAMA	RETURN
bantara	chunk
hockey,	hockey,
direbobi-lasisi	drivers-license
na&#39;urar,	device,
adulation&gt;	adulation &amp; gt;
THEWITNESS	THEWITNESS
kwarewa	experience
gatari	ax
Korantiyawa	Corinthians
Donut&quot;	Donut &amp; quot;
&quot;muhimmanci&quot;	&amp; Quot; significant &amp; quot;
kira.	call.
karɓa,	recipient,
Kayayyakin	Products
kashi.	percent.
kamata	should
POSTITION	POSTITION
sau&gt;	times &amp; gt;
rashin	lack
cuta.&quot;	disease. &amp; quot;
waiiiiiit,	waiiiiiit
Saboda	Because
S5R3.2).	S5R3.2).
&#39;m&#39;:	&#39;M&#39;:
wanin	than
Dole	Must
Charon,	Charon,
hakika,	actually,
daidaita,	adjust,
tsakãtsaki	median
Center	Center
taga).	window).
isasshen	enough
ado.	decoration.
4th	4th
ga&#39;	&#39;
nuni	display
Shostack	Shostack
ashin:	heading:
dubu&gt;	thousand &amp; gt;
frigid	frigid
System,&quot;	System, &amp; quot;
Dwarf&quot;	Dwarf &amp; quot;
Hughes	Hughes
sauya.	change.
1968.	1968.
escalated	escalated
beeps.	beeps.
294-8153	294-8153
kulle	locked
kulla	deals
Montes,	Montes,
hardware	hardware
Jamus,	Germany,
redraws.	redraws.
da&#39;irar	circle
(900	(900
ethically	ethically
bayanai	information
flights	flights
Sarrafa	Manager
openlook.	openlook.
adalci	justice
Dodson	Dodson
nuna	shows
VDC	VDC
sanyi	cool
kaifi	sharp
Windows.	Windows.
5X9	5X9
dutsen.	rock.
dutsen,	rock,
shigarwa	installation
Attaura&gt;	Law &amp; gt;
hadisai.	traditions.
(Yahaya	(John
fansa	compensation
Landers	Landers
Yohanna?	John?
Gary	Gary
sanya	made
Georgia	Georgia
hotan	Hotan
vax839@tid.es	html>
sanye	wearing
Gasa	Bake
adam.	human.
gleaned	gleaned
mako,	week,
adam,	human,
Gano	Identified
MLINDROOS@FINABO.ABO.FI	html>
Gans	Crazy
VGA	VGA
bayani:	information:
Fitowa	Exodus
640	640
bayani?	information?
Dubban	Thousands
tasirin	labels
gudana.	ongoing.
kulob	club
Bagalile	Galilean
Ee.	Yes.
armada	armada
1965,	1965,
wanna	wanna
(10,000	(10,000
bayani.	solution.
(JT)	(JT)
cututtuka	diseases
kotun	court
ãyõyin	Signs
Game	About
(kuma	(same to you
flag	flag
tun	since
Mercury,	Mercury,
Gama	For
haɓaka	fuels
Mercury.	Mercury.
1964,	1964,
Diplomasiyyar	Diplomacy
alfahari	proud
Marty	Marty
(Ina	(I
Atkinson	Atkinson
(JPL	(JPL
makale	stuck
bisa).	above).
gudanar	held
486DLC-33	486DLC-33
fanni	Specialty
layout	layout
1967,	1967,
Brian,	Brian,
tauraron	star
bangaskiya&gt;	faith &amp; gt;
VHS	VHS
Kwatancen	Comparisons
cypher	cypher
haifi	born
Houston	Houston
counterclockwise	counterclockwise
lawa	lava
650	650
APPRECITATED.	APPRECITATED.
FBI	FBI
quibble-	quibble-
Virago	Virago
Carlos	Carlos
mutuwa	death
don	to
sannu	hi
izgili	mock
km@ky3b.pgh.pa.us	html>
ions	ions
Sanjeev	Sanjeev
dos	dos
Tare	With
zamba	fraud
baseball	baseball
(wanin	(Other than
(-366	(-366
dpi	DPI
Buntus	Pontius
Nunnally@acs.Harding.edu	html>
zaman	session
(Matt.	(Matt.
American	American
windows	windows
kirki	good
canyons,	canyons,
fitarwa	output
Canada	Canada
sha&#39;awar	interested
mutum,	man
Bading)	Baerecke)
mutum.	man.
Siemon)	Siemon)
hankali	focus
unalterably	unalterably
kaina	myself
Jose,	Jose,
Lura	Note
shida	six
data	data
400dpi)	400dpi)
1962,	1962
hazo.	fog.
zama?	be?
sigina	Signal
The	The
Logitech	Logitech
fasali,	features,
northeners	northeners
cutarwa	harmful
&#39;yan	Few
fasali.	features.
AutoCAD	AutoCAD
Thu	Thu
sharuddan	terms
League	League
zama,	,
adadi	figure
sha&#39;awa)	interest)
(Edmonton,	(Edmonton,
auroral	auroral
(Dave	(Dave
School,	School
auroras	auroras
&#39;jinkirin	The slow
Brenn)	Granny)
zama)	)
Tim	Tim
Brenn,	Granny,
(1,500	(1,500
256k	256k
optilink	optilink
newsdesk@jplpost.jpl.nasa.gov	html>
Biyu	Two
musayar,	exchange,
fahimta	understand
almarar	fiction
&lt;1993Apr7.221357.12533@lamont.ldgo.columbia.edu&gt;	&amp; Lt; 1993Apr7.221357.12533@lamont.ldgo.columbia.edu&amp;gt;
enteritis	enteritis
Fade	Fade
hoax	hoax
shekaru&gt;	age &amp; gt;
ƙarfi,	strong,
dari	av
fallout	fallout
dare	night
to,	then
Krista&gt;	Christian &amp; gt;
stephen@orchid.UCSC.EDU	html>
takaice,	Briefly,
sanin	knowing
duk	all
takaici	Unfortunately
takaice	Briefly
tajirai	proprietary
&#39;yar&#39;uwa	Sister
(wanda	(
&gt;&gt;&gt;	&amp; Gt; &amp; gt; &amp; gt;
wallafe	Publications
-----------------	-----------------
10:34	10:34
elliptical	elliptical
lilo.	swing.
communicants.	communicants.
Cassini	Cassini
taurari.	stars.
sunanka,	your name,
Disamba	December
shigo	imports
ƙarfe,	steel,
&#39;	&#39;
Idan	If
taurari,	stars
VL-bus	VL-bus
(Version	(Version
&gt;	&amp; Gt;
shige	passed
months	months
shiga	enter
schauf@iastate.edu	html>
To,	Then
serial	serial
zama&gt;	&amp; gt;
kiran	call
shine	is
Duk	All
daukawa	carries
damu	worry
Wadanda	Those
Almasihu,&quot;	Christ, &amp; quot;
Campus)	Campus)
&gt;&gt;&gt;&gt;	&amp; Gt; &amp; gt; &amp; gt; &amp; gt;
Too	Too
gazed	gazed
dame	bothered
Venusian	Venusian
dama	right
Tom	Tom
karshe.	Finally.
karshe)	Finally)
divider	divider
100-kilomita	100-km
Lei)	Lei)
Weapon:	Weapon:
kasida	article
bautãwa	god
wa&#39;azi,	instruction,
100,	100,
1000	1000
gwargwadon	much
Personaly,	Personaly
der	der
(tushen	(Source
des	des
Alpha	Alpha
kuma,	same to you,
islamic	islamic
&quot;kimiyya&quot;	&amp; Quot; Science &amp; quot;
kaiwa	leads
&lt;31MAR199321091163@juliet.caltech.edu	html>
kuma:	same to you:
bike	bike
Yemen	Yemen
larry	larry
biki	holiday
Kwanan	Recently
&lt;p00261@psilink.com&gt;	&amp; Lt; p00261@psilink.com&amp;gt;
Luis	Luis
kuma.	same to you.
lawa-cika	lava-filled
kayayyaki	designs
sani?	know?
dake	with you
Hudu	Four
&#39;yanci.	Freedom.
XRaiseWindow	XRaiseWindow
malpractice	malpractice
WAYAR:	Phone:
comets,	comets,
bayyane	Visible
sani.	know.
USA	USA
jituwa	compatible
Luka	Luke
nasarar	victory
&#39;Ni	&#39;I
agogon	watch
dãɗin	conveniences
Sama.	Above.
kwatancen?	comparisons?
sani,	know,
bayyana	appear
daji	wild
shiri	plan
digiri.	degree.
anecdotal	anecdotal
1ff,&gt;	1ff &amp; gt;
tabbataccen	definite
indicting	indicting
Agusta	August
alewa	candy
tsari&quot;.	process &amp; quot ;.
(yadda	(
Länder	Länder
gilkey,	gilkey
Dr.	Dr.
alternating	alternating
&quot;pop	&amp; Quot; pop
ƙone	burned
kangara	arrogant
sanar	announced
&quot;dual	&amp; Quot; Dual
kangare	arrogant
zamba&gt;	Scams &amp; gt;
LaStrange	LaStrange
////	////
Moroccan	Moroccan
henry@zoo.toronto.edu	html>
&quot;wuya&quot;	&amp; Quot; difficult &amp; quot;
Kattai.	Giants.
sharudda.	criteria.
unethical.	unethical.
Lindroos	Lindroos
wanda&gt;	&amp; gt;
Dod	Dod
3511,	3511,
bitnet:	bitnet:
Fang	Fang
1024	1024
sauyin	CLIMATE
DOS6	DOS6
batting	batting
Support	Support
Huh?	Huh?
Finney	Finney
azumi	fast
withs	withs
DOS.	DOS.
dai,	However,
&quot;x9&quot;	&amp; Quot; X9 &amp; quot;
Hui)	Hui)
amfanin:	benefits:
sanda	police
&#39;yanci	Freedom
baya&quot;.	back &amp; quot ;.
Lucifer,	Lucifer,
farjinsu	Chastity
cikin&gt;	&amp; gt;
karshen	end
daga	from
Dos	Dos
Tun	Since
100k	100k
Don	To
codified	codified
more.	more.
goyan	supported
Jon.	Jon.
Nazarin	Study
haka,	Therefore,
haka.	.
verbatim).	verbatim).
tsoro.	fear.
neccities	neccities
altimeter	altimeter
orthodoxy	Orthodoxy
hakkin	right
Mafarki	Dream
(Amirkawa)	(Americans)
namiji,	male,
horo.	training.
Buffalo	Buffalo
da&#39;awar,	claim
jamiái	agents
*************************	*************************
ƙahonin	horns
Magazine	Magazine
Ƙara	Further
cikin	the
exeption.	exeption.
girgizar	quake
wahayi	revealed
saura	field
size.	size.
size,	size,
sauri	faster
(Steve	(Steve
Bloom,	Bloom,
saukar.	down.
Georgetown,	Georgetown,
tun&gt;	since &amp; gt;
Harshen	Language
saukar,	down,
yaudarar	misleading
(Kirk	(Kirk
Kristanci	Christianity
&quot;duk	&amp; Quot; all
​​Lee	Lee
rem	rem
cancantar	worthy
miles).	miles).
{asar	United
TIFF,	TIFF,
Proud	Proud
-428-0800	-428-0800
ciki.	interior.
ciki,	including,
John	John
Rifleman&quot;,	Rifleman &amp; quot ;,
Pluto,	Pluto,
Pluto.	Pluto.
qananan	minor
Assurance	Insurance
Spencer)	Spencer)
description	description
sauti	sound
Ashe,	Have
latsa	press
Overall	Overall
vertically	vertically
Dave	Dave
lahadi	Sunday
lura:&gt;:	Note: &amp; gt ;:
Tapered	Tapered
dila	Dealer
tvtwm,	tvtwm
daya.&quot;	one. &amp; quot;
Heat	Heat
override	override
-486-9975	-486-9975
17th,	17th,
lãbãri	story
&lt;Ba.	&amp; Lt; No.
raw	raw
martani	responses
din.	din.
jon,	jon,
Daya	One
taƙawa	cautious
Tabbatar	Confirmed
farko.	first.
farko,	First,
rind@enterprise.bih.harvard.edu	html>
Sannu,	Hello,
...&gt;&gt;&gt;	... &amp; Gt; &amp; gt; &amp; gt;
adaftan.	adapter.
Alan	Alan
Alal	For
Ni,	Me
5X9&gt;&gt;	5X9 &amp; gt; &amp; gt;
perturbations	perturbations
girgije.	clouds.
commited	commited
axis	axis
girgije,	clouds,
Systems&gt;	Systems &amp; gt;
New	New
gaya,	told,
inorganic	inorganic
direbobi	drivers
rai	life
ran	expected
&quot;gani&quot;,	&amp; Quot; see &amp; quot ;,
luwadi	Gays
rijiya-gina	well-built
gabas-da-yamma	east-to-west
Amsawa	Reaction
^^^^^^^^^^^^^^^^^^^^^^^^^^^	^^^^^^^^^^^^^^^^^^^^^^^^^^^
kofin	cup
ƙarin,	more
tambayoyi	questions
Yake	Is
8,000	8,000
Leifson)	Leifson)
farkon	early
aninai!	cents!
Shari&#39;ar	Trial
halaka&quot;&gt;	destroyed &amp; quot; &amp; gt;
alamu	patterns
sunadarai.	chemicals.
yiwuwar	possibility
gajeren	short
kumburi	inflammation
alama	feature
sabuwa&gt;	new &amp; gt;
AMMA	BUT
1986,	1986
1986.	1986.
WNCI	WNCI
sauya	change
free,	free,
Ra&#39;ayin?	Idea?
Syria	Syria
kanka,	yourself,
(22,238	(22,238
Soviet	Soviet
10,000	10,000
clipper	Clipper
Yana	Is
alhẽri?	good?
1985.	1985.
&lt;mvanheyn@cs.indiana.edu&gt;	&amp; Lt; mvanheyn@cs.indiana.edu&amp;gt;
Whethe	Whethe
motif.	motif.
Venus.	Venus.
UNIX	UNIX
kome&gt;	anything &amp; gt;
jikinsa,	body,
faifai	disk
clears	clears
tofa	spit
Venus,	Venus,
kasancewa	availability
nagle@netcom.com	html>
gudãnar	drives
Wanda	Which
acetylene	acetylene
Ground	Ground
Nan	Here
kalmomi.	words.
seethes	seethes
Explorer	Explorer
daina&gt;	Stop &amp; gt;
bindigogi	guns
1983.	1983.
Wadannan&gt;	These &amp; gt;
Utopia	Utopia
kwayar	apple
core.	core.
ka&#39;idojin?	principles?
core,	core,
kwayan	Bacterial
palastenians	palastenians
ulysses.att..com	ulysses.att..com
Europa,	Europa,
mahautsini!	mixer!
kwantar	cool
ka&#39;idojin.	principles.
misali	example
lafiya.	health.
al&#39;ummomi.	generations.
lafiya,	Health
doka,	law,
doka.	law.
Columbia,	Columbia,
igiyoyin	currents
almajiran)	disciples)
***************	***************
kalmomin	words
dagagge	elevated
labarai	news
overlapping	overlapping
1981.	1981.
cakuda	Mixture
tsanani	severe
Stores	Stores
amfani&gt;	use &amp; gt;
al&#39;adu	culture
rip	rip
fadowa	falling
Bisimillah	Cheers
lafiyar	Health
al&#39;ada	custom
&quot;dogon	&amp; Quot; long
1980,	1980,
Littafi,	Book,
Bzzt!	Bzzt!
-rigth	-rigth
alaka	related
Timmons)	Timmons)
Timmons,	Timmons,
kwamfutarka.	computer.
shrank,	shrank,
5-11,	5-11,
promiscuous&quot;	promiscuous &amp; quot;
martian,	martian,
hrubin@pop.stat.purdue.edu	html>
makamai	Arms
Nissan.	Nissan.
Celsius,	Celsius,
kaya,	inventory,
Salah)	Salah)
kaya)	inventory)
Attaura?	Law?
kaya.	stuff.
wayar	phone
rinjaye	majority
kasancewa&gt;	being &amp; gt;
(Leong	(Leong
martyj@mrcnext.cso.uiuc.edu	html>
wahala	difficulty
kaɗan	little
Attaura,	Law,
Attaura.	Law.
&lt;1qnb9tINN7ff@rave.larc.nasa.gov&gt;	&amp; Lt; 1qnb9tINN7ff@rave.larc.nasa.gov&amp;gt;
accuire	accuire
inherently	inherently
&quot;tuna	&amp; Quot; Remember
quack,&gt;	quack, &amp; gt;
97,9	97.9
&quot;Duk	&amp; Quot; All
GSX-145	GSX-145
teams	teams
nasaba	linked
akwati	container
Comics.	Comics.
Mives	Mives
Control	Control
ƙasa-moon-rãnã	earth-moon-sun
kayan	equipment
hanyar.	way.
reeves)	Reeves)
cfaehl@vesta.unm.edu	html>
hula.	cap.
hanyar,	way,
bisa,	above,
&quot;q	&amp; Quot; q
Iyakar	Border
hanyar)	way)
cryptography.	cryptography.
sadar	Connecting
goyon	support
brian@gab.unt.edu	html>
comp.sys.ibm.pc.hardware	comp.sys.ibm.pc.hardware
Jahannama	Hell
bukatar.	need.
Canucks	Canucks
(Sam	(Sam
samfurori	products
horar	training
Stephen	Stephen
Livermore,	Livermore,
kullum	daily
FRED&#39;S	FRED&#39;S
&#39;halitta	&#39;Created
likitoci	doctors
Redelfs)	Redelfs)
des-kamar	des-like
nstassen@magnus.acs.ohio-state.edu	html>
addu&#39;a&gt;	prayer &amp; gt;
lokuta,	cases,
Ibrahim,	Ibrahim,
&quot;	&amp; Quot;
harshe	language
Addu&#39;a	Prayer
samuwar.	formation.
yisti	Bread
kammala.	completed.
hannun	hand
riko,	Acting
Kuma,	Same to you,
Maxwell	Maxwell
imputs	imputs
sada?	friendly?
fushin	anger
&quot;wutsiyoyi.&quot;	&amp; Quot; tails. &amp; Quot;
Electronics	Electronics
jikinsu.	bodies.
daraja,	worth,
rairayi.	sand.
Neptune.	Neptune.
wuraren	places
Neptune,	Neptune,
486-33DX)	486-33DX)
blank.	blank.
saukad	drops
hulda	Contact
Attaura&quot;&gt;	Law &amp; quot; &amp; gt;
ohms	ohms
martians	martians
terrestrial	terrestrial
saukar	down
yiwuwa.	possible.
yiwuwa,	probably,
&quot;karshe	&amp; Quot; final
==========	==========
Tsarki,)	Purity)
(Carl	(Carl
&#39;gnostein?&#39;	Gnostein?
hannu.	hand.
Kwatancen,	Comparisons,
hannu,	mobile,
1989,	1989
makafi),	blind),
durkushe	collapse
Wagner,	Wagner,
Howdy	Howdy
Coons)	Coons)
kogin	River
yiwu	possible
eruptions	eruptions
-Karl&gt;	-Karl &amp; Gt;
(ncsc8!	(Ncsc8!
tashoshin	stations
lin)	lin)
tarayya	Federal
fang@en.ecn.purdue.edu	html>
Sharma	Sharma
asibitin&gt;	Hospital &amp; gt;
telescopic	telescopic
sai	and
Duniya.	World.
Duniya,	World
anti-gun	anti-gun
carbon	carbon
Anecdotal	Anecdotal
sauki.	easy.
upgradable	upgradable
tafsirin	interpreting
Everest.	Everest.
san	know
sau	times
spec&#39;d	spec&#39;d
years	years
zaune	living
zauna	stay
line	line
Bulus	Paul
sa,	,
Properties	Properties
yankuna&#39;.	regions.
nauyin&gt;	weight &amp; gt;
(Bryan	(Bryan
taskõkin	Treasures
saƙonni	messages
(Kevin	(Kevin
SCSI	SCSI
free-mutumin	free-man
rahama	Mercy
Darryl	Darryl
jumper	jumper
muhimmanci	important
kowane,	each,
kowane.	each.
[ban	[Ban
lilo	Browsing
&lt;&lt;	&amp; Lt; &amp; lt;
===	===
Rasha	Russia
nema)	Quest)
fuka-fuki	wings
dukan&gt;	all &amp; gt;
750.	750.
Thomas	Thomas
lyme	lyme
&quot;manyan	&amp; Quot; large
&quot;doke	&amp; Quot; beat
RS-6903	RS-6903
mayar.	back.
All!	All!
amma&gt;	but &amp; gt;
Ohio	Ohio
82%,	82%,
Potvin,	Potvin,
ayoyi	verses
Gosh..I	Gosh..I
J.David.W.Reeves@dartmouth.edu	html>
m-dutsen	m-rock
&quot;Stephen	&amp; Quot; Stephen
aep@world.std.com	html>
baƙin	mouth
Ranger,	Ranger,
Bentz	Bentz
sabanin	unlike
(watakila	(Perhaps
Kusa-guguwa	Near-hurricane
&lt;	&amp; Lt;
Littattafan	Books
haka?	So?
yini	Day
sanya&gt;	made &amp; gt;
kyau&gt;	beauty &amp; gt;
natonal	natonal
Suzuki	Suzuki
sojojin	forces
Spencer	Spencer
saukin	easily
emulators	emulators
Center.	Center.
Planitia	Planitia
awon	laboratory
makanikai	mechanics
launi	color
akwai.	there.
!!&quot;	!! &amp; Quot;
makullin	keys
Winslow,	Winslow,
sha	drink
zagayowar,	cycle,
&#39;Allah&quot;	&#39;God &amp; quot;
SU&gt;	SU &amp; gt;
16804	16804
University	University
kekuna,	bikes,
safiya	morning
bãya,	away,
Gaba	Next
bãya.	away.
aikace-aikace	applications
unguwa	neighborhood
(JPS)	(JPS)
bashin	debt
shi	it
(All	(All
sashen	section
Washington.	Washington.
nasara	victory
laifuka,	crimes,
sadarwa	Communications
garkuwoyi	shields
Dayton,	Dayton,
matakai.	steps.
_in	_in
kafar	foot
safiyo	Surveyor
ruwan.	water.
ƙarƙashin	under
ruwan,	water,
macijin	Worm
ƙãrẽwar	spending
kuka)	you)
madalla	Excellent
siriyal,	serial,
lasisi	license
kwaikwayo	theater
(______________________________________)	(______________________________________)
lafiya&quot;.	Health &amp; quot ;.
saman&gt;	top &amp; gt;
Pgf@srl02.cacs.usl.edu|Like	Pgf@srl02.cacs.usl.edu|Like
10/82	10/82
Amirka	US
Kawasaki	Kawasaki
(game	(About
ɗaba&#39;ar	publication
karkashin	under
keyboard	keyboard
1990.	1990.
1990,	1990,
bakin	mouth
birki	brake
jerin	list
ekdfc@ttacs1.ttu.edu	html>
College	College
fama.	combat.
4Runner&gt;	4Runner &amp; gt;
Domin	For
Oh,	Oh,
Djakarta,	Djakarta,
4/26/93.	4/26/93.
Ok,	Ok,
Callisto	Callisto
anecdotally&gt;	anecdotally &amp; gt;
promiscuity	promiscuity
Space	Space
6/91	6/91
qananan)	minor)
akidarsu	dogma
abinda&gt;	what &amp; gt;
daidaita	adjust
barbashi	particles
Canada,	Canada,
karfafa	strengthen
Fla.	Fla.
00ECGILLESPIE	00ECGILLESPIE
kasar,	country,
daidaito	consistency
-14	-14
degeneration.	degeneration.
irregularly	irregularly
Scharfy)	Scharfy)
ne,&gt;	&amp; gt;
hours).	hours).
ƙofar	gate
ƙoƙari	efforts
ganewa	identification
2230	2230
(Amy	(Amy
PMS	PMS
kafin	before
fatauci,	commerce,
Kuna	You
biyan&gt;	Payment &amp; gt;
rauni.	injury.
Franjione	Franjione
HOMOSEXUAL-	HOMOSEXUAL-
rocketry	rocketry
complexities	complexities
Kaufman)	Kaufman)
Telecope	Telecope
Kuma	Same to you
Volcanic	Volcanic
Edwin	Edwin
barci.	sleep.
barci,	sleep,
murya:	Voice:
gida-daga	home-from
cleanly	cleanly
zaben	election
maƙiya&gt;	enemies &amp; gt;
outermost	outermost
Duba	View
retinue	retinue
Ludwick&quot;	Ludwick &amp; quot;
bigots.	bigots.
(Andrew	(Andrew
game,&gt;&gt;	&amp; gt; &amp; gt;
(Tobiya	(Tobias
(3,010	(3,010
haƙuri.	Sorry.
(-184	(-184
files:	files:
haƙuri,	Sorry,
mika&gt;	offer &amp; gt;
amino	amino
tulun,	pitcher,
son	love
girgije	Clouds
shãfe	touch
inganci&gt;	quality &amp; gt;
ni&gt;	I &amp; gt;
babban&gt;	a &amp; gt;
---	---
&#39;.	&#39;.
leanings,	leanings,
invading	invading
Ryan	Ryan
records	records
Hoffman	Hoffman
su!	!
themon	themon
zabi.	option.
korean,	korean,
File,	File,
gudun;	speed;
alt.atheism	alt.atheism
Santa	Santa
1999.	1999.
crisscrossing	crisscrossing
&quot;Lyme	&amp; Quot; Lyme
Stanza	Stanza
ambaliyar	floods
10&quot;,	10 &amp; quot ;,
gaseous	gaseous
handgun,	handgun,
dazzling	dazzling
gangaren	slopes
a&gt;	a &amp; gt;
addu&#39;a	prayer
20th	20th
ma&#39;amaloli.	transactions.
haraji	taxes
Multiprobe	Multiprobe
alama.	feature.
hadisai	traditions
--clh]	--clh
hukuncin	ruling
dimbin	shaped
&lt;C5r60r	&amp; Lt; C5r60r
kishili.	homosexual.
___	___
kishili,	homosexual,
shipping	shipping
hankula	typical
lvc@cbnews.cb.att.com	html>
tebur	table
1993,	1993
sababinsa,	ha
Gyara:	Edit:
deceleration.	deceleration.
yaƙi	fight
Altimas	Altimas
&quot;gabar&quot;	&amp; Quot; sense &amp; quot;
Candida	Candida
freezes	freezes
bayyananniya	clear
(cyanide	(Cyanide
awa,	hour,
tsawon	period
1992,	1992
adam@das.harvard.edu	html>
dole.	must.
hukunci.	judge.
radioed	radioed
William	William
kwanda!	dilemma!
shĩ	He
Mamaki	Surprise
wa&#39;azi	instruction
&#39;:	&#39;:
Lauria)	Lauri)
juna.	each other.
handers.	handers.
juna,	each other,
real	real
kewayewa	orbit
makamashi.	energy.
1995,	1995
articals	articals
Turawa	Pushing
apples	apples
daviss@sweetpea.jsc.nasa.gov	html>
tauraron-dan	star-son
Bayyana	Appear
[magana	[Speaking
19947	19947
so,	wanted,
forsale	forsale
so.	want.
Altima,	Altima,
Obo	Obo
so;	wills;
maimakon	instead
dalili	reason
^^^^^	^^^^^
teams.	teams.
Gen3:	Gen3:
&#39;s	&#39;S
PCX	PCX
hali&quot;	character &amp; quot;
HCI.	HCl.
bangarori	Panels
so)	want)
diamita	diameter
&#39;m	M
gidajen	homes
mugu.	bad.
luck.	luck.
hankali.	attention.
dokoki.	rules.
hankali,	intelligence,
Poster	Poster
ergonomically	ergonomically
tarihi,	history,
tamu-fadi	planet-wide
wakeup	wakeup
hyundai	ford
shirin	program
tarihi.	history.
Dale	Dale
isolator&quot;	isolator &amp; quot;
Out	Out
babura,	motorcycles,
Our	Our
32-bit).	32-bit).
kasada	less than
happed	happed
babura.	motorcycles.
strawman	strawman
27611@athos.rutgers.edu,	27611@athos.rutgers.edu
cypher.	cypher.
96,5	96.5
folta@zen.holonet.net	html>
Skelton	Skelton
direba	driver
Cikin	The
zuriyar	seed
marubuta	writers
yankin.	area.
dokokin	laws
yankin,	area,
-oOOO	-oOOO
shirye-shirye	programs
astein@nysernet.org	html>
buƙaci	urged
asali	original
cututtuka,&gt;	diseases, &amp; gt;
marigayi	late
yankin:	area:
^^^^^^^^^^^^^^^^^^^^^^^^^^^^^^^^^^^^^^^^^^^^^	^^^^^^^^^^^^^^^^^^^^^^^^^^^^^^^^^^^^^^^^^^^^^
ko&#39;ina	everywhere
sharma@monet.vill.edu	html>
Patient-Likita	Patient-Doctor
Qasa	Earth
Kolodny	Kolodny
(Dick	(Dick
kasafi	allocation
BMP,	BMP,
sguerke@ravel.udel.edu	html>
OTOH,	OTOH,
Oliveira	Oliveira
kõme	nothing
GMT,	GMT
sadarin	innermost
kfrank@magnus.acs.ohio-state.edu	html>
kwamfutarka?	computer?
9600	9600
Wancan	That
Independence.	Independence.
coalesced	coalesced
baka.	you&#39;re not.
su.	.
su,	,
hans@xelion.nl	html>
sha&#39;awar,	interested,
Motherboards	Motherboards
rake,	rake,
Huduba&gt;	Sermon &amp; gt;
kamar&gt;	as &amp; gt;
&#39;Larabawa.	&#39;Arab.
SMARTDRV	SMARTDRV
labarin	story
lankford	lankford
Williams,	Williams,
muhalli.	Environment.
watau,	ie,
&quot;hankula&quot;	&amp; Quot; typical &amp; quot;
Bayan	After
kudi	money
Report	Report
ɗakin	room
manta	forget
makale,	stuck,
kundin	volumes
sun	they
tarihin	history
Frank)	Frank)
kudu	South
rakes	rakes
televison.&quot;	televison. &amp; quot;
wakilci	representation
kwalban	Bottle
shuka	plant
taɓa	never
malami	teacher
Wakiltar	Represents
holsend@mhd.moorhead.msus.edu	html>
Wasiku	Mails
Daga	From
decrypting	decrypting
cyphers	cyphers
(Robert	(Robert
main-bel	main-belt
subwindows	subwindows
kyakkyawa	beauty
addinin	Religion
FORSALE	FORSALE
sallama	Submit
Callisto,	Callisto,
sauka	down
Disclaim-ta:	Disclaim:
wurare	locations
statistics&gt;	statistics &amp; gt;
aboki	friend
weather	weather
(12V	(12V
===========================================	===========================================
WP51	WP51
addini,	religion,
kusoshi	nails
addini.	religion.
hali,	character,
gurin	covet
kungiyoyin	groups
&lt;1993Apr22.153959.12328@ucsu.Colorado.EDU&gt;	&amp; Lt; 1993Apr22.153959.12328@ucsu.Colorado.EDU&amp;gt;
hali.	character.
Latin	Latin
addini?	religion?
pitchers	pitchers
hayaniya	noise
(125	(125
cyanide.	cyanide.
tap	tap
(JPL)	(JPL)
shiryawa	packing
Dark	Dark
reno	nursing
Lawrence	Lawrence
&lt;1qkoel$5fr@horus.ap.mchp.sni.de&gt;,	&amp; Lt; 1qkoel$5fr@horus.ap.mchp.sni.de&amp;gt ;,
rufe	closed
Musa,	Moses,
likitoci).	doctors).
(Stephen	(Stephen
Geiger	Geiger
mahaukaci	crazy
halin	character
aminci&quot;	safety &amp; quot;
&lt;C5DxBs.5ov@panix.com&gt;	&amp; Lt; C5DxBs.5ov@panix.com&amp;gt;
&quot;wasanni&quot;	&amp; Quot; Sports &amp; quot;
****	****
dual-Sport	Dual-Sport
liscenced	liscenced
PS:	PS:
sãmun	find
baki,	black,
Fusion.	Fusion.
kõma	Return
ƙwalo	Premier
halfway	halfway
(175	(175
rufaffiyar	closed
Rayuwa	Life
NUNNALLY@acs.harding.edu	html>
Duo)	Duo)
[...	[...
canals	canals
WOW!	WOW!
&quot;Kada	&amp; Quot; Do
bearings	bearings
kafa,	set,
psyrobtw@ubvms.cc.buffalo.edu	html>
gudãna).	flow).
Kirista.	Christian.
sosai&gt;	very &amp; gt;
(RvKampen)	(RvKampen)
karni.	century.
kafa.	set.
!!!!	!!!!
bangaskiya.	faith.
Phil	Phil
unravel	unravel
yaushe	always
Kirista?	Christian?
lasis.	license.
....&gt;&gt;&gt;&gt;	--- &amp; Gt; &amp; gt; &amp; gt; &amp; gt;
(yawanci	(Usually
banschbach@vms.ocom.okstate.edu	html>
Willis)	Willis)
wutsiya,	tail,
ta)	)
ta,	,
labulen	curtain
&quot;bude&quot;	&amp; Quot; open &amp; quot;
Turai.	Europe.
Damu	Worry
Turai,	Europe
PTO	PTO
bakes	bakes
ta?	?
bãyar	grants
babban	great
harkokin	Foreign
dokoki,	rules,
addinai	Religious
(Tim	(Tim
bãyan	after
sauki	easy
kaina,	Personally,
ta.	.
uneventful,	uneventful,
sauke	drop
^^^^^^^^^^^^^^^^^^&gt;	^^^^^^^^^^^^^^^^^^ &amp; Gt;
Sani)	Know)
Duniya&gt;	World &amp; gt;
diamita,	diameter,
kaina.	myself.
babbar	great
dormant	dormant
ta:	:
dole&gt;	must &amp; gt;
French	French
HRB.	HRB.
crumbling	crumbling
matsala.	problem.
gabansa	before
shorted	shorted
abincin	food
14-19?	14-19?
Ajiye	Save
View,	View
bautawa	god
nake	I
Point	Point
nan.	.
nan,	Then,
zobba	rings
toml@boulder.parcplace.com	html>
kenyee	kenyee
shekarar	year
defenseless	defenseless
ƙulli]	Closure]
bit	bit
20-39	20-39
key,	key,
(gregh@niagara.dcrt.nih.gov)	(Gregh@niagara.dcrt.nih.gov)
key.	key.
bin	bin
nan)	)
9.256	9,256
....	....
ƙarfe-arziki	metal-rich
yiwuwar,	possibility,
Allah&gt;	God &amp; gt;
lankford,	lankford
kura	dust
...:	...:
Munns)	Munns)
(39.95)	(39.95)
...?	...?
amfilifa	amplifier
Roger.	Roger.
imbin	countless
zuriyarka	seed
(Tom	(Tom
Italiya	Italy
tamkar	as
&quot;jargon&quot;,	&amp; Quot; jargon &amp; quot ;,
albarkatun	resources
shekara,	year
binciken	survey
kusa	close
dabara	plan
kyakkyawan	good
shekara.	year.
sassa	parts
(Hãrũna	(Aaron
keya	keyat
Allen	Allen
dabaru	techniques
masana	experts
Goolsbey)	Goolsbey)
jikinsu	bodies
bob	bob
daya.	one.
daya,	one,
-Arlo	-Arlo
Florida	Florida
Mutum	Man
foda	powder
kera	Manufacturers
sifa	Attribute
(mu	(
crack	crack
talla	advertising
bincike.	research.
&quot;90%	&amp; Quot; 90%
(na	(
kirki.	good.
kirki,	fair,
&lt;rauser.734062608@sfu.ca&gt;,	&amp; Lt; rauser.734062608@sfu.ca&amp;gt ;,
...)	...)
bmw	bmw
...!	...!
yashwa.	erosion.
balle	nor
Ruhu-kai	Spirit-
tafiya&gt;	Travel &amp; gt;
namu	ours
(sabon)	(New)
Cuesta)	Cuesta)
gwada	test
(Frank	(Frank
&lt;C5r60r.4ID@megatest.com&gt;,	&amp; Lt; C5r60r.4ID@megatest.com&amp;gt ;,
Detroit	Detroit
gaske.	really.
gaske,	really,
Rasha,	Russia,
wahayi.	inspiration.
nan?	Here?
wa&#39;adi	while
keta	infringement
zarar,	Once,
dũkiyõyinsu	property
falakinsu	orbits
(ku	(
surveyed	surveyed
jikinsa	body
kuwa	and
Za&gt;	&amp; Gt;
whitsebd@nextwork.rose-hulman.edu	html>
Allah	God
streaky	streaky
HITEN	HITEN
streaks	streaks
(ko	(Or
5.500	5,500
benci.	bench.
Rauser@sfu.ca	html>
kuke	you
B433EI2.	B433EI2.
kuka	you
(bi	(Follow
suna,	,
lura,	Note,
nuclei	nuclei
4Runner	4Runner
(ba	(
RAM)	RAM)
hadari,	danger,
nasu	own
yankunan	areas
kula	care
1,000	1,000
mũminai)	believers)
ban	I
computergenerated	computergenerated
bai	not
hujja	proof
_your_	_your_
hadari.	storm.
zamanin	era
&quot;Robert	&amp; Quot; Robert
bad	bad
saukowa?	landing?
(as	(As
kuma	same to you
mũminai.	believers.
bar	bar
motherboard	motherboard
bincika.	search.
Imani	Believe
garken,	flock,
sunan	name
shirin.	program.
&#39;sunlit	The sunlit
niƙaƙƙun	fragments
flyby,	flyby,
(bentz.e.puryear)	(Bentz.e.puryear)
flyby.	flyby.
ƙarya,	lie,
yankuna.	regions.
ƙarya.	break.
Za&#39;a	Be
Norway,	Norway,
diyyar	price
spaceflight	spaceflight
dioxide	dioxide
Norway:	Norway:
Satumba	September
haushi,	bark,
cika.&quot;	fill. &amp; quot;
Engineer	Engineer
Voyager	Voyager
gadon	bed
Kunna	Activate
400,	400
***	***
saukowa	landing
matattu?	dead?
ruwa	water
gchin@Eng.Sun.Com	html>
kamfanoni	companies
flybys	flybys
Rick.	Rick.
sabõda	for
House	House
Replica	Replica
illa	effects
clack	clack
sana&#39;a&gt;	Professional &amp; gt;
bel	belt
HIMEM.SYS	HIMEM.SYS
ilmi	education
Colorado	Colorado
matattu.	dead.
matattu,	dead
(da	(
wajaba	enveloped
ammonia,	ammonia,
Zurfin	Depth
kididdiga	Statistics
kuna	you
matsalar	problem
koyarwar	teaching
Chryse	Chryse
ruwa-kankara,	water-ice,
domin	for
tsunduma	engaged
ƙãga	Originator
bi.	followed.
dwarfs	dwarfs
play	play
Legge	Legge
nawa	My
80111	80111
BAYANIN	FACTS
ƙayayuwa	thorns
kusa-range	close-range
Goma	Ten
ƙasa:	below:
gays	gays
ƙasa?	ground?
pop	pop
______________________________________	______________________________________
fariya	boast
Hukumar	Agency
&quot;Turai	&amp; Quot; Europe
(Ya	(
sakonni?	messages?
Triton.	Triton.
ilmin	education
gaya	told
kewaye	round
AntiSemitic	Antisemitic
za&#39;a	be
Computer	Computer
kayayyakin	products
samfur	Product
la&#39;anta	prosecution
61153	61153
ƙasar	country
Yowel	Joel
(karanta	(Read
kewaya	navigate
Shapiro	Shapiro
Good	Good
boye-boye	encryption
_him_	_him_
goma	ten
Tauraron	Star
kafin.	before.
motherboards,	motherboards,
kawar	removed
kocin?	coach?
electromechanical	electromechanical
ilmi,	knowledge,
kawai	only
kocin)	coach)
tafiyarwa	drives
site	site
Items	Items
ramummuka	slots
Wells,	Wells,
ƙarfafa	strengthen
Nunnally	Ullal
kayayyaki,	designs,
musanyãwa	change
blomberg	blomberg
tossing	tossing
gefe.	side.
namiji	male
Force	Force
ƙasa,	earth
583.&gt;	583. &amp; gt;
Zagaye	Round
sadarwa.	communication.
sito	warehouse
rigakafin	prevention
kafin?	before?
motherboards?	motherboards?
ƙasa.	below.
(Markus	(Mark
posters	posters
1990s,	1990s,
experimentation.	experimentation.
mambobi	members
62,4	62.4
Laboratory	Laboratory
su&quot;,	&amp; quot ;,
laushi	soften
bep)	bep)
busa	blow
ɗaya	one
Huhu)	Lung)
ce:&gt;&gt;	said: &amp; gt; &amp; gt;
promiscuous,	promiscuous,
Heart	Heart
six-	six-
Site	Site
jirgin	flight
&#39;^^^^^^&#39;,	^^^^^^
Gold&quot;)	Gold &amp; quot;)
workstation	workstation
Ganymede	Ganymede
al&#39;ummai?	nations?
saba.	usual.
dans@uxa.cso.uiuc.edu	html>
Tambayar	Question
rumbun	hard
-------------------	-------------------
daskare	freeze
&quot;Sai	&amp; Quot;
can	there
hali-kula	case-control
saba,	Normally,
hadarin	risk
(fili)?	(Obviously)?
________)	________)
*******************	*******************
dawwama	Infinity
shekaru,	years,
san&gt;	know &amp; gt;
Company	Company
shekaru.	years.
ƙarya	false
karamin	small
NRA-bokan	NRA-certified
(Microsoft	(Microsoft
ayyana	declared
Wings	Wings
siginar	signal
&#39;..:	..:
auku,	pass,
alfarwansu,	tents,
X3153	X3153
tãguwar	waves
weightier	weightier
goon	Gown
giant,&quot;	giant, &amp; quot;
Yahudu	Jews
Goma?	Ten?
tasirin.	labels.
buga	published
&lt;Fenton@Kaleida.Com&gt;	&amp; Lt; Fenton@Kaleida.Com&amp;gt;
Chin)	Chin)
bukukuwa.	balls.
manufofin,	policies,
Bos)	Bos)
ƙãre	finished
Surgery,	Surgery,
buge	strike
gas.	gas.
gas,	gas,
expeditions,	expeditions,
karshe):&gt;	final): &amp; gt;
buy-bãyansu	buy-backs
Buyers	Buyers
Avenue	Avenue
fatauci	trade
janar	Gen.
Ĩsã	Isa
gwaji	testing
(SF	(SF
Ishtar	Ishtar
Pleiades,	Pleiades,
Algeria	Algeria
&quot;saya	&amp; Quot; buy
(No	(No
dubawa	inspection
zaben),	elections),
(P.	(P.
Spiros	Spiros
Foundation	Foundation
fanareti	final
B2:&gt;	B2: &amp; gt;
geb@cadre.dsl.pitt.edu	html>
tattauna	discuss
(Juan	(Juan
ɗari	av
makwabta	neighbors
Rubin	Rubin
Kariya&quot;	Protection &amp; quot;
(biyu	(Two
&quot;zumunta.&quot;	&amp; Quot; relative. &amp; Quot;
rage&gt;	reduce &amp; gt;
itace	she is
principally	principally
1Meg	1Meg
romantic	romantic
bel.	belt.
bel,	belt,
lowers&gt;	lowers &amp; gt;
gano	identified
promiscuous?	promiscuous?
Dabauá	THANX
gane	recognized
Dokoki	Rules
bude	open
Kentucky	Kentucky
Titania	Titania
Audio	Audio
Arewa	North
gani	see
386DX-40	386DX-40
bus	bus
ranked	ranked
Rauser)	Rauser)
mallaka!	possess!
mutum-crewed	human-crewed
izni	authorization
Java	Java
talla.	advertising.
maraba	welcome
healers	healers
Medical	Medical
GMT&gt;	GMT &amp; gt;
biyu-domin	two-for
sarauta	reign
tsanani!	seriously!
duwatsu.	stones.
salula	Cellphone
tsanani)	severe)
tsanani.	seriously.
bc744@cleveland.Freenet.Edu	html>
gadi).	Interim).
Cirelli)	Cirelli)
Albertan,	Albertan,
ɗã&#39;a&gt;	Path &amp; gt;
caldwell8102@mtroyal.ab.ca	html>
amince,	agreed,
sauransu	etc.
rufe&quot;	closed &amp; quot;
cika?&quot;	full? &amp; quot;
gidana,	my house,
bege	hope
vantage	vantage
toyota	toyota
Galant	Galant
wayewa	civilization
goyi	support
(Arthur	(Arthur
Welles	Welles
sweeping	sweeping
title-	title-
tsananin	Severe
abinci.	food.
deviants.	deviants.
8.20).	8.20).
gare	for
jarraba	test
jhardono@nickel.ucs.indiana.edu	html>
shiriya	guidance
mallakar	power
quite	quite
Energy	Energy
kusurwa	corner
gchin@ssf.Eng.Sun.COM	html>
ARMM&quot;	ARMM &amp; quot;
ROM	ROM
aka	was
taurãri.	stars.
ake	are
bullshit	bullshit
shan	taking
matafiya	travelers
gaskiya.&quot;	true. &amp; quot;
Shipper)	Shipper)
aji	class
Verse	Verse
matafiyi	traveler
curly	curly
high-tsawo	high-altitude
9.128	9,128
Yarjejeniya	Agreement
mutane.	people.
posted,	posted,
mutane,	people,
dubban	thousands
laifuka	Criminal
yawansu	them
biyar,	five
aika	sent
AUTOEXEC.BAT	AUTOEXEC.BAT
image	image
baicin,	instead,
Capacity:	Capacity:
jayayya	Dispute
akida,	principles
tsirara	nude
Email	Email
batun&quot;	subject &amp; quot;
Finney)	Finney)
*****************	*****************
Card)	Card)
Tsakanin	Between
iko?&quot;	control? &amp; quot;
Sha&#39;awa	Interestingly
haihuwarka?	Circuits?
madigo?	lesbians?
tamu.	ours.
tamu,	our,
Kada	Do
Kristi.	Christ.
haihuwarka,	Circuits,
madigo.	lesbianism.
8300	8300
-or-	-or-
Ta&#39;addanci	Terrorism
mutanen	people
recyle	recyle
wukake:	knives:
VLB.	VLB.
daga&gt;	&amp; gt;
quack,	quack,
Ilmin	Education
empiric&gt;	empiric &amp; gt;
engp2008@nusunix1.nus.sg	html>
Dokar	Act
sadaukar	commitment
kwasfansu	bases
daban	different
dabam	Separately
wadãtar.	avail.
dabba	beast
12-14)	12-14)
\&gt;	\ &amp; Gt;
chilly	chilly
Lynn	Lynn
ne&gt;	&amp; gt;
Alabama	Alabama
amince	agreed
&lt;1r1i7mINN4n4@cronkite.cisco.com&gt;,	&amp; Lt; 1r1i7mINN4n4@cronkite.cisco.com&amp;gt ;,
aminci	safety
wurin&gt;	&amp; gt;
Tarayyar	Union
^^^^^^^^^^^^^^^^^^^^^^^^^^^^^^	^^^^^^^^^^^^^^^^^^^^^^^^^^^^^^
Lyme	Lyme
Isreal.	Isreal.
powerbook.	PowerBook.
gwajin	test
ana	are
sabon	new
annabawa.	prophets.
sharuddan),	terms),
Hitter,	Hitter
Repo	Repo
shi,	,
Villanova	Villanova
Orson	Orson
amo	noise
shi.	.
cutarwa,	harmful,
zunubansu&gt;	sins &amp; gt;
ANYI	BEEN
misinformed	misinformed
---------------------------------	---------------------------------
kananan	U there
aiki	work
neman	search
P7625)	P7625)
darajõji	degrees
hadaddun	complex
leka	Scanned
aiko	sent
Punjabi)	Loneliness)
&quot;un-izini&quot;	&amp; Quot; un-authorized &amp; quot;
gwaji.	testing.
methane,	methane,
methane.	methane.
game	about
rawaya	yellow
raina	my
;-)	;-)
kankanin	tiny
500.	500.
daidai.	exactly.
+31	+31
S.)	S.)
daidai,	right,
kasuwa	market
gama	for
(nemi	(Request
pacifist	pacifist
Alkawari,	Treaty,
overrepresented	overrepresented
Pluto	Pluto
daidai!	exactly!
buga.	published.
suma,	also,
Tashin	Hostilities
dumi.	warm.
iƙirari	claims
&#39;mu&#39;&gt;	&#39;&#39; &amp; Gt;
&#39;yan&#39;uwa	Brothers
ƙasã	earth
Ottawa,	Ottawa,
abu	thing
=============================	=============================
siffa	feature
Amurka.	US.
417-4101	417-4101
Randall	Randall
aibi	flaw
firist.	priest.
tafiya.	walk.
Timothawus	Timothy
willisw@coe-nw.clemson.edu	html>
gyarawa	fixed
magana&quot;.	talk &amp; quot ;.
Karshen	End
Micronics	Micronics
fam),	pounds),
tsananta	Persecution
Attaura&quot;?	Law &amp; quot ;?
Schuster)	Schuster)
musu,&quot;	them, &amp; quot;
makonni.	weeks.
&lt;1993Apr21.182606.6798@ra.royalroads.ca&gt;	&amp; Lt; 1993Apr21.182606.6798@ra.royalroads.ca&amp;gt;
Krista.	CHRISTIAN.
mota	car
DR350S	DR350S
&quot;biya&quot;	&amp; Quot; pay &amp; quot;
wayo!	Smart!
nazari	research
**********	**********
Italian	Italian
tawagar	team
daftarorin	Documents
Saturnian	Saturnian
gravitationally	gravitationally
DMA),	Right),
&quot;A	&amp; Quot; A
Fenton	Fenton
tafiyar	Travel
bindiga-dokokin.	gun-laws.
darajar,	value,
rayu&gt;	live &amp; gt;
zumunta	relative
&quot;,	&amp; Quot ;,
Annabi	Prophet
&quot;-	&amp; Quot; -
sunan,	name,
&quot;.	&amp; Quot ;.
m-it2691@cs.nyu.edu	html>
&#39;hanyar	&#39;Cause
Ishaku,	Isaac,
ƙasa	ground
Kana	You
malami.&quot;	teacher. &amp; quot;
inganci	effective
Almajiran	Disciples
dlb@hudson.wash.inmet.com	html>
gaba	next
argon,	argon,
dukiya,	property,
dukiya.	property.
SUPERVGA	SUPERVGA
watakila.	maybe.
ƙari	Extensions
ƙare	protect
ƙara	further
Askew	Askew
Kama	Catch
ainihi&gt;	identity &amp; gt;
ka&gt;	&amp; gt;
^^^^&gt;	^^^^ &amp; Gt;
daliban	students
sauki&gt;	easy &amp; gt;
quacks	are quacks
Nitrogen	Nitrogen
dalibai	students
ado	jewelery
Ulysses,	Ulysses,
moon	moon
Lantarki	Electronic
&quot;asirai&quot;	&amp; Quot; mysteries &amp; quot;
taron,	Conference
Whitsell	Whitsell
KRISTI	CHRIST
Asalin	Origin
gadi	Interim
KASHE	OFF
jama&#39;a	public
hanyoyi	roads
gada	bridge
Solar	Solar
alternately	alternately
++.	++.
warkar	healing
aiwatar&gt;	process &amp; gt;
613)	613)
&lt;15378	&amp; Lt; 15378
liwadi	homosexuality
Costner	Costner
cinye	consume
bene.	floor.
har,	and,
hambidge@bms.com	html>
18:33	18:33
benci	bench
bene,	floor,
hannu	Manually
iko,	power,
DBD@ICF.HRB.COM	html>
iko)	control)
(Clayton	(Clayton
zãlunci	wrong
theists)	theists)
Guerke,	Guerke
Guerke)	Guerke)
Cant	Cant
theists,	theists,
masõyansa	loved ones
&#39;bude&#39;.	&#39;Open&#39;.
tãyar	raised
Project	Project
aza	load
cuta,	disease,
mamaki:	surprise:
cuta.	disease.
Cape	Cape
(ya	(
gaisuwa	greeting
Kewaye	Round
cyphers?)	cyphers?)
untimely	untimely
madadin&gt;	backup &amp; gt;
waje.	outside.
11:26),	11:26),
kasuwanci&quot;,	business &amp; quot ;,
Karl	Karl
addinĩna	my religion
Sabres,	Sabres,
filastik	plastic
ciki	depression
3-8),	3-8),
cike	full
Surveyor	Surveyor
kekuna	Cyclists
ci-gaba	carry on
azurta	provided
(Herman	(Herman
kãma	seized
ai843@yfn.ysu.edu	html>
thomasp@ifi.uio.no	html>
spouts	spouts
garkuwa	shield
cutar	disease
Three-Way	Three-Way
cika	fill
Quebec,&gt;	Quebec &amp; gt;
nema)&gt;	Quest) &amp; gt;
gaskiya	Truth
Kasa	Ground
(Peter	(Peter
ayi	situated
iko?	control?
mujalla	review
Proteus	Proteus
(21,648	(21,648
Stone)	Stone)
mutãnenta.	people.
damuwa,	concern,
iko.	control.
mujallu	magazines
sihirin,	magic,
damuwa)	Concern)
diyya	compensation
yawanci	usually
aya	v
23-26,	23-26,
takarda	paper
hali	behavior
ba,	,
alung@megatest.com	html>
yankin	area
ba.	.
masanin	scholar
info.	info.
ƙasƙanci	lowest
baya-kofa	back-door
FJ1200	FJ1200
gawawwakin	bodies
takardu	documents
jami&#39;an	officials
coldest	coldest
faruwa-fito-na-aiki	going-out-of-work
haka	so
(Dan	(Dan
Thorson	Thorson
ikon	power
mu?&quot;	? &amp; quot;
shakata&gt;	relax &amp; gt;
hockey	hockey
Pharasees	Pharasees
sace.	stolen.
eavesdropper	eavesdropper
Stars	Stars
ƙarfafawa	stabilization
dõmin	for
(1,100	(1,100
juriya.	resistance.
--------------------------	--------------------------
kilomita	km
Corolla	Corolla
hana	prevent
lasisi,	licenses,
Musulmi	Muslim
que	que
Nagle	Nagle
hadadden	complex
Moon	Moon
tabbas	probably
wajen	to
Kowane	Each
==========================================	==========================================
&quot;Kaitona,	&amp; Quot; Oh,
Rauser	Rauser
leftist	leftist
2.5-kilomita	2.5-km
kokarin	efforts
HAMZA	HAMZA
ma&#39;ana.	meaning.
(Nicki	(Nicki
abokai	friends
Firayim	Prime
#&gt;	# &amp; Gt;
abokan	friends
Barry-hadar	Barry Bonds
sludge.	sludge.
Manzo	Messenger
Ulysses	Ulysses
canzawa	unchanged
Palestine	Palestine
itraconazole	itraconazole
shekaru).	years).
&quot;Kuma	&amp; Quot;
415-688-8231	415-688-8231
Nobuaki	Nobuaki
Ammonia	Ammonia
kasance).	).
20Meg	20Meg
kasashen?	countries?
Nowadys	Nowadys
Brooks	Brooks
murfin	cover
sheka	Switching
ribace-ribace	margins
hange	spotted
sheki	gloss
Pioneers	Pioneers
Hello,	Hello,
Telematics	Telematics
daban.	different.
sashe	section
ship	ship
--------	--------
hazo	fog
Sunansa	Name
JESUSCHRIST	JESUSCHRIST
Monitor	Monitor
cewa:&gt;	: &amp; gt;
takarar	candidate
kankanen	short
chunks.	chunks.
haye	crossed
(dutse),	(Rock)
za&#39;ayi.	there will be.
dabam.	separately.
takarce	junk
nazarin	study
Kokomo,	Kokomo,
ulterior	ulterior
fetur,	gasoline,
shi?	it?
for?	for?
refering	refering
deduced	deduced
ƙaho	trumpet
cire	remove
imani	believe
(su	(
shakka	definitely
(der	(Der
anti-fungal	anti-fungal
Ottoman	Ottoman
high-tsawo,	high-altitude,
talakawa	poor
Askew,	Askew,
(ta	(
Chicago.	Chicago.
mamaki),	surprise),
reasonning	reasonning
tambaya	question
inganta	improve
nazari,	review
lamiri	conscience
awa	hours
imaged	imaged
tambayi	Ask
tambaye	asked
unclumped	unclumped
Ma&#39;ana	Meaning
(1,170	(1,170
ma&#39;anar	meaning
Freq.	Freq.
dabbobi	animals
images	images
ƙeƙasasshiya	inactive
Small	Small
Palmer	Palmer
uban	father
multimillion	multimillion
gabãnin	before
Nunnally)	Ullal)
Order	Order
Alyosha	Alyosha
Makullin	Keys
&quot;Wannan-da-irin	&amp; Quot; That-a-kind
Askew)	Askew)
Lankford	Lankford
almajiransa	disciples
RSEVERY	RSEVERY
Carl	Carl
boulders.	boulders.
cikinta&gt;&gt;	wherein &amp; gt; &amp; gt;
Card	Card
(inda	(Where
wakilcin	Represented
ni,	me
gangarawa,	headed,
Justification_,	Justification_
ni.	me.
Tampa	Tampa
dangane&quot;	connection &amp; quot;
pgf@srl03.cacs.usl.edu	html>
Natal&#39;,	Natal,
detrimental	detrimental
rawa	role
UUNET:	UUNET:
Best!	Best!
ni)	I)
taron	Conference
8.1,	8.1
homosexal	homosexal
saituna	settings
Kwayoyin	Bacteria
Ruya	Revelation
Yesu	Jesus
&quot;cika&quot;&gt;	&amp; Quot; full &amp; quot; &amp; gt;
zubar	shed
ni?	me?
paradox	paradox
touch	touch
incinerate	incinerate
craters	craters
wata,	a,
wata.	a.
Sãɓãwar	Alternation
amsoshin	answers
&quot;sanyin	&amp; Quot; comfort
AT)	AT)
sayarwa	sale
Canadiens?	Canadiens?
&quot;tattaunawa&quot;	&amp; Quot; conversations &amp; quot;
_____	_____
net	net
ganinsu	sight
ganinsa	see
ra&#39;ayi&gt;	concept &amp; gt;
raya	Development
almajiran	disciples
fursunoni	prisoners
Range	Range
ze&gt;	seem &amp; gt;
Babu	No
yesu	Jesus
Ira	Invention
asteroid	Asteroid
&#39;yan&#39;uwanku	Brothers
Daga:	From:
Masana	Experts
Ubangiji	Master
Communications	Communications
aji,	class,
040	040
Masani	Knowing
20X-60X60mm,	20X-60X60mm
wargajewa	extermination
hetero	hetero
dutse	mountain
Mutane	People
bandwith	bandwith
Hakika,	Of course,
ne,	,
ne.	.
ganina).	my opinion).
tsawon,	length,
bakwai	seven
hanya	way
ultrahigh-ƙuduri	ultrahigh-resolution
ventured	ventured
ƙulli	Closure
fitila	Lamp
Yaren	Language
AIAA	AIAA
fito.	out.
maza),	men),
antennas	antennas
kauce	avoid
madawwama	abide
_______________________	_______________________
rescinded.	rescinded.
Phobos	Phobos
assirtar.	ridden.
&lt;C5xxq0.18M@cs.columbia.edu&gt;	&amp; Lt; C5xxq0.18M@cs.columbia.edu&amp;gt;
rayu	live
French-	French-
Carlton	Carlton
Karanta	Read
===============	===============
ne:	is:
matsala	problem
(shaho	(Hawks
aikin.	.
kasassun	kasassun
nan	here
Orient	Orient
maras	low
Panoramic	Panoramic
Baseball	Baseball
kunsa.	wrap.
KAFIN	BEFORE
Hyundai	Hyundai
WinJPEG	WinJPEG
&quot;Yin	&amp; Quot; Making
Magellan,	Magellan,
faɗi	extension
Its	Its
(OO)	(OO)
faɗa	fight
(ron	(Ron
classic	classic
tikiti	tickets
&quot;&gt;	&amp; Quot; &amp; gt;
5vdc	5vdc
000	000
ayyuka	Activity
watau	ie
watan	month
Humphreys	Humphreys
3.1,	3.1
&quot;zana	&amp; Quot; draw
Wucewa	Passing
Mystique&quot;	Mystique &amp; quot;
na)	)
rani	summer
rana	day
na.	.
apps,	apps,
na,	,
ƙididdiga	Statistics
132,252	132.252
GABATARWA	INTRODUCTION
belts	belts
mulki	ruling
Active	Active
toml@boulder.ParcPlace.COM	html>
Herman,	Herman,
rami	hole
shelar	proclaim
maganar?	Word?
^^^^^^	^^^^^^
Zabura	Psalm
oxygen	oxygen
al--92-186,	al - 92-186,
Yesu.	Jesus.
kumbon	spaceship
Yesu?	Jesus?
minti.	minutes.
ma&#39;ana	meaning
(Romawa.	(Romans.
Felix	Felix
movie	movie
&quot;yin	&amp; Quot;
duka&gt;	all &amp; gt;
Yesu,	Jesus,
hasken.	light.
Claudio	Claudio
Yesu)	Jesus)
sãɓã	disobedience
chipset	chipset
square	square
3.1?	3.1?
guguwa-kamar	hurricane-like
iska,	air,
gudana	ongoing
Amirkawa).	Americans).
taimake!)	help!)
(Bill	(Bill
rasa	lost
&quot;Ya,	&amp; Quot;
rare	rare
Yesu&gt;	Jesus &amp; gt;
hira	interview
suka&gt;	&amp; gt;
zarar	Once
|&gt;&gt;	| &amp; Gt; &amp; gt;
tsayi	stop
TranslateCoordinates	TranslateCoordinates
farmaki	attack
al-/	al /
marly	Marlyn
TIFF	TIFF
yamma	West
Timmons	Timmons
zahiri&gt;&gt;	literally &amp; gt; &amp; gt;
Fisher	Fisher
apple	apple
tsaye	standing
tsaya	stand
&quot;suka&quot;,	&amp; Quot; &amp; quot ;,
12-shekara	12-year
waxanda	which
memory.	memory.
makonni	weeks
samuwar	formation
6/92,	6/92,
mwm	mwm
daina	stop
Shi&gt;	&amp; Gt;
hanya:&gt;	way: &amp; gt;
mutuwar	death
Photos	Photos
mlee@post.RoyalRoads.ca	html>
tsãge	rent
kauna	love
budurwa.	girlfriend.
v124p7kk@ubvmsc.cc.buffalo.edu	html>
Aikin	Work
neccacery	neccacery
kabilanci	Ethnic
Canza	Change
tsawo	height
Akwai&gt;	There &amp; gt;
kunshe	included
siffofi	features
kunshi	contains
fitar	out
zarce	exceed
____________________________________________	____________________________________________
1992/93	1992/93
Perturbations	Perturbations
Jet	Jet
Inc.	Inc.
curable	curable
Date:	Date:
matsayi	status
feedback	feedback
kunnawa	player
kasuwanci	business
Triantafyllopoulos)	Triantafyllopoulos)
karami	smaller
rana.	day.
rana,	day
Safety	Safety
Mitchum)	Mitchum)
discoverer,	discoverer,
da&gt;&gt;	&amp; gt; &amp; gt;
yayin	while
zagayowar	cycle
Attaura	Law
Englewood,	Englewood,
wato,	namely,
Bayani)	Information)
tambayoyi.	questions.
al&#39;umma	community
daban-daban	different
muradi	motives
Adam.	Adam.
(CRAF)	(Craf)
shugabanci	leadership
Adam,	Adam,
Japan,	Japan,
Bari	Let
Flying	Flying
binne	buried
ƙanƙanta	least
knifes	knifes
Track	Track
(Hans	(Hans
jaskew@spam.maths.adelaide.edu.au	html>
Pasadena,	Pasadena,
radioisotopes.	radioisotopes.
Jay	Jay
Duniya-Moon	Earth-Moon
Vancouver	Vancouver
Faehl)	Faehl)
dioxide.	dioxide.
photovoltaic	photovoltaic
gwamnati	government
tsarin.	system.
bindigogi.	guns.
gaba.	next.
(Yahudawa).	(Jews).
zabin.	option.
tsarin,	system,
bindigogi,	guns,
watsi	emissions
ƙi	ki
totur	Accelerator
(AIR)	(AIR)
Bayanan	Data
dashi	up
College,	College,
resistors	resistors
nutse	sink
sake))	again))
sigogi	parameters
nufin	means
Back)	Back)
&quot;electroglow.&quot;	&amp; Quot; electroglow. &amp; Quot;
lokaci-lokaci	occasionally
Adams	Adams
Masters,	Masters,
wadannan	these
maƙiyi	enemy
Lore	Lore
wutsiya	tail
Inda	Where
email	email
maƙiya	enemies
Sakamakon	Results
^),	^),
haši	Connector
hurawa	blowing
wanzu&#39;	exist &#39;
zinariya	gold
Yahudawa	Jews
(303)488-6120	(303)488-6120
gaban	before
[386enh]	[386enh]
(_______________________)	(_______________________)
yi.&quot;	. &amp; quot;
hanyoyin	Methods
nagari	good
gabas	East
(Matt	(Matt
Gudun	Speed
damina	bumper
Low.	Low.
interactions	interactions
burge	thrill
fungal	fungal
(sai	(
nufi.	point.
Viking	Viking
harshen	language
general	general
Nagle)	Nagle)
ranar	on
tsarin?	system?
gaba?	next?
watsa	transmission
Galilei,	Galilei,
atraction	atraction
Tarihi,	History,
laetril	laetril
(National)	(National)
scan	scan
Info	Info
kaddarorin	properties
high	high
Saukake	Easily
tsarin;	system;
MacRae)	MacRae)
Baya	Later
surface	surface
zuwansa,	His coming,
&lt;1993Apr17.125545.22457@rose.com&gt;	&amp; Lt; 1993Apr17.125545.22457@rose.com&amp;gt;
abokina	my friend
AIR	AIR
^^^^^^^^^^^^^^^^^^^^^^^	^^^^^^^^^^^^^^^^^^^^^^^
hanyoyi.	ways.
Horus	Horus
yammacin	West
(ailin	(Aili
definition,	definition,
kamance,	similarities,
Kiristoci,	Christians,
Akwai	There
Kiristoci.	Christians.
rigths	rigths
al&#39;amurra	issues
xx155@yfn.ysu.edu	html>
Joseph	Joseph
karatu	reader
al&#39;amurran	issues
deriving	deriving
KO.	OR.
tẽku	sea
Microsystems	Microsystems
Galileo,	Galileo,
Equatorial	Equatorial
(437	(437
(Rick	(Rick
abokin.	friend.
nisa.	distance.
Bloomberg,	Bloomberg,
fayil	file
Management	Management
placebos	placebos
range	range
zukatan	hearts
******************	******************
tashi	rise
watanni.	months.
tashe	raised
watanni,	Months
arzikin	economy
100&gt;	100 &amp; gt;
Firaministan	Prime
Ayyuka&quot;	Activity &amp; quot;
mine	mine
alloli	gods
(Brian	(Brian
soyayya	love
mini	me
volts&gt;	volts &amp; gt;
lowers	lowers
rediyo	radio
803-654-8817	803-654-8817
dizzying	dizzying
British	British
jinsi.	gender.
gidan-sized	house-sized
Science	Science
gudãna	flow
girma)	Great)
&quot;wuya	&amp; Quot; hard
maƙwabcinsa	neighbor
Kuri&#39;a	Lots
girma,	Great,
Yanar-gizo:	Internet:
ƙoƙarin	efforts
2,400	2,400
rotational	rotational
jannati	astronaut
semiconductor	semiconductor
arziki!	rich!
(kawai	(Only
rufe&quot;?	closed &amp; quot ;?
kalmar?	word?
girgije-kamar	cloud-like
kunshi,	contains
bangaren,	component,
laifi.	crime.
Basu	Basu
Radio-Shack-iya	Radio-Shack
34,839	34.839
&quot;Wannan	&amp; Quot; This
girman	size
sci.crypt	sci.crypt
lissafi	calculation
furta	state
Arizona.	Arizona.
(Greek	(Greek
Jon	Jon
(447	(447
Island	Island
inept	inept
ganina,	my opinion,
Joe	Joe
Adawa	Opposition
-club	-club
rubũta	record
Bay,	Bay,
Kafin	Before
[LDS]	[LDS]
40Meg	40Meg
minutes	minutes
kunshin	package
molesters	molesters
unacceptable	unacceptable
Delco	Delco
tabbacin	guarantee
burbushi	traces
Infiniti?	Infiniti?
total	total
Things&gt;	Things &amp; gt;
Ju)	Ju)
rayuwata	life
KOWANE	ANY
bari),	let)
15:	15:
radar-zana	radar-draw
Harvey)	Harvey)
150	150
free	free
Kawai	Only
muku,	you
15,	15,
Stanley	Stanley
``.&#39;	``. &#39;
bbs:	bbs:
tuna,	Remember,
Kodayake	Although
sayar	sold
&quot;jin	&amp; Quot; feel
sayan	purchase
92,8	92.8
Apple	Apple
flyby	flyby
primeval	primeval
infusions	infusions
Wizzard	Wizzard
Tick	Tick
RKBA.	Rkba.
zunubansu.	sins.
kawai&gt;	only &amp; gt;
(215)645-6463	(215)645-6463
16,	16,
jira?	Wait?
ƙasar.	country.
dangantaka.	relationship.
ƙasar,	country,
masana&#39;antu	manufacturing
176	176
17:	17:
170	170
Yanzu,	Now,
warmer	warmer
_hard_	_hard_
marasa	patients
sane	knowingly
rendezvous	rendezvous
sani	know
saya,	purchase,
X-Window	X-Window
(Brian@gab.unt.edu)	(Brian@gab.unt.edu)
tunani.	think.
kansa.]	himself.
sabunta	update
tunani,	thought,
Mafi	More
tunani!	Think!
NCI.	NCI.
johnson	johnson
sami	found
guntu	bar
(David	(David
sama	heaven
(post	(Post
lokaci.	time.
mike	straight
lokaci,	time,
dangantakar	relations
address.	address.
mika	offered
yaɗuwar	transmission
ganganci	intentionally
1984&gt;	1984 &amp; gt;
Mai,	A,
11.	11.
lambobin	numbers
NA&#39;URA	DEVICE
Noring)	Noring)
samu	found
20850	20850
sayen	purchasing
Shaci	Outline
&quot;Amma	&amp; Quot; As
cramer@optilink.COM	html>
san,	know,
122	122
Shack	Shack
mil)	miles)
hikima)	Wise)
sale	sale
wasa,	play,
(aka	(
wasa.	play.
Ibraniyawa	Hebrews
jiya	yesterday
tunanin	Imagine
arab,	arab,
120	120
12)	12)
12,	12,
haka&gt;	&amp; gt;
Quinn)	Quinn)
Phone	Phone
saki	release
ma&#39;anarta	meaning
sake	again
Healers	Healers
saka	insert
(408)	(408)
kaddamar	Launched
molestation	molestation
ainihin	real
halaye	characteristics
Orbiter	Orbiter
Palestine?	Palestine?
sickening,&gt;	sickening, &amp; gt;
myslef)	myslef)
Camary	Camary
13,	13,
Clark.	Clark.
Mail	Mail
taga&gt;	window &amp; gt;
------------------------------	------------------------------
&lt;timmbake@mcl.ucsb.edu&gt;&gt;&gt;	&amp; Lt; timmbake@mcl.ucsb.edu&amp;gt; &amp; gt; &amp; gt;
ba&#39;a	fun
jiran	waiting
149	149
14:	14:
rabawa	distributor
annabta	predicted
********	********
kamfani	company
ƙanƙan	tight
wasan	match
14,	14,
cryptoanalysis.	cryptoanalysis.
la&#39;akari	Consider
asteroids,	asteroids,
duka)	all)
duka,	all
Torre	Torre
hadari	storm
Chemical	Chemical
perturbed	perturbed
yanke	cut
Sashen	Section
yanki	area
kasuwanni	markets
Bamediye	Median
saya	buy
ɗan&#39;uwansa,	brother,
saye	purchase
sayi	buy
wagner@mala.bc.ca	html>
Latonia)	Latonia)
kirawo.)	called.)
(Noring	(Noring
Fadada-muguwar	Expansion-cruel
Ikilisiya	Church
lambobi.	numbers.
streaks,	streaks,
bitamin&gt;	vitamin &amp; gt;
al&#39;amuran	events
hadar.	Bonds.
zuriya	seed
LA,	LA
yawo,	Streaming,
CRAF	Craf
kwatanci	imagination
(audible	(Audible
ɓãta	null
&lt;93095@hydra.gatech.EDU&gt;,	&amp; Lt; 93095@hydra.gatech.EDU&amp;gt ;,
yanka	cut
readiing	readiing
martian	martian
haramta,	prohibited,
gungu	clusters
cuta	disease
Bell-Northern	Bell-Northern
19,	19,
nufa?	mean?
mouse@thunder.mcrcim.mcgill.edu	html>
Fraering	Fraering
(Oh,	(Oh,
Mayans	Mayans
VESA	VESA
RA&gt;	RA &amp; gt;
pitching	pitching
yawon	Tourism
19?	19?
shugaban.]	President.
&#39;Wanda	&#39;Who
19:	19:
&quot;misali&quot;	&amp; Quot; standard &amp; quot;
rãyuwar	life
fuskar	face
tsararru	array
Comments?	Comments?
Halley	Halley
Cututtuka	Diseases
Kai	Head
trillionth	trillionth
makullin.	keys.
tausayin	petty
&quot;Idan	&amp; Quot; If
Mercury	Mercury
katin	card
pointers	pointers
VE7GDA	VE7GDA
---------------	---------------
dukan	all
Boats	Equipment
seafarers	seafarers
Resp.	Resp.
LDS	LDS
nagartaccen	sophisticated
Antarctica.	Antarctica.
gaba-hadar	next Bonds
LED	LED
lafiya&quot;	Health &amp; quot;
lakabi	title
karrama	honors
~~~	~~~
iya,	can,
direba,	driver,
(Is&#39;hãƙa	(Isaac
zargi	accused
haifar	create
filaye	Grounds
sa&gt;	&amp; gt;
Ken	Ken
wajibi	compulsory
rage	reduced
maraice	evening
saita	set
rago	lamb
matukar	while
rai.	life.
karanta	read
floppies	floppies
Matt	Matt
shida.	six.
wutsiyoyi.	tails.
ragu	decrease
wutsiyoyi,	tails,
&#39;al&#39;ada	&#39;Normal
bambancin	difference
gravitacional	gravitacional
&lt;1993Apr4.221228.17577@bsu-ucs&gt;	&amp; Lt; 1993Apr4.221228.17577@bsu-ucs&amp;gt;
noma.	agriculture.
korau.	negative.
Shi,	It,
ziyartar	visiting
&#39;Theos&#39;	&#39;Theos&#39;
Masu	The
itatuwa,	trees,
rubuce-rubucen	writings
haife,	born,
niyyar	intent
matsaloli	problems
ƙura	dust
fitarwa?	export?
(Gordon	(Gordon
(510)	(510)
Scandinavians	Scandinavians
(kishili	(Homosexual
Pan-Turai	Pan-European
Washington	Washington
fada	fight
plausible	plausible
duwatsu	mountains
samu&gt;	find &amp; gt;
factor	factor
astein@israel.nysernet.org	html>
canje-canje	changes
(Keith	(Keith
rafi	Rafi
collisions	collisions
Shin	Whether
mutuwa.	death.
gasar	competition
mutuwa,	death,
faci	patches
100,000	100,000
Rufe	Closed
travesty	travesty
kyan	beauty
Express	Express
Sports	Sports
northerly	northerly
Infiniti	Infiniti
fadi	extension
shaida	witness
tudu	mountain
kwashe.	evacuated.
vacsc0qe@VAX.CSUN.EDU	html>
keybd	keybd
scott@asd.com	html>
index	index
zababben	Selective
1-26	1-26
ilimin	Education
Ofishin:	Office:
Kipling	Kipling
launukansa&gt;	colors &amp; gt;
dialup	dialup
shekaru	years
propulsion	propulsion
Dawuda.	David.
starowl@rahul.net	html>
kyau	good
playoffs!	playoffs!
taba,	tobacco,
tuba	converted
motsi	motion
annabci	prophetic
tube	tube
motsa	move
anti-gun,	anti-gun,
shekara	year
juriya	resistance
&quot;Borshevshky&quot;.	&amp; Quot; Borshevshky &amp; quot ;.
sanyaya	cooling
(Alan	(Alan
Gordon	Gordon
Weiss)	Weiss)
ciphertext	ciphertext
injin)?	machine)?
Michael	Michael
5.0.	5.0.
Benedikt	Benedikt
Maza	Men
PB170	PB170
syria.	syria.
M.)	M.)
Man,	Oil,
migrating	migrating
plumes	plumes
karya-malami?	break-teacher?
mine!	mine!
Ko,	Or,
kakar,	season,
Pittsburgh,	Pittsburgh,
haƙuri	patient
mine.	mine.
akan	on
cover	cover
Barman)	Barman)
akai	basis
warkewa	Healing
cipher?	Cipher?
wasu.	other.
Folta	Folta
Palestine.	Palestine.
wasu,	others
1.3	1.3
Male	Male
1.1	1.1
Shafi	Related
wakilta.	represented.
tsarin	system
akai-akai	frequently
bep1@cbnewsg.cb.att.com	html>
5-minti	5-minutes
&lt;lsj4ruINNl7o@saltillo.cs.utexas.edu&gt;	&amp; Lt; lsj4ruINNl7o@saltillo.cs.utexas.edu&amp;gt;
gashi	hair
masa?	him?
1-2	1-2
10.	10.
10,	10,
0,14	0,14
relays?	relays?
encrypting	encrypting
ceton	saving
fasara:&gt;&gt;	paraphrase: &amp; gt; &amp; gt;
gaske	really
shãmaki	barrier
(Malcolm	(Malcolm
intollerent	intollerent
fam)	pounds)
volcanoes.	volcanoes.
wakiltar	represents
Kou	Kou
saing	saing
100	100
sayi.	bought.
tashoshi	channels
ofishin	office
faku	absent
Edmonton	Edmonton
shawarwari	debate
Vica	Vicar
kwatanta	comparison
ionosphere,	ionosphere,
fan.	fan.
1/2	1/2
tsarki	purity
myopic,	myopic,
(Gasa	(Baked
Bure,	Free download,
on-line	on-line
fama	victims
clueless	clueless
(Gary	(Gary
Adams.	Adams.
radiated	radiated
Adams)	Adams)
ceto,	saved,
rabu	separated
tuna	Remember
Mulkin	Rule
Tiff	Tiff
Bernard)	Bernard)
_National	_National
thermocouples	thermocouples
MIniVas	MIniVas
Watsin	Transmission
sheka&gt;	Switching &amp; gt;
zahiri,	actually,
Tambayoyi	Questions
tsaro,	security
mummuna	ugly
tsaro.	security.
duniyoyi.	planets.
kufai	ruins
littattafai	books
Bures	Bures
&quot;T&quot;	&amp; Quot; T &amp; quot;
assult	assult
Mars	Mars
sauransu&gt;	etc. &amp; gt;
zobba,	rings,
allon	screen
tuki	driving
zobba.	rings.
&quot;tsaro	&amp; Quot; security
tranfer&gt;	tranfer &amp; gt;
Mark	Mark
Marc	Marc
ajiye	reserve
rabo	share
GIF.	GIF.
namu.	ours.
Rule	Rule
GIF,	GIF,
namu,	ours,
rabi	half
mini?	me?
gases	gases
short-rayu.	short-lived.
far,	therapy,
far.	therapy.
ƙawãta	beautified
raba	share
thermocouple,	thermocouple,
Singapore	Singapore
stargazers	stargazers
ExposureMask	ExposureMask
duniyoyin	spheres
bara	last year
kasa.	below.
sayarwa?	sale?
taimako,	help
saman-hagu	top-left
raɗaɗin	pains
Pluto),	Pluto),
relays	relays
sayarwa.	sale.
Neal	Neal
Bicentennial.	Bicentennial.
bari	let
barrantar,	cleared,
vshield	vshield
wasiyya	bequest
sa&#39;a	Hour
...	...
Fang)	Fang)
tambayar	question
kiyasta	estimated
Tsauni	Mountain
Eurosport	Eurosport
lokatan	TIMES
sakamako.	effect.
tsammani	guess
sakamako,	Reward
sakamako:	Reward:
kuma&gt;	and &amp; gt;
phosphorus)	phosphorus)
kasar	country
kwamfuta;	computer;
Cipriani)	Cipriani)
taimakon	help
bata	error
competently	competently
basu	not
ciyar	Spend
jargon	jargon
kwamfuta?	computer?
Matiyu	Matthew
fax:	fax:
&#39;a&#39;	&#39;&#39;
magana).	Speaking).
cryptanalysis.	cryptanalysis.
fax.	fax.
tsibirin	island
cancanta	worthy
makãmashin&gt;	fuel &amp; gt;
sauyawa	replacement
sakamakon	results
ciniki	trading
oozed	oozed
fadin,	across,
kwamfuta.	computer.
taga	window
kwamfuta,	computer,
bamu	us
precursor	precursor
photographed	photographed
fata	skin
bane	bane
Canadians	Canadians
software	software
band	band
(Afrilu	(April
tana	is
lumpy	lumpy
iyaye	parents
tap,	tap,
mota.	car.
tamu	our
kira	calls
ppm,	ppm,
sa&#39;a.	hour.
fasa	bust
dukan.	all.
bisexual.	bisexual.
dukan,	all
dukan)	all)
NOBODY	NOBODY
laifi	guilty
kisankai&#39;	murder &#39;
&quot;wani	&amp; Quot;
Amirkawa,	Americans,
ko&#39;	or
rubuce.	written.
-Karl	-Karl
rubuce,	writing,
duniya.	world.
launi,	color,
haddasa	causing
duniya,	World
Amirkawa:	Americans:
nickel-core	nickel-core
allo	screen
jũna	another
[mutãne]	[People]
fara	start
basira	skills
audio.	audio.
tabbatar.	sure.
fari	drought
tabbatar,	sure,
faru	events
lan	lan
iyawa	handles
Consulting,	Consulting,
&lt;15464@optilink.COM&gt;	&amp; Lt; 15464@optilink.COM&amp;gt;
bar,	left,
Pittsburgh	Pittsburgh
audio,	audio,
snowball.	snowball.
sa&#39;an	and
tunanin.	Imagine.
wadda	which
Ilmantar	Educating
sanarwa.	statement.
sanarwa,	statement,
Kaldis	Kaldis
&#39;SRESURRECTION::::	SRESURRECTION ::::
Mariner	Mariner
matasa-Leith)	Youth-Leith)
orbiter	orbiter
taka	play
orbited	orbited
take	title
asibiti	hospital
Hikimar	Wisdom
taki	Manure
volts.	volts.
launin	color
sa&#39;ad	when
muhimman	important
fuska&gt;	screens &amp; gt;
duniyar	world
zauna&gt;	sit &amp; gt;
kashe	off
rabo&gt;	ratio &amp; gt;
Lines.	Lines.
kashi	percent
taro	conference
sauran	other
Tug-na-yaƙi	Tug-of-war
Miranda	Miranda
tare	with
tanã	it
yaki.	war.
mažalli	Key
iyali	family
bindiga.	gun.
tasa	bowl
&#39;fassarar&#39;	&#39;Interpretation&#39;
kun	you
bindiga,	Rifle,
togiya.	exception.
taru	together
wutsiyoyi	tails
naman	meat
itãcen	palm
promiscuity&gt;	promiscuity &amp; gt;
Hauwa&#39;u	Eve
mls@panix.com	html>
Daidaitacce	Adjustable
Gnomes	Gnomes
tozarta	exploiting
iyalinsu	family
dadewa.	increase.
Lee	Lee
tara	nine
matsayi.	position.
&lt;C4vG3F.Kx3@apollo.hp.com&gt;,	&amp; Lt; C4vG3F.Kx3@apollo.hp.com&amp;gt ;,
Shawarwari	Debate
Price	Price
iyaka	Limited
baya	later
kara).	added).
sanarwar	statement
shimfiɗa	spread
England	England
Thorson)	Thorson)
yakin	War
Allahn	God
Shapiro)	Shapiro)
ku?	you?
kabila	race
fahimtar	understanding
Dr.Banzai	Dr.Banzai
hankalta	understand
planetology.	planetology.
ku,	,
(0,0)	(0,0)
Law	Law
........	........
ku.	.
Support)	Support)
Yana&gt;	&amp; Gt;
MDs	MDs
yanayin,	mode,
yanayin.	mode.
arziki	provision
motif	motif
.45	.45
dbd@icf.hrb.com	html>
Turanci	English
yanayin:	mode:
matsayin	as
1-800-344-4539.	1-800-344-4539.
Mouse	Mouse
tsibiran	The islands
yake.	.
yake,	,
cewa&gt;&gt;	&amp; gt; &amp; gt;
400&gt;	400 &amp; gt;
MC)	MC)
Canadians:	Canadians:
gurbin	replaced
rebooted	rebooted
Rubin)	Rubin)
yake:	is:
minti	minutes
oOOO	oOOO
tsabar	cash
FJ1200&gt;	FJ1200 &amp; gt;
rikitarwa	complications
Rubin.	Rubin.
Rubin,	Rubin,
X11R5	X11R5
X11R4	X11R4
hamadar,	deserts,
ethane,	ethane,
&quot;kasuwanci&quot;	&amp; Quot; business &amp; quot;
&quot;Casa&#39;in	&amp; Quot; Ninety
kuskure	mistakes
&#39;surface,	&#39;Surface,
seeded	seeded
aikatãwa	do
batu	issue
kmac@cisco.com	html>
jimlar	total
tsari&gt;	process &amp; gt;
halayyar&gt;	characteristic &amp; gt;
Neon	Neon
firistoci	Priests
Agnosticism	Agnosticism
McDonnell	McDonnell
range.	range.
suranta	shapes
hal@cco.caltech.edu	html>
Administration	Administration
Honda,	Honda,
Flown	Flown
(38.8	(38.8
shirya	prepared
dept.	dept.
ruwa-kankara	water-ice
taso	float
shirye	ready
faye	characterization
&quot;lura	&amp; Quot; Note
matsa	move
narkar	dissolved
excoriate	excoriate
joshuaf@yang.earlham.edu	html>
SETVER.EXE	SETVER.EXE
munns@cae.wisc.edu	html>
kungiyar	group
Model	Model
&lt;19613@pitt.UUCP&gt;,	&amp; Lt; 19613@pitt.UUCP&amp;gt ;,
e-mail	e-mail
liwadi&gt;	homosexuality &amp; gt;
jima&#39;i	sex
Steve.Shapiro@f440.n101.z1.fidonet.org	html>
Nesa	Distance
jiki	body
&quot;lasisi	&amp; Quot; license
karon	time
Siemon	Siemon
tunani	reference
rigorous	rigorous
daidai&gt;	right &amp; gt;
jiko	Infusion
XR250L	XR250L
Andreas	Andreas
Latsa-Democrat,	Press-Democrat,
saboda&gt;	for &amp; gt;
ganin),	see),
Terra	Terra
karni	century
low	low
girmamawa	honor
Luis&gt;	Luis &amp; gt;
dual-iska	Dual-air
Tsohon	Former
madauwari	circular
Patricia	Patricia
rubutun	scripts
Tauraro	Star
lengthy	lengthy
p.s.	p.s.
baby	baby
International	International
kan&gt;	&amp; gt;
babu	no
taimaka!	help!
tayi	offers
yakan	rises
cosmic	cosmic
lmh	lmh
&lt;Apr.9.01.09.22.1993.16580@athos.rutgers.edu&gt;	&amp; Lt; Apr.9.01.09.22.1993.16580@athos.rutgers.edu&amp;gt;
sabis.	service.
tsara-in	designed-in
(yisti)	(Yeast)
&quot;Proper	&amp; Quot; Proper
bada	giving
sabis,	service,
MLS	MLS
hunturu.	winter.
torre	Torre
ƙwalo,	Premier,
aikata.	do.
musamman	Special
Cisco	Cisco
ziyarci.	visit.
bimbinin	search-
beleive	beleive
ethane-methane	ethane-methane
karanta&gt;	read &amp; gt;
uucp:	uucp:
(wannan	(This
ayyukan	activities
Korenek	Korenek
(Ryan	(Ryan
kwayoyi	drugs
karin	more
nicad	nicad
Rocket&quot;	Rocket &amp; quot;
_ARE_	_ARE_
Comets	Comets
Yahudawa?	Jews?
&quot;gun	&amp; Quot; gun
hadaya	offering
Cibiyar	Center
192.100.81.100	html>
&quot;placebo	&amp; Quot; placebo
3&quot;,	3 &amp; quot ;,
kyawawa	beautiful
lmh@juliet.caltech.edu	html>
outright.	outright.
mother-	mother-
hula	cap
fasali	features
fassarori.	interpretations.
bazai	may not
Sauti	Sound
Davis	Davis
Internet:	Internet:
daure	bound
henry	henry
(Af,	(By the way,
repopulation	repopulation
daura	BIND
Mail:	Mail:
Stalin?	Stalin?
David	David
jinin	blood
Duwatsu	Mountains
Kadina	Cardinals
taimake!	Help!
(starowl@a2i.rahul.net)	(Starowl@a2i.rahul.net)
muhimmiyar	important
Basic	Basic
akalla	at least
PCX,	PCX,
???	???
Institue	Institute
5-7)	5-7)
&lt;May.7.01.08.16.1993.14381@athos.rutgers.edu&gt;	&amp; Lt; May.7.01.08.16.1993.14381@athos.rutgers.edu&amp;gt;
kuma&#39;	same to you&#39;
Mormonism	Mormonism
gabata	previous
.....)	.....)
tunawa	memorial
ka&#39;ida	regulation
Prism	Prism
faduwar	Twilight
&quot;Buy	&amp; Quot; Buy
(225	(225
kawai.	only.
crews	crews
baje	level
capacitive	capacitive
CAS.	CAS.
Ezekiel)	Ezekiel)
kawai,	Only
dalilin	reason
dama&quot;	Several &amp; quot;
NatLamp	NatLamp
komawa	return
mata;	women;
Bucky	Bucky
stats.	stats.
mata,	women,
5-6.	5-6.
rinjãya	controllers
Fasaha,	Technology,
N81	N81
Canaveral	Canaveral
baki	black
interested,	interested,
fatara	bankrupt
pixel	Pixel
...&gt;	... &amp; Gt;
ambato	hint
lair.	lair.
zafin	heat
fairly	fairly
Sent	Sent
orbital	Orbital
sell	sell
&quot;mayalwaci	&amp; Quot; adequately
nesa.	distance.
uwar	mother
karya	false
tashi-canza	fly-change
ball	ball
post	post
cache	cache
ran).	day).
(Life	(Life
tiriliyan	trillion
amintattu	secure
fagen	field
Nuwamba	November
jira	wait
ambata	mentioned
bautãwa)	god)
m-it2691@DOC.CS.NYU.EDU	html>
Cloud,	Cloud,
bautãwa,	god,
bautãwa.	god.
Mouse)	Mouse)
zafi.	heat.
zafi,	heat,
garin	town
wasan!	game!
NASA,	NASA,
Cuta	Disease
hakkoki	Rights
wasan.	game.
Roman	Roman
badi	Wednesday
bags)	bags)
18th	18th
---------------------------&gt;	--------------------------- &amp; Gt;
wasan?	game?
folta@well.sf.ca.us	html>
lokacin	time
zuwa:	to:
shuɗe,	blue
gabas)	East)
price.	price.
zuwa.	to.
Landmann)	Landmann)
facade	facade
price,	price
Sauya	Replace
recedes	recedes
Itace	She is
daga.	from.
symbolisms	symbolisms
daga,	from
Watakila	Maybe
Mutanen	People
zuwa,	to
zuwa)	)
TIDSA	TIDSA
(muna	(We
Triton	Triton
tambaya?	question?
algorithm?	algorithm?
Kirista	Christian
1742a	1742
hudu	four
Halley,	Halley,
asalin	origin
Kiristi	Christ
Loc	Loc
tambaya,	question,
tambaya.	question.
1.00	1.00
===================================	===================================
(wadanda	(
dauka	taken
(800)	(800)
digiri	degree
algorithm,	algorithm,
bukukuwa	balls
dalili.	reason.
Magellan	Magellan
jini	blood
jannati.	astronaut.
cibiyar	center
dauki	reaction
jannati,	astronaut,
dauke	carrying
welshed	welshed
zažužžukan	options
na&#39;urorin	Devices
gubar.	lead.
ƙaddara	determined
Schaufenbuel)	Schaufenbuel)
Taimako:	Help:
Harkokin	Foreign
LM350T	LM350T
launukansa	colors
lantarki?)	electronic?)
thread	thread
ma,	also,
gawarwakin	bodies
ma.	too.
1759,	1759,
launukansa,	colors,
qasar	country
demokraɗiyya	democracy
tipped	tipped
wanzu?	exist?
kayyadewa,	regulator,
18EB	18EB
kocin	coach
versa&quot;	versa &amp; quot;
gefe	side
takardun	documents
Yanzu	Now
Postbus	Postbus
asirai	secrets
{uunet,	{Uunet
likita.	doctor.
fortay	fortay
mac	mac
-km	-km
///	///
Subject:	Subject:
kawasaki	MOTORCYCLE
MC05A	MC05A
mai	a
likita?	doctor?
saƙon	message
Makan	Makan
ayoyi.	verses.
yi&gt;	&amp; gt;
sha&#39;awa	Interestingly
River	River
man	oil
daukar	taking
duhu,	dark,
Finnish,	Finnish,
(Billy	(Billy
daukan	takes
diddige,	heel,
kickback	kickback
diddige.	heel.
Salibiyyar	Crusaders
janar&gt;	General &amp; gt;
adadin	number
unscrupulous	unscrupulous
rarraba	distribution
camfin	myths
(kalubalanci	(Challenged
rarrabe	distinctive
15-The	15-The
(Makan	(Makan
10--	10--
gt4417a@prism.gatech.edu	html>
biyu&gt;&gt;	two &amp; gt; &amp; gt;
tsada	Expensive
Borland	Borland
harba	shoot
amma	but
Agency)	Agency)
harbi	shooting
Agency.	Agency.
&quot;bayyana	&amp; Quot; clear
kudin	currency
karãtun	rehearse
shipping.	shipping.
alhakin	responsibility
Gwamnatin	Government
**************************************************	**************************************************
gwaje-gwaje	tests
Gregory	Gregory
-------------------------------------------------	-------------------------------------------------
sakawa	positioning
shipping)	shipping)
nitrogen	nitrogen
(Elaine	(Elaine
guru	guru
kudi:	rate:
vents	vents
mine)?	mine)?
sikelin	Scale
hikima	Wisdom
kudi,	money,
&#39;juyawa	&#39;Rotation
alherin	goodness
sanarwa	statement
shugaba	President
cewar	According to
___________________	___________________
amsa	answer
hukunta	judge
micrometeorites,	micrometeorites,
ambaci	remember
lmh@shakes.caltech.edu	html>
MS-Windows?	MS-Windows?
gode!	Thank you!
Joshuaf	Joshuaf
Me?	Why?
23:17:25	23:17:25
halaka.	destruction.
..:.&#39;	..:. &#39;
Cl056@cleveland.Freenet.Edu	html>
gode.	Thank you.
gode,	Thank you,
[saka	[Insert
Yahudawa,	Jews,
ceto	saved
ziyarci	visit
Yahudawa.	Jews.
Great	Great
debating	debating
kwana?	days?
bayan-kashe	after-off
ruwan	water
Meg	Meg
ƙarni,	century,
astronomical	astronomical
cewa.	that.
cewa,	that
NHL	NHL
sattellite	sattellite
ƙafafunsa.	feet.
karfe	metal
cewa:	that:
Toronto	Toronto
karfi	strength
Florida.	Florida.
Mariners	Mariners
fuskanci	experience
Parsli	Parsli
Guthrie	Guthrie
Chronology.	Chronology.
Kristanci.	Christianity.
asiri.	mystery.
kari,	bonuses,
kari)	Extensions)
Windows	Windows
rukuni	group
uku&gt;	three &amp; gt;
ruwa.	water.
arcs,	arcs,
kwayoyin	bacteria
cliffs	cliffs
Williams	Williams
SMARTDRV.EXE	SMARTDRV.EXE
Greg,	Greg,
ofishin,	office,
^^^^^^^^^^^^^^^^^^^^^^^^^^^^^	^^^^^^^^^^^^^^^^^^^^^^^^^^^^^
ganganci.	intentionally.
knapsack	knapsack
gun.	gun.
km@cs.pitt.edu	html>
Kevin	Kevin
Phillip)	Phillip)
Man	Oil
percentages.	percentages.
fuska	screens
Wayar	Phone
adadi.	figure.
Dayton	Dayton
Mai	A
Hakika	Actually
wuyar	difficult
Mac	Mac
wuyan	neck
hutu	holiday
Yorker,	Yorker,
sulfuric	sulfuric
months)	months)
swirling	swirling
Impedance	Impedance
rubuce	written
kuzarin	energy
rls@uihepa.hep.uiuc.edu	html>
Faransa	France
cewa	that
guje	flight
fractured.	fractured.
kwance	lying
May	May
wanzu.	exist.
kidaya	count
wanzu,	exist,
ethan@cs.columbia.edu	html>
kadan	little
NET	NET
takamaiman	specific
jihohin	states
kwanan	recently
&#39;ya&#39;ya	Children
list	list
Waya:	Phone:
(Benedikt	(Benedikt
&#39;blue	Blue
irin.	type.
kadai	only
rumfa-tushen	virtual-based
spins	spins
karbi	received
fushi	angry
wuya,	hard,
--------------------------------------------------	--------------------------------------------------
cancanci	worthy
daidai	exactly
&gt;&gt;&gt;&gt;&gt;	&amp; Gt; &amp; gt; &amp; gt; &amp; gt; &amp; gt;
shack	shack
firearm.	firearm.
NOW	NOW
1975	1975
(Re:	(Re:
firearm?	firearm?
aikace.	application.
zaton	think
1977	1977
1979	1979
Catalog	Catalog
wasiya&quot;	testament &amp; quot;
Fisher)	Fisher)
buckling	buckling
C.O.D.	C.O.D.
cell	cell
lasafta	calculated
Masani,	Knowing,
_____________________________________________________________________	_____________________________________________________________________
-&gt;&gt;	- &amp; Gt; &amp; gt;
stacks	stacks
dafa,	cook,
1990	1990
alyoung@kiwi.ucs	alyoung@kiwi.ucs
dafa.	cook.
batun,	issue,
7,00.	7.00.
486/33	486/33
Dauka	Taken
Deimos.	Deimos.
sunansa.	name.
Amma	But
siyasa	political
unrivaled.	unrivaled.
kwangila	contract
reprehensible	reprehensible
nasarorin	achievements
cika,	filled,
motherboard.	motherboard.
Karamazov	Karamazov
qarami.	SMALL.
1991	1991
composing	composing
1992	1992
mafiya	most
zukatansu.	hearts.
Ganymede,	Ganymede,
1993	1993
1994	1994
LM350K.	LM350K.
NRA	NRA
1999	1999
|&gt;	| &amp; Gt;
motsi.	movement.
tsari	proposal
Yaya	How
mũnin	Misery
tsaro	security
tare.	with.
Annabãwa	Prophets
ZENON	Zeno
kasance?	be?
Note	Note
kifi	fish
tsara	designed
skateboard	skateboard
shaft	shaft
tsare	guard
wani&gt;	a &amp; gt;
co-ordinates	co-ordinates
Alicea,	Alice,
iskõki	Winds
3:31	3:31
shafa	affected
sarrafa,	manager,
tuki.	driving.
&lt;1993Apr22.153000.1@vms.ocom.okstate.edu&gt;&gt;	&amp; Lt; 1993Apr22.153000.1@vms.ocom.okstate.edu&amp;gt; &amp; gt;
kasance.	.
shafi	Related
kasance,	,
Koyi	Learn
shafe	eliminated
haƙiƙa	actually
------------------------------------------	------------------------------------------
(360	(360
(baya)	(Back)
samuwa	available
MacRae	MacRae
sana&#39;a,	professional,
zunubanmu	sins
&#39;doping&#39;	&#39;Doping&#39;
Mix	Mix
tuki?	driving?
bombarded	bombarded
ordering	ordering
tafasa	Boil
baya)	back)
sassauta	lower
baya,	later,
baya.	back.
kida	music
lafiya	Health
gorges,	gorges,
extrapolation	extrapolation
guda	single
(HAU)	(NIV)
&lt;thomasp@ifi.uio.no&gt;	&amp; Lt; thomasp@ifi.uio.no&amp;gt;
quality?	quality?
mu,	We,
matattu	dead
shaho	ODDS
mu.	us.
fita,	out
hedkwatarsu	center
carl_f_hoffman@cup.portal.com	html>
Kowa	Everyone
jodfishe@silver.ucs.indiana.edu	html>
shapiro@sofbas.enet.dec.com	html>
gudu	run
mu?	we?
batun.	issue.
Allaha	Resting
&lt;1993Apr16.173252.7393@asd.com&gt;,	&amp; Lt; 1993Apr16.173252.7393@asd.com&amp;gt ;,
(yamma	(West
extrapolating	extrapolating
thriving	thriving
Tilastawa	Force
bice&gt;	extinguish &amp; gt;
sama.&gt;	above. &amp; gt;
muni,	worse,
bushe	dry
bayar	provided
muni.	worse.
Kawaguchi,	Cresswell,
haihuwa.	old.
bayan	after
tabbatarwa,	maintenance,
....&gt;	--- &amp; Gt;
yadudduka	layers
sãmu	found
photochemistry	photochemistry
-----------------------------	-----------------------------
(Larry	(Larry
Steve.	Steve.
mun	we
theist,	theist
riƙe	hold
kadan.	little.
slegge@kean.ucs.mun.ca	html>
riƙi	taken
sãme	found
NASA	NASA
linzamin	mouse
justifications	justifications
tawagar,	team,
tawagar.	team.
Allah,	Allah,
ɗaya,	one,
Allah.	God.
hey,	hey,
rahotannin	reports
(wani	(A
aikatawa	do
makiya	enemies
Brooklyn,	Brooklyn,
shari&#39;a	Justice
flowed	flowed
Uranian	Uranian
Ctrl-Alt-Del	Ctrl-Alt-Del
1200-1500.	1200-1500.
Ɗari	Av
mace,	female,
Mun	We
cece	save
wadanda	those
(323	(323
tsaga	split
high-gudu	high-speed
yanzu-yanzu&gt;	Momentary &amp; gt;
ceci	save
cũta&quot;.	disease &amp; quot ;.
Tattaunawa	Discussion
shugabannin	leaders
Kou)	Kou)
acid.	acid.
Ariel,	Ariel,
netters,	netters,
====================================	====================================
tsagi	groove
Duniya	World
Amsa	Answer
tsage	rent
Steven	Steven
sammai,	heavens
&lt;wnk.734824081@aquifer.geology.uiuc.edu&gt;,	&amp; Lt; wnk.734824081@aquifer.geology.uiuc.edu&amp;gt ;,
tarin	collection
ɗebe	minus
theists	theists
culmination	culmination
5,25	5.25
Nicji,	Nicji
Cewa	That
-dk	-dk
fãsiƙai	perverse
nisa-jẽfa	far-flung
tabbatar	confirmed
KRISTI&#39;S	CHRIST&#39;S
tebur.	table.
version	version
;-).	;-).
ubiquitous	ubiquitous
mil	miles
labeled	labeled
Ƙarƙashin	Under
yanzu?	now?
taba	never
baturi	battery
(818)	(818)
tarko	trap
qara	increases
batura	batteries
[shi	[
yanzu,	now,
...&quot;	... &amp; Quot;
yanzu)	now)
tabo	spot
Kor.	Kor.
yanzu.	now.
tace	filter
kila	Maybe
Qasa.	Earth.
lafiya&gt;	Health &amp; gt;
kadai.	alone.
rubutu	text
martin	martin
dacewar	relevance
rubuta	write
&#39;Magnetic	Magnetic
Gravitational	Gravitational
rubuta:	wrote:
1947	1947
1949	1949
Babur	Motorcycle
Sa&#39;an	And
takardar	paper
haƙĩƙa	certainly
Aikace-aikacen	Applications
Mr.	Mr.
kilo	kilo
rubuta.	written.
rubuta,	write,
Technology	Technology
cẽto	intercession
1959	1959
yadda&gt;	&amp; gt;
darajar).	value).
Mummunan	Negative
share	share
denser	denser
gunkin	image
Barry	Barry
jelly	jelly
INFJ	INFJ
reparented,	reparented
Mai-Tsarki&gt;	Bible &amp; gt;
===========================	===========================
takarda:	paper:
haukan	Mentality
kika	you
1969	1969
kotun.&#39;	Court.
1962	1962
1964	1964
[Yesu]	[Jesus]
sarrafawa	Logistics
(wasu	(Some
jihãdi	strive
fadin.	across.
(Ray	(Ray
INF)	Inf)
tafi	go
(310	(310
-----------------&gt;&quot;	----------------- &amp; Gt; &amp; quot;
