XR650L	XR650L
(إريك	(Erik
واحد؟!؟	daya?!?
القمة.	saman.
535	535
وجدت،	samu,
سطح	Surface
تم العثور عليها.	samu.
طائرة نفاثة	jet
#	#
على &amp; quot؛ إثبات تنسيق	&quot;hujja-Tsara
مجرم	laifuffuka
المستوى.	matakin.
جيمس	James
$	$
٪	%
*	*
جوا	airlifted
+	+
(جون	(Jon
(	(
)	)
.	.
بما فيه الكفاية!	isa!
فريق	Team
/	/
،	,
-	-
بما فيه الكفاية.	isa.
3	3
2	2
عودة	dawo
1	1
7	7
6	6
5	5
4	4
مقهى	cafe
:	:
9	9
رجعي	retrograde
8	8
العلامة &amp; lt؛ 94318@hydra.gatech.EDU&amp;gt.	&lt;94318@hydra.gatech.EDU&gt;
=	=
أخرق	Gauche
D	D
E	E
القائمة.	tushen.
F	F
SetWUTime	SetWUTime
مقرها،	tushen,
@	@
عمالقة	Kattai
A	A
B	B
. الوقت ومثل؛	lokaci.&quot;
اسرعت	sped
C	C
L	L
M	M
الحسابات	MATATTU
H	H
أنا	I
J	J
العلاقات	Dangantaka
U	U
تي	T
نحن	muka
وكالة	hukumar
(713)	(713)
Q	Q
S	S
السلطانيات	daruna
\	\
_	_
^	^
منطقة	yankinka
X	X
1846	1846
html>	mmm@cup.portal.com
ز	g
د	d
فبراير	Feb
ه	e
الأسئلة:	Tambayoyi:
في	a
واحد	daya
حل	bayani
المقرر	slated
العلامة &amp; lt؛ 1r10jcINNt1g@lynx.unm.edu&amp;gt.	&lt;1r10jcINNt1g@lynx.unm.edu&gt;
حزم ومثل؛	kunshe-kunshe&quot;
س	o
م	m
شتيرن.	tsananin.
ح	h
ط	i
ث	w
حقيقي	hakikanin
520	520
ص	p
Optilink!	Optilink!
نقل	isar
~	~
|	|
على &amp; quot؛ إعادة تظهر على &amp; quot؛؟	&quot;Re-bayyana?&quot;
&#39;I	&#39;Ina
س	x
جليد	kankara
قراءة،	karanta,
(KJV)	(KJV)
خطى	zambiyõyin
(بما في ذلك	(ciki
عدوانية	agressive
تملكها.	mallakar.
ميلنك)	Melnick)
تحديث	updated
في عالم	Duniya-a
JPEG،	JPEG,
فصول	azuzuwan
html>	ocom.okstate.edu
580	580
آدم	Adam
يتوازى	paralleled
الهيليوم،	helium,
ابتدائي	firamare
القفز	tsalle
أسئلة وأجوبة.	FAQ.
منزل	Gida
الدعاية.	farfaganda.
الهيليوم.	helium.
التعليمات	FAQ,
(عذرا	(sorry
على &amp; quot؛	&quot;yi
قيود	hadar
(بما في ذلك	(haɗa
التحديث	update
يحتوي على	ƙunshi
خلق	Halitta
العاملين	Ma&#39;aikatan
البحار.	tekuna.
(__)	(__)
بلد	Kasar
&#39;&#39;	&#39;yan&#39;
وجدت]	samu]
على &amp; quot؛ نحن	&quot;mun
الأسباب:	dalilai:
(هذا	(Wannan
XBell	XBell
DO.	YI.
صلة	dangane
وصول	samun
محاولة	Yunkurin
سكر	Sugar
LPT1	lpt1
العقاب).	azaba.)
خشب التنوب	Fir
3	3rd
شكر	Godiya
pgf@srl02.cacs.usl.edu|Like	pgf@srl02.cacs.usl.edu|Like
تقسيم	Division
صالح	Fit
الأسباب.	dalilai.
ديني	addini
عقيدة خاطئة؟	karya-koyaswa?
TASCO	Tasco
DR250ES	DR250ES
على &amp; quot؛	&quot;ko
في المئة	Kashi
vesterman.	vesterman.
كاف	ishe
إعادة تعريف	redefined
وطن؛ &amp; GT؛	&gt;&gt;
وظائف.	jobs.
أخبار المؤتمر	labarai-taron
نفسها.	kanta.
الخبز.	burodi.
ميلا)	miles)
العلامة &amp; lt؛ C51nLs.7As@boi.hp.com&amp;gt،،	&lt;C51nLs.7As@boi.hp.com&gt;,
بلا ضجة	noiseless
هذا ومثل؛	cewa&quot;
تذهب،	tafi,
Detriot،	Detriot,
م أحمر	m-ja
التشفير	cryptography
المذنبات	comets
الذهاب	faruwa
رصدت.	hange.
وGT.	masu&gt;
مكافحة بندقية	zanga-gun
يتجمد،	freezes,
مثلج	frosted
المسألة.	tambayar.
رفض.	kãfirta.
المنتجات.	samfurori.
الإنترنت	Intanet
منذ &quot;	tun&#39;
تذهب؟	tafi?
شتاء	hunturu
الإنترنت:	internet:
التجارة،	ciniki,
(بليز	(Blaise
010-A	010-A
مثليون جنسيا،	luwadi,
ثورة	Juyin
الأنبياء.	Annabawa.
4H7	4H7
الأنبياء،	Annabawa,
على &amp; quot؛ حقيقية ومثل؛ &amp; GT؛	&quot;hakikanin&quot;&gt;
مثل	Irin
النرويج	Norway
على &amp; quot؛ أحمر	&quot;ja
وراء الخبر	indepth
النرويج):	Norway):
جبل	dutsen
الاجتماعات &amp; GT؛	tarurruka&gt;
خوارزميات	Algorithms
HOME.	GIDA.
يشعر	jin
المعلومات.	bayanai.
المعلومات،	bayanai,
دوغلاس	Douglas
المثلية	Liwadi
نبتون	Neptune
تويوتا،	Toyota,
يمكنك نقل	tranfer
50.	50.
50	50,
DOUBLE_BUFFER	DOUBLE_BUFFER
وجود	ciwon
500	500
--------------------------------------------	--------------------------------------------
الشروط	yanayi
نحن	muke
غروب	opti
00:26	12:26
المماس	tangent
جيدة ومثل؛	kyau&quot;
ماريا،	maria,
إدموند	Edmond
على &amp; quot؛ &amp; مثل؛	&quot;kai&quot;
على &amp; quot؛	&quot;mu
على &amp; quot؛	&quot;na
مطلوب	bukata
الشعر ومثل؛	gashi&quot;
الكثبان الرملية.	dunes.
الألوان	launuka
أسوأ	muni
5.7	5.7
accusors.	accusors.
الحب	LOVE
محادثات	tattaunawa
شتاين)	Stein)
ضائع	hasãrar
النيازك.	meteoroids.
5.0	5.0
الفيضانات	ambaliya
1870	1870
نحن	muna
عصابة	zobe
متلازمة)	ciwo)
الذئاب	Wolves
العلامة &amp; lt؛ 1r9j33$4g8@hsdndev.harvard.edu&amp;gt،،	&lt;1r9j33$4g8@hsdndev.harvard.edu&gt;,
2000	2,000
^^^^^^^^^^^^^^^^^^^^^^^^^^^^^^^^^^^^^^^^^^^^^^^^^^	^^^^^^^^^^^^^^^^^^^^^^^^^^^^^^^^^^^^^^^^^^^^^^^^^^
تأصيل	rooting
البرد.	huce.
غرامة الحبيبات	m-grained
763-5889	763-5889
أعلى	saman
قهري	tursasawa
84 سنة	84-shekara
الصيف	bazara
كل وGT.	duk&gt;
الإنتاج	samar
الحكم.	mulkin.
html>	timmbake@mcl.ucsb.edu
نافذة	Window
على &amp; quot؛ كامل &amp; مثل؛	&quot;cika&quot;
Cyrix	Cyrix
القاعدة)	mulkin)
الثقة.	amana.
ألمانيا	Jamus
16-169	16-169
هو	ita
محظور	Katange
أعلاه)	sama)
شقيق	ɗan&#39;uwãna
1ff	1ff,
أعلاه،	sama,
أعلاه.	sama.
Cyric	Cyric
الهيليوم	helium
NUETZMAN	NUETZMAN
السماء؟	sama?
وظائف.	ayyuka.
جول	joules
المتصاعدة،	escalating,
FTP	FTP
ل&amp; GT؛	Domin&gt;
الآلهة.	gumakan.
الطبية ومثل؛	likita&quot;
العلامة &amp; lt؛ sl3b+@andrew.cmu.edu&amp;gt.	&lt;sl3b+@andrew.cmu.edu&gt;
د	ɗ
أيام	Kwana
منبثقة	Popup
صفقة	magance
قدم	gabatar
قرصة	tsunkule
هوندا	Honda
الظهر ومثل؛	Back&quot;
superencipherment	superencipherment
العلامة &amp; lt؛ 1rbn60$gs7@usenet.INS.CWRU.Edu&amp;gt.	&lt;1rbn60$gs7@usenet.INS.CWRU.Edu&gt;
جديد	sababbin
المجتمع،	al&#39;umma,
مثل	irin
شرائح.	chipset.
المجتمع)	al&#39;umma)
&quot;السمع	&#39;jin
منهم	musu
الصحة	kiwon
الله.	bautawarku.
الضربات	naushe
(82178	(82,178
مختلفة،	daban-daban,
عالية،	Maɗaukaki,
أنفسهم.	kansu.
التكنولوجيا،	Technology,
ثواني.	seconds.
أنفسهم،	kansu,
الحفر	Craters
على &amp; quot؛ الخميرة	&quot;yisti
نحن	Muka
html>	noring@netcom.com
يموت	mutu
على &amp; quot؛ تطوير	&quot;Developing
688-8231	688-8231
نظام	Tsarin
الذكاء	tunaninka,
XXX	XXX
صدمت	gigice
شاحب،	kodadde,
html>	hays@ssd.intel.com
نفاية	vata
...........	...........
النظم الفرعية	subsystems
الوجود	wanzu
نحن	Muna
علامة تجارية	iri
ضوء	haske
كاف	isa
الكتب،	littattafai,
تساي)	Tsai)
العلامة &amp; lt؛ _Atheism:	&lt;_Atheism:
بفضل!	Godiya!
iconified).	iconified).
مبكرة.	karye.
الميثان	methane
سفن	jiragen
كمبيوتر	kwamfuta
الفكرة،	ra&#39;ayin,
بق	kwaro
11:25	11:25
نقاء	Tsarki
المجتمع:	al&#39;umma:
العلاج،	magani,
أنا	inã
(604)	(604)
الانبعاثات.	watsi.
العلاج.	magani.
الفكرة؟	ra&#39;ayin?
الحشرات	kwari
الجاذبية	gravitational
عملاق	giant
تقليدي	gargajiya
يسوع المسيح	Almasihu
فلسطيني	Palasdinawa
رئيس	Shugaba
ساعي &amp; GT؛	Fe&gt;
(تقريبا	(Kusan
الحياة،	rãyuwar,
سبب	Dalilin
باور	PowerPC
الحق.	hakkin.
السكان.	yawan.
النيتروجين،	nitrogen,
الأوراق؟	paperwork?
النيتروجين.	nitrogen.
(سكيلتون	(SKELTON,
العلامة &amp; lt؛ rauser.734062608@sfu.ca&amp;gt.	&lt;rauser.734062608@sfu.ca&gt;
المقاطعات.	interrupts.
كروفورد)	Crawford)
southeners	southeners,
AUTOEXEC.BAT	autoexec.bat
============ صدى	============ECHO
العلاقات	dangantaka
ولم يضف	premade
متطور	ɓullo
مناقشة،	tattaunawa,
. ومثل؛	nan.&quot;
مناقشة.	tattaunawa.
مصر	Misira
نعتقد	gaskata
نهج	kusanci
الألوان.	launuka.
معاول،	cokula,
أيام	kwana
وضع	jeri
نكتة.	wargi.
وكالة الطاقة النووية.	NEA.
المقاومين	resisters
مرور	nassi
صف	jere
إلغاء	soke
المدرجة	jera
بحث	caje
الدين و GT.	addini&gt;
html>	jaskew@spam.maths.adelaide.edu
بحث	caji
يعني،	nufin,
علبة	iya
كلينت	Clint
التقنيات،	Technologies,
الهوكي	Hockey
باختصار؟	gajeren?
كتب:	littattafan:
الأردن	Jordan
سقيفة	rumfa
فوق بنفسجي	ultraviolet
هم	sunã
بالضبط،	Daidai,
على &amp; quot؛ &amp; مثل؛ والمسيحية	&quot;Kirista&quot;,
مارتي،	Marty,
1770	1.770
نتاج	samfurin
كلمة	maganar
percieved	percieved
-391	-391
أشهر	&#39;watanni
هناك.	can.
جمعية خيرية.	sadaka.
كولومبيا	Columbia
عظيم	babba
الأصل	Original
شملتها الدراسة.	surveyed.
وظيفة.	post.
مكافحة الاحتكار	anti-dogara
آخر،	post,
متعة.	fun.
جولة	rangadin
قيامة	tashinsa
انحسار	matafã
والأمبير.	&amp;
html>	rscharfy@magnus.acs.ohio-state.edu
خطاب	magana,
الكلام.	magana.
هناك؟	can?
منتجع	mafaka
G20	G20
المسيح &amp; GT؛	Kristi&gt;
انتقال،	watsa,
النشرات الإخبارية	mujalloli
الإتصال و GT.	tuntube&gt;
السلطة،	ikon,
تكنولوجيا و GT.	Fasaha&gt;
مريح	daɗi
نسخة	kwafe
و	Suka
مقارن	kamanta
فيديو	bidiyo
(الأعلى	(saman
.4ID	.4ID
صالون	salon
أجواء	atmospheres
لويس	Louis
قذيفة	Shell
فرصة	Chance
الشمس!	Sun!
GOD	ALLAH
نيزك	meteoroid
الأحلام،	mafarkai,
حيث &amp; GT؛	inda&gt;
354-1333،	354-1333,
#:	#:
401	401
كارون	Charon
جملة	jimla
400	400
henling	henling
على &amp; quot؛	&quot;wadanda
قريب	kusa,
على &amp; quot؛ جديد	&quot;New
Cryptologia	Cryptologia
على &amp; quot؛ ^^^^^^^^^^^^^^^^^^^^^^^^^^^^^^^^	&quot;^^^^^^^^^^^^^^^^^^^^^^^^^^^^^^^^
1.610	1.610
كلام	kalmomi
عشوائي	bazuwar
نأمل؟	bege?
العربية	Larabci
170	170,
THEIR	MUSU
2	2nd
ربما	watakila
السفينة الفضائية	Kumbon
هي	suna
securital	securital
!!	!!
باب ومثل؛	kofa&quot;
نووي	nukiliya
خوادم	sabobin
توافق	yarda
الصلب.	karfe.
html>	artmel@well.sf.ca.us
(______	(______
شكل	siffar
كتاب	Littafi
************	************
ألفيس	Elvis
بقعة	suma
أن reponse	reponse
14-19	14-19
(كارل	(Karl
توافق،	yarda,
مارتن،	Martin,
الحفاظ	kiyaye
ترك	barin
نوافق على ذلك.	yarda.
العلامة &amp; lt؛ RVESTERM@vma.cc.nd.edu&amp;gt.	&lt;RVESTERM@vma.cc.nd.edu&gt;
html>	engp2008@nusvm.nus.sg
توافقون على ذلك؟	yarda?
كين	ken
SAVING	CETO
السعر	farashin
تأثير	rinjayar
مفتاح	key
35789	35.789
على &amp; quot؛ &amp; مثل؛	&quot;mu&quot;
مجلس	majalisan
القانون على &amp; quot؛	Attaura.&quot;
عدة وGT.	dama&gt;
خلية	tantanin
100 &amp; GT؛ &amp; GT؛	100&gt;&gt;
يورق	Leafs
قاموس	ƙamus
($	($
! dookie ومثل؛	dookie!&quot;
08:31	8:31
الاختبارات.	gwaje-gwaje.
مفاجأة	mamaki
بطانية	bargo
هم	suke
بوسطن	Boston
حكومة	gwamnatin
مواجهة	fuskantar
هم	suka
الناس &amp; GT؛	mutane&gt;
الشمس،	Sun,
الأغلبية.	rinjaye.
سلاح ناري	firearm
الهادئة المظهر	placid-neman
الشمس.	Sun.
إبليس	shaidan
فك تشفير	decrypt
مجرم	Laifuka
أعدت	Shirya
،	ke,
طويل	dogayen
البيتزا التغيير	pizza-canza
مستقر	barga
الشمس؛	Sun;
الشاهد	shaidar
عرض	nisa
[ستسن]	Stassen
تناثرت	barjat
سمعي	audio
هل	Suna
وGT.	ake&gt;
مضحك	funny
إصلاح.	gyara.
تلفيق	ƙiren
مشاهدات	sightings
قبل وGT.	kafin&gt;
الجميع.	kowa.
467	467
أجنبي	waje
- وطن.	-&gt;
الخطط.	schematics.
إذهب &amp; GT؛	tafi&gt;
عميق.	zurfi.
القوارض	rodents
المسبار	lander
حكم و GT.	Kiyãma&gt;
الشاهد	shaida,
الشاهد.	shaida.
الجدائل	ringlets
ذاتهما	themself
سائق	Driver
ملفات	Fayiloli
الشاهد)	shaida)
تنمية	bunkasa
(M	(m
**	**
نسخة	Kwafa
واي	Wai
سو،	Sue,
)	ku)
ضوئية	photochemical
ميلا).	mil).
برنامج	Shirin
ميلا)،	mil),
هواء	Iska
جونسون،	Johnson,
شراء	Purchase
أنواع.	iri.
+1	+1
++	++
نصف	rabin
على &amp; quot؛ تعزيز ومثل؛	&quot;gabatarwa&quot;
(A	(A
html>	phj@remus.rutgers.edu
احصائيات: &amp; GT؛ &amp; GT؛	stats:&gt;&gt;
*************************************	*************************************
look-	look-
plexiglassso	plexiglassso
4094	4.094
تمطر	¡uraishi
خوارزمية	algorithm
(2	(2
يوجد على نحو قانوني	lawfully
CSHOW	CSHOW
الكون.	samaniya.
نهائي	ƙarshe
(1	(1
الفحص.	jarrabawa.
حرب	War
(7	(7
في الواقع	zahiri
الفحص،	jarrabawa,
()	()
يكون	kasance
لهم.	cikinsu.
الكون،	samaniya,
(	(a
&quot;ريال مدريد&quot;	&#39;real&#39;
سحر	Magic
AH	hijira
هامش	fringes
(\	(\
أحداث	abubuwan
شمال	arewa
html>	ritley@uimrl7.mrl.uiuc.edu
على &amp; quot؛ البديل &amp; مثل؛	&quot;madadin&quot;
(I	(I
)	),
المذنبات	Cometary
حطام	tarkace
الآلهة	abũbuwan
Puryear	Puryear
ما	Menene
المكان.	wuri.
محضرات	preps
المتشددين	hardcore
..	..
html>	gonzaled@ucsu.Colorado.EDU
(Korenek@nmti.com)	(korenek@nmti.com)
ألتيما	Altima
أيام،	kwanaki,
ضرر	lalata
أيام)	kwanaki)
اتصال	lamba
عمل	dokar,
متحير	ruxani
تآكل،	eroded,
عصبة	league
أيام.	kwanaki.
//	//
على &amp; quot؛ لا	&quot;Babu
البنود	abubuwa,
العارضة	exhibiting
البنود.	abubuwa.
إذا وGT.	idan&gt;
البرامج.	shirye-shirye.
دراجة نارية	babur
كلمة	Kalmar
مكان	wurin
محتوى	Abun
html>	ge!severy%severy@uunet.UU.NET
MAX641،	MAX641,
[الجنرال	[Gen
تكتونية	tectonics
تشكيلة	iri-iri
مقاومة	impedance
بين	tsakanin
البريد الإلكتروني:	e-mail:
برودة	colder
توسع	faɗaɗa
تعليق	dakatar
إرجو	ergo
html>	ILV20078@UDELVM.UDEL.EDU
لكن	fãce
مثلي الجنس	Gay
المعايير	sharudda
451-0815	451-0815
دون جدوى.	banza.
غاضب	hushi
4.6	4.6
كريمر	Cramer
غاز	Gas
هضم	nike
-.	-.
Raste	raster
المناورة	maneuvering
مدة	duration
المجموعة.	kungiyar.
يصل ومثل؛	up&quot;
مجموعة،	kungiyar,
منتصف الصيف.	midsummer.
ابن	Ɗan
Kloo	Kloo
حرية	walwala
صلة	hadewa
استراحة بين الطبيب	karya-likita
الشخصية	sirri
namelplate	namelplate
المغرب	Morocco
35	35
A	Wata
هاتف	waya
لعبة شد الحبل من الحرب	Tug-na-yaki
البعض	ansu
3:	3:
العلامة &amp; lt؛ 1993Apr21.170403.22855@yang.earlham.edu&amp;gt.	&lt;1993Apr21.170403.22855@yang.earlham.edu&gt;
4.	4.
4،	4,
البعض	Wasu
42	42
40	40
الفلك.	jirgin.
(613)	(613)
2:	2:
(128.149.6.2)؛	(128.149.6.2);
المضادة	anti
22	22
سيفيري	severy
23	23
24	24
قبل احتساب	befor
الأخطاء.	kurakurai.
PowerBooks؟	PowerBooks?
25	25
رولاند	Rowland
دفع	tura
26	26
1W	1W
المتخصصين.	kwararru.
التخلص منها.	dashi.
3،	3,
تنقية	tsarkakewa
3.	3.
30	30
1M	1m
إيشي،	Ishii,
31	31
PowerBooks	PowerBooks,
الاحتباس الحراري،	greenhouse,
3)	3)
كاف	isasshe
19	19
1:	1:
الغرف	dakunan
17	17
مجنون	wawa
18	18
15	15
ما	Abin
16	16
13	13
14	14
11	11
12	12
21	21
20	20
حول	kimanin
2.	2.
أن	Lalle
2،	2,
هيمنت	mamaye
2)	2)
21-22:	21-22:
2٪	2%
البحر،	teku,
البحر.	teku.
عابر	wucewa
نافذة.	taga.
النافذة،	taga,
هلال	watã
html>	erikb@idt.unit.no
1.	1.
الأمراض ومثل؛	cututtuka&quot;
10	10
الوقت.	lokacin.
1)	1)
الوقت،	lokacin,
1٪	1%
مزود	maroƙi
منبوذة	unaccepted
سوارتز	Swartz
الإنجيل؟	Linjila?
7:	7:
كبريت	Sulfur
78	78
الغرب.	West.
طبع	Bugu
7329.	7.329.
prohipiting	prohipiting
(صحيح)،	(gaskiya),
المتوافقة معها	compatable
شجاع،	jarumi,
8،	8,
TO	ZUWA
دقيقة.	minutes.
حلوى من سكر أسمر وزبدة	butterscotch
(أي	(waxanda
6:	6:
قمري	Lunar
رسمي	hukuma
7)	7)
زور	zur
وقال: &amp; GT؛	ce:&gt;
!!!! &amp; قووت]؛	!!!!&quot;
7،	7,
أخطاء	kurakurai
ولدت	generated
70	70
72	72
فقدت!	rasa!
76	76
مودم	modem
نموذج	model
5:	5:
html>	martyj@uiuc.edu
Solomina)	Solomita)
56	56
التحديث	Update
رؤية	dũbi
55	55
5؟	5?
نظرة	dũba
6،	6,
عظيم	girma
أيها الإخوة،	&#39;yan&#39;uwa,
RIGO.	rigor.
12،00	12,00
عدد،	lambar,
السياق.	mahallin.
60	60
صهر	narke
جنوبي	kudancin
^^^^^^^^^^^^^^^^^^^^^^^^^^^^^^^^^^^	^^^^^^^^^^^^^^^^^^^^^^^^^^^^^^^^^^^
4:	4:
1980s.	1980s.
المخطط.	makirci.
4؟	4th?
العصابات.	makada.
دواسة،	feda,
______	______
التي	Wane
70000	70,000th
WW2	WW2
قطرة	maniyyi
5،	5,
عبر الاختيار	haye-duba
A	Wani
مجز	Clipper
النظام الفرعي	subsystem
شمال	Arewacin
PCX،	pcx,
5.	5.
توري:	Torre:
50	50
وصول	damar
(508)	(508)
لمعان	Sheen
عزام)	Azzam)
486	486
*************************************************	*************************************************
أن	lalle
99.86	99,86
الذكور، و GT.	namiji,&gt;
رعاية	kulawa
482	482
العلامة &amp; lt؛	&lt;a
الدول	kasashen
نتيجة لذلك،	sakamakon,
واللفتنانت؛ /	&lt;/
فعل	kar
في	kan
مدريد	Madrid
كوبونات	baucoci
رئيس	kai
تطبيقات	Aikace-aikace
تجارب	gwaje-gwajen
شوكولاتة	cakulan
Lankform	Lankform,
::	::
10:39:15	10:39:15
ملوث	gurbata
غبار	turɓaya
على الارض.	grounded.
فاسد	rududdugaggu
ربما	ƙila
ل	wani
أليس كذلك؟	dama?
:)	:)
الهيئات	gawawwaki
مصدر.	Madogararsa.
مصباح،	fitila,
.	ka.
html>	sbp002@acad.drake.edu
ارتكبت	kasanta
93	93
90	90
معلومات خاطئة.	misinformed.
،	ka,
متابعة	followup
[المسيحيين]	[Kiristoci]
حق	daman
==================================================	==================================================
88	88
الخطأ؟	azzãlumai?
شركة &amp; GT؛	kamfanin,&gt;
دورة	da&#39;ira
وGT.	ce&gt;
ال	wato
بدلا من ذلك	madadin
كاردون	Kardon
جمع القوانين و ينسقها	codify
. أعلاه على &amp; quot؛	Sama.&quot;
؟؟	??
الزاوية)	kusurwa)
هلال	Watã
ماكراي): &amp; GT؛ &amp; GT؛ &amp; GT؛	MacRae):&gt;&gt;&gt;
حادث مؤسف،	mishap,
صعوبة؟	wahala?
عالم الغيب	prescient
عدة	dama,
؟!	?!
ترجمة	fassara
الشركة المصنعة	manufacturer
وضعت أسفل	sa-saukar
وGT.	na&gt;
الابن.	dansa.
القمر.	Moon.
سابق	tsohon
علم	kimiyyar
الملقمات.	sabobin.
تقريبا	kusan
القمر،	Moon,
مئات	daruruwan
ليونغ،	Leong,
إضراب	dũka
خط الصدع-	laifi-line
من فضلك	faranta
الكثير	kuri&#39;a
X11	X11
(LGV	(LGV
لوحات	faranti
صعوبة.	wahala.
تحميل مجاني	Bure
صعوبة،	wahala,
(كين	(Ken
ل	For
الرسومات	graphics
إريك	Erik
html>	gt4417a@prism.gatech.EDU
لعب	wasa
WNI	WNI
البعض	wasu
خلق	halicce
فهرنهايت)	Fahrenheit)
إشاعة	jita-jita
ل	wata
الإنجيل	bishara
افتراضيا،	tsoho,
احترس	hattara
motherships	motherships
و	Da
الزبادي	yoghurt
لمحة	Glance
حاجة	bukatan
مقالة	labari
الإيثان	ethane
4.850	4,850
العمل؟	aiki?
معيار	daidaitattun
حاجة	bukatar
مساعدة	&#39;taimako
E.	E.
العملية،	aiki,
الأرض،	Land,
DE	DE
الدولة	jihar,
غلاطية	Galatiyawa
(Korenek@nmti.com) وGT؛ &amp; GT؛ &amp; GT؛	(korenek@nmti.com)&gt;&gt;&gt;
العمل.	aiki.
DH	DH
المواقع	shafukan
الدولة.	jihar.
أكل	Ci
الإنجيل	bisharar
بوريش &amp; GT؛	Bures&gt;
كاليفورنيا.	California.
virus..It	virus..It
340	340
الاطلاع	knowledgable
الإرهاب)	Ta&#39;addanci)
مدراء	manajoji
مسيحية	Kiristanci
فلسفة	falsafa
مصباح	fitilar
GE	GE
الحديد	Fe
ون تشنغ	Wen-Cheng
الخارجين عن القانون	outlaws
عظيم	babbar,
رحلات الفضاء	Spaceflight
طريق مسدود	mutu-karshen
ازدهار	wadãta
كتيبات	handbooks
المحيط.	tẽkun.
الوديان،	kwaruruka,
المحيط،	tẽkun,
IO.	IO.
G.	G.
FM	FM
IO،	IO,
أنفسنا	kanmu
FI	FI
HG	HG
مكان	Place
مركبات	mahadi
إلى	Ga
المنتج.	samfurin.
العلامة &amp; lt؛ C5t7Gs.7v3@news.iastate.edu&amp;gt.	&lt;C5t7Gs.7v3@news.iastate.edu&gt;
المسيح على &amp; quot؛	Almasihu.&quot;
أدرجت	Incorporated
IP:	IP:
نسبيا،	proportionally,
763-2626	763-2626
عربي	Larabawa
بحر	teku
هم	suKe
الناس ومثل؛؟	mutane?&quot;
GP	GP
GO	GO
H.	H.
GM	GM
الجلد)	fata)
(بول	(Paul
توصيات المؤتمر	recomendations
غريب الاطوار	oddball
فولت	volts
نظم،	Systems,
itself_	itself_
الجنس.	jima&#39;i.
المرتبات الثانية	Secondaries
الهدف	manufa
ركوب	hau
05:17	5:17
الجنس)	jima&#39;i)
jusgement	jusgement
أورت	Oort
فوق	har
رحلة بحرية	cruise
على &amp; quot؛ دان	&quot;Ɗan
كيف	yaya
تكافح	fafitikar
عملاق	Titan
ملتوياتي	spirochetal,
كيف	Yadda
جونسون آند جي تي؛	Johnson,&gt;
1930،	1930,
العروض	yayi
A.	A.
====================================== وطن.	======================================&gt;
AT	AT
300	300
ابن	ɗan
ولدت الشمس	rana-generated
فوائد	amfãni
BA	BA
مقدمة	gabatarwar
30٪	30%
عندما وGT.	lokacin&gt;
III	III
AM	AM
B.	B.
السويد	Sweden
30،	30,
مرحبا،	Hi,
IMMMMMMMMMMMMMMMMMMMMMMMMMMMMMMMMMMMMMMMMMMMMMMMMMMMMMMMMMMM.	IMMMMMMMMMMMMMMMMMMMMMMMMMMMMMMMMMMMMMMMMMMMMMMMMMMMMMMMMMMM.
AN	AN
BV	BV
C:	C:
الإطار،	frame,
العلامة &amp; lt؛ C5qsBF.IEK@ms.uky.edu&amp;gt.	&lt;C5qsBF.IEK@ms.uky.edu&gt;
AS	As
ليس	Ba
CA	CA
حب	ƙaunar
BF	BF
عمل	aikin
BI	BI
خارج الأرض	Extraterrestrial
BC	BC
إعلان	Ad
قبل.	wuce.
ل	An
منذ	wuce,
(2147	(2,147
C	C,
C.	C.
شركة	Al
3.0	3.0
بواسطة	By
3.1	3.1
إيستوود	Eastwood
3.8	3.8
الفضاء	sarari
DB	DB
و	DA
الآن	yanzu
الترويج.	gabatarwa.
3.5	3.5
سوف	zai
. &#39;الله على &amp; quot؛	&#39;Allah.&quot;
جوبيتري	Jovian
أنا	zan
القرص المضغوط	CD
نفسك	kanka
D.	D.
غرفة	dakin
أنت	Ku
!!)	!!)
(عبرانيين	(Ibraniyawa
الأسد	Assad
IDE	IDE
!!!	!!!
M.	M.
قديم	haihuwa
أو	Ko
التوأم	Twin
مهلا	hey
(NASA	(NASA
متهالكة	cratered
تعاون	gwiwa
ويسكي	wuski
ليونارد	Leonard
LITTLE	LITTLE
مقيد	ɗaure
MD	MD
MB	MB
الأنهار	kõguna
صغيرة،	kananan,
وGT.	da&gt;
162	162,
إعادة صياغة	reformatting
شروط.	yanayi.
N.	N.
الشروط	yanayi,
Gilkey	Gilkey
لوحة المفاتيح،	keyboard,
DEEP	SOSAI
MS	MS
لماذا	Me
. الخير ومثل؛	kirki.&quot;
تكثف	sandare
NI	NI
عبادة	bauta
مجاري الأنهار	riverbeds
NA	NA
html>	dlb@fanny.wash.inmet.com
NE	NE
الشريط.	tef.
لي	My
نحن	Mu
الالكترونيات،	Electronics,
لوطي	Homo
---------------------------	---------------------------
سوف	Zai
NO	NO
أنا	Zan
العلامة &amp; lt؛ ekdfc.14.0@ttacs1.ttu.edu&amp;gt،،	&lt;ekdfc.14.0@ttacs1.ttu.edu&gt;,
P.	P.
(6200	(6,200
ON	ON
لي	Ni
عروس	amaryar
هل	Ne
(على &amp; quot؛ السهول	(&quot;sararan
متعددة	Multi-da
أنا	Na
تأتي،	zo,
لوحة،	farantin,
نجمة	star
P5 +	P5
OP	OP
حالة	yanayin
html>	lei@rtsg.mot.com
حسنا	Ok
في	On
(ون تشنغ	(Wen-Cheng
يا	Oh
كبريت	sulfur
رفض	musun
السلطة الفلسطينية	PA
برميل	PB
PC	PC
الزائفة	pseudo-
I،	I,
الانترنت.	yanar-gizo.
الوسطى،	tsakiya,
خلق	kirkiro
مسألة	al&#39;amari
بارنجر	Barringer
مؤقت	wucin
لأنه،	domin,
(إذا	(idan
يانكي	Yankee
معالجة	jawabi
نيزك.	meteor.
النيازك	meteorites
ضرب	hit
الهوية	ID
إلى:	domin:
IF	IF
II	II
html>	nuet_ke@pts.mot.com
توم &amp; GT؛	Tom&gt;
مرحبا	Hi
J.	J.
آمال	fatan
IN	IN
الدجال	quack
IO	IO
بشرة	fatar
IT	IT
تغيير	canza
html>	dh782@cleveland.Freenet.Edu
ستيريو	sitiriyo
النادي.	Club.
لهم،	musu,
PLEASE	PLEASE
مع الأخذ	ɗaukar
محترف	sana&#39;a
هرتز	Hz
شبكة	Network
EGALON)	EGALON)
العربية،	Larabawa,
على &amp; quot؛)،	&quot;),
التشغيل للطاحونة &amp; GT؛	gudu-na-da-niƙa&gt;
مسيحي	christian
أنا	In
مساعدة	taimake
الثناء	flexing
معلومات خاطئة	misinformation
بركاني	volcanic
مساعدة	taimaka
JT	JT
التحقق من صحة	validating
وسط	tsakiyar
نيزك.	meteorite.
الشهب	meteors
(Hamaza	(Hamaza
IBM	IBM
المكونات.	yayan.
مساعدة	taimako
html>	st1ge@Elroy.UH.EDU
تويوتا	Toyota
لاأخلاقي	promiscuous
(جوزيف	(Joseph
OR	KO
خريطة	taswira
L.	L.
الصمام	jagoranci
ك	your
قصف	bombardment
هال	Hal
ID.	ID.
أنت	Ka
الناريدة واحدة من حوريات البحر	Nereid
LH	LH
عام 1938،	1938,
علم	Kimiyya
فوق	Har
أجمة	ƙunci
FROMTHEDEAD:	FROMTHEDEAD:
أفريقيا	Afirka
يضيء،	haskakawa,
دوامة	swirl
stephen.guerke@mvs.udel.edu	stephen.guerke@mvs.udel.edu~~V
العلامة &amp; lt؛ C5w5CB.Ct4@rahul.net&amp;gt،،	&lt;C5w5CB.Ct4@rahul.net&gt;,
VL	VL
W.	W.
منعطف	juya
تأمل	yayata
زعيم	jagoran
Lebannon.	Lebannon.
على &amp; quot؛ لل	&quot;Ga
عنوان	ashin
الصور	hotunan
diferential	diferential
يسوع ومثل؛	Yesu&quot;.
الأعمال.	kasuwanci.
تلميذ	almajiri
ثم	To
الرياضة	wasanni
مساهمة	shigar
بواسطة	Ta
شريك	abokiyar
على &amp; quot؛ هم	&quot;Bã
TX	TX
التلفزيون	TV
إلى	Su
مجلدات	Kundin
html>	wnk@aquifer.geology.uiuc.edu
هؤلاء	waɗannan
المقاعد	XT
تضارب	inconsistency
ثقة	dogara
نورتون	Norton
Landmann	Landmann
الصور.	hotuna.
منخفض &amp; GT؛	low&gt;
(المحمولة)	(Fir)
تغيير	canja
تغيير	canji
عرب؟	Larabawa?
احتكاك	gogayya
------------------------	------------------------
Jun&#39;ichiro	Jun&#39;ichiro
عرضة	dogaro
العرض.	gabatar.
عرب.	Larabawa.
كتل	tubalan
ما	Mene
فتح	Open
عمال النظام)	Sysops)
منذ	wuce
القانونية،	shari&#39;a,
الناس	mutane&#39;
باثفايندر &amp; GT؛ &amp; GT؛ &amp; GT؛	Pathfinder&gt;&gt;&gt;
S.	S.
يعقوب؟	Yakubu&#39;?
بندقية	Gun
يوم الأحد	Lahadi
تعيين	Saita
Folta)	Folta)
الفضاء.	sarari.
حرام	haramun
شخص	Guy
على &amp; quot؛ إعلان	&quot;wucin
علم	kimiya
(متنوع)	(daban-daban),
لياقة بدنية	dacewa
R.	R.
html>	alin@nyx.cs.du.edu
حالة	al&#39;amarin
(1.5 ميل)	(1.5-mil)
مضيف	rundunar
مبادئ	ka&#39;idodinta
هي	mãsu
نظري	ka&#39;idojin
حق	yancin
البرتقال.	lemu.
اليهودي	Bayahude
البق.	kwari.
جيدة ومثل؛	kirki&quot;
تعقيد	ganewar
TO	TO
ثورة	juyin
وقود	makãmashin
الفضاء	sararin
SS	SS
دموع	hawaye
السطح،	surface,
أعدت	tattali
ذقن	Chin
TA	TA
T)	T)
النزاهة.	mutunci.
SI	SI
السطح.	surface.
liscened	liscened
-120	-120
على &amp; quot؛ بندقية	&quot;bindiga
RR	RR
DH-مثل	DH-kamar
اللوائح.	ka&#39;idoji.
أرصدة	ma&#39;aunan
التجارب،	gwaje-gwajen,
على نحو مهلك	fatally
السلسلة.	Sarkar.
///////	///////
المسألة:	al&#39;amari:
html>	franjion@spot.colorado.edu
SA	SA
سائق &amp; GT؛	Driver&gt;
يهودي،	Bayahude,
على &amp; quot؛ علامة	&quot;alamar
O	Yã
من	​​daga
،	za,
عمالقة.	Refayawa.
موقع،	site,
(إيثان	(Etan
N3JXP	N3JXP
مائي	ruwa-ruwa
بيع	Sale
كوكبي	planetary
^)	^)
سيفيري	Severy
التلويح	waving
\\	\\
الأرجون	argon
CONFIG.SYS	CONFIG.SYS
=============================================	=============================================
سام.	Sam.
وGT.	zuwa&gt;
إطلاق	Saki
مثل السخان	geyser-kamar
غير متعاطف	unsympathetic
اختيار &amp; GT؛	zabi&gt;
الناس	mutãne
ثانية	Sake
مقاومة	jure
&quot;أبد	&#39;madawwama
،	a,
أ.	a.
__	__
كتلة	block
&quot;بالتأكيد	&#39;haƙiƙa
في!	a!
حياة	rayuwa
إذن	izinin
خط الاستواء	ekweita
MouseWare	MouseWare
html>	dbernard@clesun.Central.Sun.COM
تشرين الأول	Oktoba
.signature.	.signature.
هوتشيسون ومثل؛	Hutchison&quot;
منهم	cikinsu
فقر	talauci
أرسلت.	aiko.
حقيقي	ainihi
R &amp; GT؛	r&gt;
[2]	[2]
^^	^^
جون	Yahaya
حل	Bayani
عرض	umurni
بندقية	gun
3-8)، وGT.	3-8),&gt;
صحافة	Press
WILL	ZA
النار.	wuta.
-183	-183
استكشاف،	binciko,
382	382
العالم	halittu
إلى	Ya
حول	game,
النهضة،	Renaissance,
تاريخ	tarihi
كتاب	littafin
النهضة.	Renaissance.
بحث	Bincike
فعل	Yi
يقرر	tattare
جمع	tattara
-179	-179
كل	dukkan,
خلق	halitta
التعديلات.	sabawa.
نفسه	kanta
المنضب	tsautsayi
فئات *	catagories
مرة	Lokacin
إيطاليا،	Italiya,
(دوغلاس	(Douglas
المنطقة	yankinka,
375	375
DO	YI
الإفراج)	saki)
هل وGT.	Shin&gt;
$!	dala}!
آخر	juna
الحفر.	craters.
جدا	sosai
بقايا	remnants
نفسه	kansa
الماجستير	Masters
مرة أخرى،	sake,
[	[a
نانايمو،	Nanaimo,
المشجعين	magoya
360	360
أورانوس.	Uranus.
أورانوس،	Uranus,
من قبل،	rantsuwa,
ADC	Dogarin
هم	Sũ
أنفسهم	kansu
إسرائيل.	Isra&#39;ila.
المتلقي	karbar
عمق	zurfin
HRB	HRB
مليار	biliyan
وجدت	Samo
سوف	Za
سامس	Sams
APRIORI.	apriori.
على &amp; quot؛ الدجال ومثل؛	&quot;quack&quot;
كريس	Chris
\)	\)
سلبي	mummunan
\.	\.
حكم	¡iyãma
وGT.	ga&gt;
هاوية	abyss
JESUS	YESU
48؟)	48?)
K1Y	K1Y
رمي	jefa
أرض	Land
عرف	al&#39;adar
واقف	Tsaya
تخطى	tsallake
(	(nan
إلى	ga
العلامة &amp; lt؛ 1qksc2$2mr@fido.asd.sgi.com&amp;gt.	&lt;1qksc2$2mr@fido.asd.sgi.com&gt;
المخنثين	bisexual
احتفال	bikin
الحياة،	rayuwa,
ليس	bã
نوع	IRIN
JPL	JPL
أكثر	fi
الحياة.	rayuwa.
الساخن livered	zafi-livered
إيمان	bangaskiya
بول	Paul
العراق؟	Iraki?
203	203
سوط	bulala
200	200
علم	koyar
201	201
20:	20:
كان	dã
صربي	Serbian
الناس	mutane
لها.	ita.
جبل	Dutsen
html>	SLEGGE@kean.ucs.munc.ca
التقارير.	rahotannin.
إلى	Yin
20٪	20%
حريق	wutar
كاميرات	kyamarori
تطهير	tsarkake
الملايين	miliyoyin
أنت	cikinku
20-	20-
إذا	idan
20،	20,
دائم	zaunanniya
الأب،	Uba,
الأب.	Uba.
بيتا	Beta
ربما	yiwuwa
بواسطة	Rantsuwa
الآراء	ra&#39;ayoyin
على &amp; quot؛ ...	&quot;...
بتهور	recklessly
هناك	akwai
الدفاعات	thrusters
الواجهة؟	facade?
Aili	ailin
على &amp; quot؛ أنا أعرف	&quot;nasan
البنوك	Banks
مفتاح ومثل؛	key&quot;
21)	21)
حياة	rayuwar
Iftccu:	Iftccu:
21،	21,
مبتذل،	tacky,
من خلال	Hanyar
نظرة	look
إيمان	ĩmãni,
).	su).
نعتقد.	ĩmãni.
أنا	Ina
الوهمية وGT.	delusional&gt;
المتقدم	Advanced
هام	gagarumin
(الاتحاد الوطني للعمال التكنولوجيا	(UNT-Tech
زوجة،	matar,
إلى الوراء	bãya
أبولو	Apollo
2300	2,300
EN	en
بهجة	murna
Fraering)	Fraering)
الجدول الزمني.	jadawalin.
(لا يوجد	(babu
المراجع	nassoshi
يختفي،	vuya,
بواسطة	by
انتس)	Lantz)
(دوستويفسكي)	(Dostoevsky)
د،	d,
حزيران	Yuni
هيئة	jikin
(62 ميل)	(62-mile)
النقش	etching
(الموضوعية،	(objectivity,
تابع	bi
عيون	idanu
الفقراء،	talakawa,
1610،	1610,
و	da
العاديين.	talakawa.
احتشد	Teemu
؟	ya?
على &amp; quot؛ الهدف ومثل؛	&quot;haƙiƙa&quot;
(هل ل	(Shin,
ترجمة	fassarar
عادي:	talakawa:
(&amp; طن.	(da&gt;
موقع	wuri
أكل	ci
.	ya.
قال	ce
&#39;	&#39;mai
،	ya,
فارغة ومثل؛	blank&quot;.
XT350	XT350
html>	ab245@cleveland.Freenet.Edu
زمارة	Ihu
جمهور	Jama&#39;a
الموضوعات	batutuwa
إحصائيات	statistics
html>	geb@cs.pitt.edu
مراكز	cibiyoyin
خطاب	magana
علماء الفلك	falaki
جليد	ice
مسروق	sace
عمل	mataki
أدنى	ƙananan
``	``
العالم	halittu,
علاج	magani
تموز	Yuli
منطقيا	Azancin
متوسط	talakawan
على &amp; quot؛ العودة	&quot;mayar
حريق	wuta
ليس	ba
أعدت	tattalin
في	at
معتاد	saba
عين	ido
بنقلها	transfering
القانون،	Law,
ج:	c:
مواطن	National
html>	franjion@spot.Colorado.EDU
رفض	ƙaryata
ذاكرة	memory
معالجة	zalunta
ج.	c.
JKN	JKN
هاتف	Tarho
منظمة العفو الدولية	ai
اليوم	yau
ابنة	yar
يناير،	Janairu,
لا،	A&#39;a,
ل	an
الصورة	yan
[1]	[1]
نبوءات	annabce-annabce
فضح	bijirar
حقا	realy
استهداف!	manufa!
كاديلاك ومثل؛	Cadillac&quot;
كاليفورنيا	California
مطالبة	da&#39;awar
من	of
الهدف.	manufa.
تسليم	tsĩrar
عودة	mayar
في	on
الهدف،	manufa,
قضية	batun
html>	schuster@panix.com
هذا	Wannan
أكثر	yafi
النصوص	texts
بطيء	jinkirin
عرضي	wuccin
الجبلية الحجم	dutse-sized
بيلاطس	Bilatus
Lippard)	Lippard)
أو	kõ
I)،	ni),
إصلاحات،	gyare-gyare,
هيئة	Jiki
المؤسسة العامة	pe
على &amp; quot؛	&quot;Na
كمبيوتر	pc
رر	pl
العضوية	fledged
الامبير،	amps,
مساء	pm
أمبير.	amps.
تعليق	comment
محطات،	tashoshin,
إشعاع	radiation
الأعضاء	Member
html>	psyrobtw@ubvmsb.cc.buffalo.edu
يان	Yan
دوس.	dos.
myselfe	myselfe
الجسم.	jiki.
نيزك	meteor
على نحو واسع	yadu
اليوم	Yau
نقطة:	batu:
البرية،	daji,
على &amp; quot؛ I	&quot;Ni
ابنة	Yar
المبتدئين	novices
هدف	manufar
انتشار	yada
إلتهاب الجيب	sinusitis
أيضا	ma
ميغابايت	mb
الجسم،	jiki,
ثلاثة.	uku.
الحجم العالم	duniya-sized
إغلاق &amp; GT؛ &amp; GT؛	ƙulli,&gt;&gt;
لماذا	me
كما سبق.	Ditto.
نقطة،	batu,
العين،	ido,
مسير	Messier
46904	46904
شاحن	shipper
مرض التصلب العصبي المتعدد	ms
نحن	mu
الشوط	inning
متشابكة	garwaya
على &amp; quot؛ كاملة ومثل؛	&quot;kammala&quot;
حبر	tawada
أنا	na
غير	ne
سفر	tafiya
لي	ni
ص.	p.
أسلحة،	makamai,
فهرنهايت)،	Fahrenheit),
فكرة	ra&#39;ayin
خير	nagarta
هذه،	waɗannan,
فهرنهايت).	Fahrenheit).
المدارية	Orbiters
مدح	yabo
سكين	wuka
html>	mock@watt.support.Corp.Sun.COM
سكرتير خاص	P.S.
فاز	doke
السيارات	motoci
القانون	doka
مثل،	kama,
XQueryTree	XQueryTree
الجراحية،	m,
التويج،	Corollas,
كي	ki
)	yi)
لي).	ni.)
إلى	ke
.	yi.
أنا	ina
،	yi,
أنت	ka
حول	Kimanin
Bressler)	Bressler)
القدس	Urushalima
أنت	ku
؟	yi?
أو	ko
م.	m.
منزل	gida
Rubenfeld)	Rubenfeld)
فضفاض	sako-sako
المرتفعات	tsaunuka
على &amp; quot؛ الشمام ومثل؛	&quot;cantaloupe&quot;
منخفضة.	low.
على &amp; quot؛	&quot;mai
لغط	murmurs
معمودية	Baftisma
كما	kamar
قوة	iko
===========	===========
فاجع	catastrophic
المسبار،	Orbiter,
الرأي.	ra&#39;ayi.
كان متوقعا.	tsammani.
المتتبع.	Orbiter.
&#39;	da&#39;
مرحبا	hi
وطن؛ &amp; GT؛ &amp; GT؛؟	&gt;&gt;&gt;?
alt.psychology.personality!	alt.psychology.personality!
الصفحة.	shafi.
كل	Dukan
بلغت	amounted
رابطة القانون الدولي	ila
الرأي:	ra&#39;ayi:
إلى	yin
شاب	matasa
الرأي؟	ra&#39;ayi?
من ومثل؛	daga&quot;
html>	livesey@solntze.wpd.sgi.com
Xelion	Xelion
html>	rauser@sfu.ca
عفريت	puck
____	____
الافتراضي	tsoho
على &amp; quot؛	&quot;Ka
الموسيقى.	kida.
إلى أسفل.	down.
تنصل	disclaimer]
الدول	Kasashen
يجب	dole
في	in
اذهب	je
إبراء الذمة	disclaimers
أزرق	blue
سمع	ji
مشاهدة	kallon
مسودة	daftarin
تعهد،	jinginar,
أحمر	ja
شفاء	warkarwa
html>	COEGALON@LARC.NASA.GOV
شارما)	Sharma)
العلامة &amp; lt؛ الإيمان	&lt;imani
على &amp; quot؛ سمح &amp; مثل؛	&quot;yarda&quot;
الثقافة.	al&#39;adu.
YYY	YYY
المقاعد	xt
مسألة	Tambayata
مقعد	mazauni
تروندهايم	Trondheim
&#39;	&#39;yana
بووربووك	Powerbook
Schaufenbuel	Schaufenbuel
bading@cs.tu-	bading@cs.tu-
VV	vv
upperleft	upperleft
على &amp; quot؛ I	&quot;Zan
اتخذت	ɗauka
إلى	wa
حمل	ɗauke
اسمي،	sunana,
انتس	Lantz
html>	nodrog@hardy.u.washington.edu
العلامة &amp; lt؛ C4Hyou.1Iz@mentor.cc.purdue.edu&amp;gt.	&lt;C4Hyou.1Iz@mentor.cc.purdue.edu&gt;
سحب	Pull
مباراة	vs
معلمون	malaman
تأمين	inshora
النقل الجوي	airlift
ذلك،	cẽwa,
الجنس ومثل؛	jima&#39;i&quot;.
المكالمات	Kira
هواء	iska
موجة &quot;	kaɗawa&#39;
(جيمس	(James
11-15،	11-15,
غير	yana
وجود	kasancewar
(قبعات،	(huluna,
قالب	matrix
نحن	mũ
ديبورتيس	deportes
كينسلي	Kinsley
أجزاء،	sassa,
فوق	up
rethorical.	rethorical.
الحيوانات؟	dabbobi?
جزء	part
على &amp; quot؛ مينيسوتا	&quot;Minnesota
أنا	nĩ
إلى	to
ضد	v.
ISA.	ISA.
(ول	(bari
قصر	des,
سيفاس	Kefas,
من فضلك	roƙonka
ISA)	ISA)
(ماركوس	(Marcus
قصر)	des)
في الواقع،	gaskiya,
قبل أمبير &amp; GT؛	pre-amp&gt;
الشركة المصرية للاتصالات	te
غير	yake
صحيح.	gaskiya.
القشرة الأرضية	crustal
الحقيقة)	gaskiya)
عراك	yaki
بواسطة	ta
إلى	su
علامات	markings
إلغاء	sakewa
الرجال،	maza,
سر	asiri
SM	sm
الرجال.	maza.
ذكي	kaifin
ديلاوير،	Delaware,
الوصايا	so
إيرباص	hte
مضاعف	mahara
تكساس	Texas
تغيير.	canji.
عميق	zurfi
html>	brenner@ldgo.columbia.edu
ماركات	sa
الأخبار.	labarai.
تحديد،	gano,
التي تم تحديدها.	gano.
مشقوق	fashe
أنا	nã
ال	&#39;Yan
أشهر	watanni
تقليد	kwashe
نيريد،	Nereid,
بووربووك	powerbook
CHRISTIAN	Krista
نظام	System
على &amp; quot؛	&quot;da
يسوع المسيح	Kristi
المنافسة.	gasar.
لف	mirgina
-221	-221
يتدفقون	flocking
html>	bressler@iftccu.ca.boeing.com
إطالة	mikawa
رأس الجسر	bridgehead
مدن،	birane,
التحكم ومثل؛ &amp; GT؛	iko&quot;&gt;
متطلبات	bukatun
&#39;&#39;	&#39;&#39;
البنوك)	Banks)
مثمن ذو تماني زوايا و أضلاع	octagonal
سلاسل،	sarƙoƙi,
شمال ومثل؛	Arewa&quot;
رسائل	sakonni
الأنشطة	Ayyukan
تدور	orbiting
قسري	tilasta
السليكات	silicate
280	280
تقرير	rahoton
بروكس)	Brooks)
عربي	Arab
لقطات	yawo
يناير	Janairu
لا	bãbu
28:	28:
رؤية	gani,
يشاع	yayatawa
الناس	mutãnen
الإجابة: &amp; GT؛	amsa:&gt;
على &amp; quot؛ مكتب ومثل؛	&quot;Bure&quot;
كثير	yawa
27،	27,
NHL.	NHL.
الأنهار	koguna
قبيلة	kabilar
html>	engp2008@nusunix.nus.sg
html>	winfrvk@dutiws.twi.tudelft.nl
بندقية	bindiga
40-22k	40-22k
html>	willisw@willisw.ENG.CLEMSON.edu
أنظمة	Systems
أحذية رياضية	sneakers
على &amp; quot؛ O	&quot;Yã
محاكمة)	fitina)
propter	propter
ضاربا	hitter
583.	583.
Egalon	Egalon
سريع الحركة	azumi-motsi
سوف	zã
طبل على شكل	drum-dimbin
على &amp; quot؛ ما	&quot;Mene
ANTI-TRUST	zanga-TRUST
البنود	abubuwa
رؤية	ganin
بناء	gina
مشهور	shahara
واتس	Watts
بناء	gini
القراءة،	karatu,
تعاون	hadin
بولس:	Bulus:
29،	29,
من خلال	hanyar
الشعار	logo
العلامة &amp; lt؛ BADING.93Apr23105229@athene.cs.tu-berlin.de&amp;gt.	&lt;BADING.93Apr23105229@athene.cs.tu-berlin.de&gt;
talk.politics.guns	talk.politics.guns
المجموعات!	ƙungiyoyin!
التسوية	leveling
مدينة	City
(الذاكرة	(memory
من الصعب	wuya
درجات	darajõji,
لائحة	Jerin
قضيب.	sanda.
على &amp; quot؛	&quot;a,
html>	pubinfo.jpl.nasa.gov
حلزون	katantanwa
محاكمة.	fitina.
بارز	shahararren
وعد	wa&#39;adin
نهاية	Qarshen
24،	24,
رؤية و GT.	gani&gt;
html>	caltech.edu
سخاء	falalarSa
240	240
ثني	lankwasa
في الواقع،	haƙĩƙa,
القليل	little
جوهر	gist
الصباح،	safiya,
المعلم.	malami.
مجلة	Journal
جريح	raunata
اليوم.	yau.
243	243
مينغ)	Ming)
وصف	Prescribing
هايز)	Hays)
(5.25	(5.25
تديم	perpetuate
كلمة	kalmar
الطريقة:	hanya:
اليوم،	yau,
الطريقة.	hanya.
على &amp; quot؛ أكثر	&quot;mafi
تناوب	juyawa
24-بت	24-bit
الطريقة،	hanya,
الأطباء،	likitoci,
المتسوق)	Shopper)
ISA	ISA
مشرك	ummiyan
صبي	yaro
هم	sũ
kludgy	kludgy
العلامة &amp; lt؛ لا	&lt;basu
مباراة	ze
الأطفال	yara
إزهار	Bloom
سوف	za
مساعدة	taimakawa
على &amp; quot؛ &amp; MAGIC مثل؛ &amp; GT؛ &amp; GT؛	&quot;MAGIC&quot;&gt;&gt;
اليابان &amp; GT؛	Japan&gt;
(والتر	(Walter
جاء	zo
250	250
(Henling	(Henling,
J23	J23
لوحة	farantin
25،	25,
إلى	ya
*****	*****
الناس،	mutãne,
(	(mai
كلمة،	kalma,
متعرج.	Winding.
مشفرة	rufaffen
[&amp; قووت]؛ الناس	[&quot;Mutanen
أبيض	White
هذا	wannan
كل	dukansu,
html>	berlin.de
العلامة &amp; lt؛ 1r0vk6INNaft@cronkite.Central.Sun.COM&amp;gt.	&lt;1r0vk6INNaft@cronkite.Central.Sun.COM&gt;
فعل	yi
برينر	Brenner
GetGeometry	GetGeometry
لا شيء.	kõme.
Iaccoca	Iaccoca
المتسوق	Shopper
خطورة	muhimmancin
أخضر	kore
قالب	Matrix
أكثر	mafi
تأثير ومثل؛	sakamako&quot;
&#39;لا يوجد	&#39;Ba
المبادئ التوجيهية	jagororin
ميتسوبيشي	Mitsubishi
**************	**************
الهواة	amatuer
اللطخات	smudges
(فيل	(Phil
بقعة،	Spot,
كوميدي	comic
مستكشف	Pathfinder
قتل	kisan
الهيدروجين،	hydrogen,
الهيدروجين.	hydrogen.
هيروكي	Hiroki
اسم &amp; GT؛	sunan&gt;
التطبيق	App
من الصعب	Hard
أبريل	Apr
رياضة	Sport
موصى به	shawarar
شركة،	kamfanin,
رقاقة.	guntu.
عشاق نقية	Tsarki-masoya
متوقع	saran
ربما،	tabbas,
بووربووك)؟	PowerBook)?
العلامة &amp; lt؛ 1993Apr20.102756.1709@mala.bc.ca&amp;gt،،	&lt;1993Apr20.102756.1709@mala.bc.ca&gt;,
أوروبا	Turai
أخلاق	xa&#39;a
حجري	Stony
بدء،	fara,
floppy..BURN	floppy..BURN
النصيحة:	shawara:
(أي،	(watau,
فايس	Weiss
المشورة،	shawara,
دمرت	hallaka
الحقل،	filin,
المطور	developer
html>	hall@boi.hp.com
91٪	91%
html>	pharvey@quack.kfu.com
أكثر من ذلك.	fi.
أكثر	fi,
المشورة.	shawara.
احتراق	kona
الكرة السريعة	fastball
html>	lippard@skyblu.ccit.arizona.edu
(تقريبا)	(kusan)
زبيب)	Zbib)
2000	2000,
كراهية	ƙiyayya
تفاصيل	ƙayyadaddu
(GIF،	(GIF,
رسم	jawo
بريان	Brian
بإنشائه.	halitta.
الحدود	iyakar
الحواسيب الشخصية	sirri-kwamfuta
صقر	Hawk
جهاز	na&#39;ura
الاتصال:	lamba:
شمال	North
صاعقة	walƙiya
US &amp; مثل؛	Amurka&quot;
نقاط	maki
كبار السن	mazan
من أي وقت مضى،	abada,
فاكس	fax
المشاركة	Posting
عدد	lambar
حظ	luck
علاج	far
أسبوع	mako
مروحة	fan
974	974
ملخص	Summary
دولة	jihar
الأمراض.	cututtuka.
أنت	maka
(872	(872
عالم	duniya
مخزن	Store
PROOFOF ::::	PROOFOF::::
الأعمال العدائية	tashin
banschbach	banschbach
أمريكا الشمالية	Amerika
جونسون)	johnson)
الذري	atomic
موضوع،	thread,
مجلات	mags
خلق	halittar
هم	Sun
يهودي ومثل؛	Bayahude&quot;
(842	(842
حيث	Sharuddan
بريد	mail
140.	140.
تورونتو،	Toronto,
العدد.	lamba.
رئيسي	main
نيسان	Nissan
أوروبا	Europa
قبل أمبير	pre-amp
html>	billq@ms.uky.edu
HAD	KASANCE
الأب.	Uban.
صندوق	akwatin
هكذا	Haka
ظل	Shadow
الصيد	farauta
العنوان	Kanun
مختار	zaba
الدول	jihohi
استطلاع	zabe
664-6354	664-6354
مختار	zabi
الأرصاد الجوية	meteorology
وGT.	ba&gt;
، هذا	-This
توجيه	fuskantarwa
خيال	Fiction
وردد	echoed
رقائق	Kwakwalwan
الحد.	iyaka.
#From	#From
البخار.	tururi.
========	========
العينين.	idanuna.
جدا	ƙwarai
الاخوة	Brothers
الإنترنت:	Intanit:
frank@D012S658.uucp	frank@D012S658.uucp
الأساسية درجات الحرارة	core-zafin
الحق.	DMA.
كما هو	as-ne
Krsek)	Krsek)
أورانوس	Uranus
هالة	Halo
هوتشيسون	Hutchison
الإنترنت	yanar-gizo
كلمة	kalma
مطلوب	Bukata
فينوس	Venus
خطأ؟	kuskure?
1959،	1959,
09:31	9:31
Noring	Noring
استنفدت،	ƙãre,
جيد).	alhẽri).
خطأ،	kuskure,
خطأ.	kuskure.
التشفير &amp; GT؛	boye-boye&gt;
الأقل	kalla
أو دواير)	O&#39;Dwyer)
على &amp; quot؛ لوحات تحمل أسماء على &amp; quot؛	&quot;nameplates.&quot;
البعض	Sauran
=========================	=========================
كل شخص	kowa
1958،	1958,
اتصالات	lambobi
دولة	Jihar
مميزة،	rarrabe,
أبحث	kallo
تشكيل	forming
امرأة	mace
هانز	Hans
بوسطن؟	Boston?
النقاد	sukar
غفر	gafarta
html>	uu.net
تعليم و GT.	koyarwar&gt;
نعم	Na&#39;am
_CRAZY_؟	_CRAZY_?
أنا	Ban
التقنيات،	dabaru,
التقنيات.	dabaru.
تنويه!	Disclaimer!
على &amp; quot؛ دراجة نارية، ومثل؛	&quot;babur,&quot;
على &amp; quot؛ فاصل ومثل،،	&quot;Terminator&quot;,
94550	94550
أمن	jingina
Frmwrks	Frmwrks
وهلة ومثل؛	Glance&quot;
موسيقى	Kida
عظيم	Babbar
على &amp; quot؛ المعالجين ومثل؛	&quot;healers&quot;
متموج	rippled
الدوائر	haihuwarka
التشخيص؟	diagnoses?
غاليليو	Galileo
(317)	(317)
غاليلي	Galilei
تعلم	koya
[ذكر]	[namiji]
إخلاء المسئولية؟	Disclaimer?
نولز ومثل؛	Knowles&quot;
ديفيد.	David.
الرش،	airless,
تعلم	koyi
تعلم	koyo
عظيم	Babban
شاذ	aberrant
&quot;الشاهد&quot;.	&#39;shaida&#39;.
إحصائيات	Statistics
html>	punjabi@leland.Stanford.EDU
دراسة:	binciken:
مليون	miliyan
ضوء،	haske,
تعليق	sharhi
ضوء.	haske.
الأطباق.	jita-jita.
الدراسة.	binciken.
09:02:48	09:02:48
ياماكاوا،	Yamakawa,
وعود &amp; GT؛	alkawuran&gt;
اختبار	Gwada
واللفتنانت؛ هذا	&lt;Wannan
سهل	sauƙi
عشرون	ashirin
كلايتون	Clayton
الحقول.	filayen.
المشعة	rediyoaktif
SuperVGA	SuperVGA
فرط الحساسية	hypersensitivity
تعلم.	Koyi.
روث)	roth)
إسرائيل	Isra&#39;ila
سمور	somwhere,
أبو	Abu
صعوبة)	wuya,)
هو	Shi
مالاسبينا	Malaspina
العبرانيين]	Ibraniyawa],
زيارة	ziyara
V الإلكتروني:	V-Mail:
ضوء	hasken
على &amp; quot؛ الأبيض	&quot;fararen
النمط،	style,
وGT.	ya&gt;
تقنية،	dabara,
نسبيا	comparatively
e_mail:	e_mail:
كريغ	Craig
م كلمة	m-magana
لقاء	gamuwa
الذكر.	ambata.
سيدي	Sir
الكاتب	marubucin
متعلق بالمد والجزر	tidal
السلطة،	mulki,
VMS.	vms.
--------------------	--------------------
نساء	mata
BIOS	BIOS
الرتق،	darn,
حياة	rayuwarsu,
يكون	zama
بندقية النادي	bindiga-kulob
بيتر &amp; GT؛	Bitrus&gt;
الموثوقية	AMINCI
THE	THE
(من	(daga
الصلاة.	salla.
(كريس	(Chris
الأعضاء	memba
الأحداث	faru,
يشفق.	dski.
نطاق	kewayon
آلات	inji
البرتقالي	orange
ضوئية	photocell
حار	zafi
السياق	mahallin
البؤر الاستيطانية.	outposts.
جديد،	sabon,
sci.med	sci.med
(داريل	(Darryl
حكم	mulkin
اختتام	Kammalawa
vfintd.386	vfintd.386
أنت	Zaka
الرجال	maza
مكوورلد	Macworld
البتنت	Bitnet
على نطاق واسع.	faɗi.
دينينغ	Denning
تجاوز	overriding
::	&#39;::
بديل	maye
ناعم	wispy
devide	devide
بين	tsakaninka
حذف،	share,
----------------------------------------------	----------------------------------------------
عموما،	manyan,
حدث؟	faru?
حل،	warware,
كل	kowace
الأمثلة.	misalai.
sys.ini	sys.ini
الموالية للبندقية	pro-gun
السائقين،	direbobi,
الليل.	dare.
الأمثلة،	misalai,
كامل	cikasa
أن	wancan
حولها.	kewaye.
أعرف:	Sanin:
ريتشارد	Richard
TTL	TTL
المعلومات	info
شارع	St.
:-)	:-)
علماء الفلك	falakin
قبر	kabarin
تفاخر	boasted
أبيض	fari,
مهم	Muhimman
مولدات	janareto
البيانات وGT.	kalamai&gt;
أون،	en,
لي	mani
سيئة	sharri
بحث	bincike
لنا	mana
html>	oak.oakland.edu:pub/msdos/windows3/winjp210.zip
هواء	Air
الشاهد	Shaidar
وGT.	zai&gt;
بحث	bincika
ملاحة	kewayawa
الخ)	sauransu)
الارتفاع.	tashi.
المميزة	bayãnin
معونة	agaji
كويستا	Cuesta
نشاط	Activity
المظهر،	bayyanar,
طويل	dogon
حقيقة	Gaskiya
C.)	C.)
دودسون)	Dodson)
استكشاف	binciko
الإجابة.	amsar.
ترجمة	translation
ليل	daren
الأوراق المالية	jari
نجوم،	star,
نجوم.	star.
القيام به.	aikatãwa.
لا شيء	kome
مخادع	fallacious
عودة	koma
&#39;NF&#39;	&#39;NF&#39;
سوف	zasu
تدريس	Koyar
التوصيات.	shawarwari.
نزل	zaunar
أبيض	farin
العلامة &amp; lt؛ 188@ky3b.UUCP&amp;gt.	&lt;188@ky3b.UUCP&gt;
BMP	BMP
TSC	TSC
نزوة	zato
متعلق بالمد والجزر	Tidal
الحب &amp; GT؛	son&gt;
جيوتو	Giotto
مرتفعات	Heights
ينمو	tsiro
منزل	gidansa,
البراكين	volcanoes
مجانية.	freeware.
(وهناك	(akwai
جزء	bangare
الحياة،	rayuwata,
استخدام.	amfani.
بارتون)	Barton)
استيقظ	farka
تصميم	zane
ثلمة	daraja
عجلة	dabaran
استخدام،	amfani,
رسم	zana
له	masa
نجا	tsira
كل	All
ال	masu
نحن	zamu
باروديا	parody
أولا	farko
الجنوب الشرقي	maso
عامي	Ami
الأشكال،	Formats,
الأشكال.	Formats.
الجني:	Genie:
عالية السرعة	high-gudun
كل	kowane
تسجيل	rijista
ل	saboda
حطم	rafke
البريد الإلكتروني	E-mail
ديفيس)	Davis)
دائم؟	wanzuwa?
تحطم	Crash
لطيف	Nice
نظرية	ka&#39;idar
الشحن).	shipping).
الرسوم	zargin
C2.	C2.
محلول	Sol
هل	Ana
الترانزستور؟	transistor?
باب	kofa
1-301-340-4543	1-301-340-4543
إصلاح	gyara
فوائد	amfanin
حول	kewayen
().	().
مقاوم	resistive
الطبية وGT؛ &amp; GT؛	likita&gt;&gt;
مرة	lokaci
Alane	Alane
حيث	inda
(10-105	(10-105
مجمع &amp; GT؛	fili&gt;
العقبات،	cikas,
كل	dukkan
وطن؛ &amp; GT؛،	&gt;&gt;,
طريق	Road
نهر	kogi
ديلاوير	Delaware
سماوي	samaniya
الأطفال	&#39;ya&#39;yan
فنلندا	Finland
البريد الإلكتروني:	email:
755-8742	755-8742
محطة	tashar
البريد الإلكتروني.	email.
وطن؛ &amp; GT؛؟	&gt;&gt;?
جالانت،	Galant,
1970s.	1970s.
والبرامج	da-tsare
طبقة	Layer
&quot;الغيوم	&#39;girgije
غطاء،	cover,
وجود	wanzuwar
html>	jmilhoan@magnus.acs.ohio-state.edu
نقية،	Tsarki,
مصدر	Madogararsa
حوادث	bijiro
html>	gt7469a@prism.gatech.edu
توفي.	mutu.
1312	1312
أبيض	fararen
يموت،	mutu,
علم	kimiyya
الارتفاعات.	altitudes.
عائلة	mutãnensa
القانون ومثل؛	Attaura&quot;
درقي	thyroid
1949.	1949.
شراء	Buy
(	(zuwa
ارتفاع &amp; GT؛	high&gt;
جولييت.	Juliet.
خارج	fito
جيد &quot;	kyau&#39;
إعادة	Replay
(6)	(6)
الجامعة	Jami&#39;ar
وبطبيعة الحال،	shakka,
خارج	fita
(59	(59
أقواس	arcs
1948:	1948:
ADAPTEC	Adaptec
خاصة،	musamman,
قمصان،	shirts,
8.6	8.6
المزدوجة الحرارية	THERMOCOUPLE
GIF	gif
1948	1948,
لمدة عام	shekara-dogon
عربي	arab
(5)	(5)
يوم أمس،	jiya,
اجتماعات،	gamuwa,
Umbriel	Umbriel,
رجل	mutum
فحص	jarrabawa
فعال	tasiri
أمريكي	Amirka,
الأسود &amp; GT؛	.com&gt;
الكويكبات	Asteroids
الصفحة)	Page)
الحلم.	Mafarki.
(	(sunã
بارتون	Barton
القارة.	nahiyar.
استقبال	gaishe
(4)	(4)
Landmann &amp; GT؛	Landmann&gt;
الظلال.	tangents.
وجيز جدا	yanzu-yanzu
أيام	Kwanaki
هيدروجين	hydrogen
المؤامرات	mãkirci
الرب	Ubangijinku,
هارمان	Harman
(32	(32
كبيرة جدا	manya-manyan
إغلاق	abar
(3)	(3)
رو؟	Ru?
الانحراف	eccentricity
فارياتي	variaty
[26]	[26]
نظريات	theories
نهاية،	karshen,
على &amp; quot؛ الوردي	&quot;Pink
(27	(27
خارجي	matsanancin
معدن	ƙarfe
قوة	ƙarfi
المثال.	misali.
في بعض الأحيان،	lokatai,
وتقدر.	kiyasin.
على سبيل المثال،	misali,
(2)	(2)
انتعاش	maida
دفن،	binne,
ميراندا،	Miranda,
======================	======================
رائد	Majagaba
ميراندا.	Miranda.
مئوية	Celsius
82:	82:
(1)	(1)
النوافذ،	windows,
القوانين، وGT.	dokokin,&gt;
النوافذ.	windows.
(6118	(6,118
JPS &amp; GT؛	jps&gt;
غبار	turbaya
============================================	============================================
(745	(745
[23]	[23]
التجارة،	cinikayya,
رقص	Dancing
LaStrange)	LaStrange)
عوجا	karkata
التفاصيل.	daki-daki.
حارس مرمى	goaltender
الصور	hasashe
إصلاح.	fix.
[24]	[24]
مثال	misalin
إلكتروني	lantarki
المسيحيين	Kiristoci
شيوخ	dattawan
أرض	Ƙasã,
نقية.	Tsarki.
البقاء،	zauna,
[25]	[25]
سبت	zauna.
الذي،	wanda,
يرضى	kosad
العراق	Iraki
مكبرات الصوت	jawabai
مبادئ	ka&#39;idodin
حرف	wasika
القرار؟	ƙuduri?
على &amp; quot؛ بافل	&quot;Pavel
X11R4.	X11R4.
الشكر.	godiya.
html>	I3150101@dbstu1.rz.tu-bs.de
html>	jh6r@andrew.cmu.edu
تختلف	bambanta
خمسة	biyar
IBM؟	IBM?
جيمس،	James,
شكرا،	godiya,
بحث	nema
الطلاب،	dalibai,
تحذير	gargaɗi
و	Sai
بفضل!	godiya!
سام	Sam
سعى	nemi
كمبيوتر	kwamfutarka
بصمات	ragowar
Franjione)	Franjione)
كريمر)	Cramer)
(؟)	(?)
Triantafyllopoulos	Triantafyllopoulos
ومثل؛	kai&quot;
الوزن.	nauyi.
الوزن،	nauyi,
plutoneon	plutoneon,
غاز	gas
خلص	kammala
مثلي الجنس	gay
IBM.	IBM.
اليهود وGT.	Yahudawa&gt;
العلامة &amp; lt؛ id.XNFZ.VJ8@nmti.com&amp;gt.	&lt;id.XNFZ.VJ8@nmti.com&gt;
المجتمع ومثل،،	al&#39;umma&quot;,
رؤية	gan
أكثر	fiye
يدوي	hander
جيدة.	kyau.
فتحات،	ramummuka,
=====================================	=====================================
9،846	9,846
شارك	posted
خير	kyau,
hobbiest	hobbiest
النيكل.	nickel.
سفاح القربى	lalatar
(ريتشارد	(Richard
html>	c23st@kocrsv01.delcoelect.com
الأسيتيلين،	acetylene,
البعض &amp; GT؛	sauran&gt;
6X9	6x9
ألعاب،	wasannin,
المتلقي)	karɓar)
قاعدة،	tushe,
مرات	Sau
موجة	kaɗawa
الاستثناءات).	ware.)
أحدث	sabo-sabo
سان	San
(سكوت	(Scott
الموارد،	albarkatun,
عاصفة	hadiri
Q4	Q4ayata,
الترفيه.	liyãfa.
الاستثمار،	jari,
كنديينز	Canadiens
الملحقون	ɗora
الطقس،	weather,
اشتراك	biyan
الزواج،	aure,
الطقس.	weather.
جميل	kyaun
.	wa.
بطارية	batirin
خان	Khan
كينزي	Kinsey
المرور؟	zirga-zirga?
على &amp; quot؛ والصحة	&quot;kiwon
ما	abin
الولي	riqo
إكس تيرم	xterm
حلم ومثل؛	Mafarki&quot;
753-3245،	753-3245,
الرأي،	duba,
الشواطئ،	shorelines,
الضرر.	lalata.
على &amp; quot؛	&quot;sai
روزا	Rosa
روكفيل،	Rockville,
أفترض	ganina
&#39;خواتم	&#39;zobba
بحث	Research
جميل	kyawawan
حذفت.	tsallake.
(95	(95
(93	(93
مصدر	tushen
غاز الأمونيا	ammonia
باستثناء	tsattsarkar
سببياتي	etiologic
نصح	shawarta
المدفوعة.	biya.
على ما يبدو،	fili,
html>	cj195@cleveland.Freenet.Edu
نهائي	karshe
stylizied	stylizied
وكالة	Agency
القديمة	Ancient
UUNET.	uunet.
(88	(88
ESPN	ESPN
سيارة	Car
طاقة	makamashi
ترتد؟	billa?
UUNET!	uunet!
تقريع؟	Bashing?
خطاب	jawabin
وقف).	tsayar).
تأمين	Inshora
1200	1,200
المعرض،	nuna,
المعرض.	nuna.
غير قابل للعلاج	untreatable
حقل	filin
كوميدي،	comic,
أمثلة	misalai
إد ومثل،،	ed&quot;,
html>	korenek@nmti.com
HE	SHI
إكسسوارات	Hadi
سواء	Shin,
مذكرة	lura
الجسيمات	gaɓãɓuwa
إطارات	windowed
صفة مميزة	halayyar
اليسار	hagu
وتستخدم	takan
Harumph.	Harumph.
على &amp; quot؛ ول	&quot;bari
القيود	constraints
يتعرض	fallasa
جدا)،	sosai),
مجمد	daskararre
ذلك).	shi).
نيلسون)	Nelson)
حافظ.	kiyaye.
الوصول.	damar.
A &amp; GT؛	A&gt;
زبيب	Zbib
الأهداف،	raga,
الإلتفاف	whirling
VanHeyningen	VanHeyningen
ضيف	baƙo
إيمان	bangaskiyarku
أسود	baƙi
لعبة البيسبول.	baseball.
(لا يوجد	(Ba
السماح	kyale
فتيل	fus
هؤلاء	waɗanda
SKS	SKS
شكر	godiya
ظلام	duhu
صامتة	muted
كنيسة	Ikkilisiyar
html>	leonard@aix3090b.uky.edu
تؤذي،	cuce,
سابقا	riga
الحقول	filayen
عمل ورقي	paperwork
(زوجتي).	(matata).
صخرة	falalen
البكتيريا.	Kwayoyin.
00ecgillespi@leo.bsuvc.bsu.edu&amp;gt.	00ecgillespi@leo.bsuvc.bsu.edu&gt;
جديد	sabuwar
شيء،	abu,
وفنيا	artistically
بما فيه	hada
مجموعة	hade
خبز	burodi
وGT.	tare&gt;
مواطن	Citizen
كل	duka
415-	415-
عديم القيمة	banza
عدوانية.	agressive.
أصليا	parented
عائلتنا	gidanmu
على &amp; quot؛ jargonese ومثل؛	&quot;jargonese&quot;
كيرك.	Kirk.
اتفاقية	yarjejeniyar
الجسيمات،	barbashi,
العلامة &amp; lt؛ jh6r+@andrew.cmu.edu&amp;gt.	&lt;jh6r+@andrew.cmu.edu&gt;
مرض	gamsarwa
حجم	size
الضارب.	hitter.
كل شيء؟	duk?
محتوى	abun
روبرت	Robert
العرض،	nuni,
[	[wata
ضاربا)	hitter)
عرض	tayin
الضارب،	hitter,
عندما	lõkacin
وGT.	iya&gt;
SER	SER
SET	SET
متوافق ومثل؛)	jituwa&quot;)
بما فيه	haɗa
دور	rawar
نعتقد	ĩmãni
رد:	Re:
لقب	take,
عار	kunya
أحمر	Red
حياة	rayuwarsu
ممتلكات	dukiya
عموميات	saɓani
نيسان	Afrilu
يتصرف	riko
المشاركات	posts,
قوانين	Dokokin
كامل	Cikakken
قواعد	dokoki
حلزوني	karkace
megatest.com &amp; GT؛،	megatest.com&gt;,
الملايين).	miliyoyin).
عقد	rike
ثابر	lurk
بعد	nesa
رقاقة مجموعة	guntu-sa
على &amp; quot؛ جوناثان	&quot;Jonathan
أتش تي أم أل&gt;	html>
فلاش	flash
SPL	SPL
بواسطة	via
خلق	ƙirƙirar
إلى	for
على &amp; quot؛ الرئيسية	&quot;Home
اثنين)	biyu)
كما	Kamar
اثنين.	biyu.
اثنين،	biyu,
فو	foo
القيم	dabi&#39;u
).	da).
ذاكرة	kwakwalwa
الثاني:	biyu:
COD	COD
---------------------	---------------------
نيويورك	York
ستة	Shida
اثنين؟	biyu?
يميل	tilted
صندوق البريد	POBox
(Tvtwm).	(tvtwm).
دبوس.	fil.
العرض،	tayin,
فرق	bambanci
رون	Ron
FROM:	DAGA:
قاعدة	tushe
الضغط العالي	high-matsa
علم الطيران	Aeronautics
مصلحة	amfana
(مايك	(Mike
فعل	aikata
سرعة	bugun
ربما،	yiwu,
(مارتن	(martin
الضارب	HITTER
كروفورد	Crawford
رسل.	manzanni.
الرسل،	manzanni,
مزدوج	dual
(	(Ka
القبعة اليهودية	yarmulke
عرض	sallama,
بووربووك	PowerBook
بندقية و GT.	bindiga&gt;
لايم،	Lyme,
علاج	jiyya
(أو	(Ko
800M.	800mA.
(الأسرة	(Family
أساس	Grounding
الملك.	sarkin.
عبارات	phrases
أكثر	ƙarin
بقعة	Spot
استعمال	amfani
الكثير.	yawa.
على &amp; quot؛ الشخصية	&quot;Personal
ألف	dubu
(خاصة	(musamman
جهاز	na&#39;urar
كوكب المشتري	Jupiter
ربح	riba
كثير)	yawa)
(J.	(J.
274-5357	274-5357
بالتأكيد	tabbata
العلامة &amp; lt؛ 1993Apr21.234159.1206@ualr.edu&amp;gt.	&lt;1993Apr21.234159.1206@ualr.edu&gt;
سرعة	gudun
قرن	ƙarni
اكتسبت	tsiwirwirinsu
على &amp; quot؛ Drakula ومثل؛	&quot;Drakula&quot;
جناح	flank
السيارات.	motoci.
...]]	...]]
الخسارة.	asara.
المنظمين.	gwamnoni.
و	alhãli
(إدوارد	(Edward
كثير؟	yawa?
رأي	duba
بجوار &amp; GT؛	gaba&gt;
نظرة	dubi
القوانين،	dokokin,
عدد السكان	yawan
دبوس	fil
نجمة	tauraro
كامل	cikakken
عظيم	manyan
رسل	Manzanni
ماتسو،	Matsuo,
معمودية &amp; GT؛	Baftisma&gt;
مخطط	makirci
خيارات.	zažužžukan.
فتيل	fis
نظراء	takwarorinsu
شركاء.	abokan.
النجوم	taurari
حل	fix
موقف	shakatawa
شركاء،	abokan,
تشغيل.	gudu.
تشغيل،	gudu,
و &amp; مثل؛	da&quot;
كولومبيا وGT.	Columbia&gt;
كما يبدو	fili
أخيرا وGT.	karshe&gt;
بوس	Bos
90٪	90%
فيديو	video,
كوكب المشتري،	Jupiter,
تصدير	aikawa
: &amp; GT؛ &amp; GT؛	cewa:&gt;&gt;
BUFFERS	BUFFERS
تطبيق	aiwatarwa
90،	90,
كوكب المشتري.	Jupiter.
التقدم	Advancements
كوكب المشتري.	Jupiter;
مخططي	tsarawa
هيرشيل.	Herschel.
مختلف	dabam-dabam
شركة،	Inc.,
Vehical	Vehical
قذيفة	ɓawon
html>	sharma@tiger.vill.edu
الخط؟	line?
وGT.	su&gt;
تدريب	horo
عراك	yãƙi
ضعيف	rauni
هذا:	wannan:
الأقران).	takwarorina).
27.6	27,6
لا متماثل	asymmetric
يخطأ	faulting
جرد	kaya
التشفير ومثل؛	boye-boye&quot;
هذه؟	wannan?
مرر	auku
فوق	bisa
الذي،	wadda,
فيديو	video
(&amp; اللفتنانت؛ س &amp; GT؛	(&lt;o&gt;
تحديد	kayyade
حيوية	animation
هذا.	wannan.
^^^^^^^^^^^^^^^^^^^^^^^^^^	^^^^^^^^^^^^^^^^^^^^^^^^^^
أوهام	kawayeniya
هذا،	wannan,
منخفض	Maras
الخ &amp; GT؛ &amp; GT؛	sauransu&gt;&gt;
xelion!	xelion!
جدل	rigima
نبتون	Neptunian
على &amp; quot؛ هناك	&quot;akwai
73،	73,
فريدمان	Friedman
تندب	Scarring
المسيح:	KRISTI:
بدلا من	baicin
مظهر	bayyanar
العلامة &amp; lt؛ pgf.735012282@srl03.cacs.usl.edu&amp;gt،،	&lt;pgf.735012282@srl03.cacs.usl.edu&gt;,
؟	da?
العلامة نداء:	Callsign:
صورة	hoto
محطة	Station
أسماء	sunayen
27.2	27.2
ثبت &amp; GT؛	tabbatar&gt;
(ديترويت،	(Detroit,
المحيط	tekun
على &amp; quot؛ &amp; الضباب الدخاني مثل؛	&quot;smog&quot;
العلاج!	Far!
و،	da,
أقراص	DISKs
قياس	auna
)	da)
Lampoon_	Lampoon_
الكويكب	Asteroid
1500	1,500
Selannes	Selannes
الاعتراف.	LURA.
جلب	kawo
!	da!
اتصال	tuntubi
محاولة	Yunƙurin
N-8-1.	N-8-1.
اتصال	tuntube
على &amp; quot؛	&quot;wanda
إلكترونيا	electronically
الخط.	line.
.	da.
410-34-1	410-34-1
ملفات	fayiloli
البرمجيات	Software
غرب	Yammacin
سحر	sihiri
وعود	alkawuran
700	700
الآلهة.	alloli.
703	703
الربع &amp; GT؛	kwata&gt;
G20،	G20,
سنوات	Shekaru
حجر دمره	dutse-pocked
لكن	dai
مايكروسوفت	Microsoft
خشب القيقب	Maplewood
رمز	code
العاصمة)	dc)
G20.	G20.
DX)	DX)
إعادة شحن البطارية	recharge
وعلاوة على ذلك	cigaba
وGT.	wannan&gt;
ابن	dan
بالطبع &amp; GT؛	shakka&gt;
الفاكس:	Fax:
لي)	Lee)
حماية	kare
إعادة صياغة:	fasara:
المضاربة	speculating
ملحقات	kari
هيروشي	Hiroshi
sci.med	sci.med,
الهاتف:	wayar:
نانايمو	Nanaimo
واللفتنانت؛ س &amp; GT؛)	&lt;o&gt;)
المزيد	kara
هؤلاء	Wadannan
المسيح،	Almasihu,
حضر	halarci
المسيح.	Almasihu.
7.5	7.5
مرة	karo
كينيدي	Kennedy
غير واضح	indistinct
html>	cl056@cleveland.Freenet.Edu
(سبيروس	(Spiros
العلامة &amp; lt؛ &amp; GT الفضاء.	&lt;sarari&gt;
أرض	kasa
عباءة	alkyabbar
html>	&lt;1APR199313404295@skyblu.ccit.arizona.edu
200uf	200uf
الفجر،	alfijir,
دفع،	Turawa,
بريندا	Brenda
(61302	(61302
افي.	Ave.
إعادة رسم	redrawn
خطط	tsare-tsaren
هنري	Henry
ويتن	Whitten
قوية.	ƙarfi.
html>	zbib@bnr.ca
MILLITARY	millitary
html>	betel@camelot.bradley.edu
على &amp; quot؛ الشك	&quot;Wasi-wasi
عدد المشاهدات	ra&#39;ayi
الشحن	Shipping
العلامة &amp; lt؛،	&lt;,
ماسة	iyakacin
خطوط	Lines
(شريطة	(azurta
ماكورد،	McCord,
إلى	zuwa
أعلى ومثل؛	saman&quot;
الضغط:	Turawa:
؟ ومثل؛	ta?]&quot;]
يسوع	jesus
مجموعات،	kungiyoyin,
الولايات المتحدة	Amurka
24:46،	24:46,
السيارات	auto
DOSKEY	DOSKEY
إمكانية	Yiwuwar
أحداث	al&#39;amura
بنتيوم	Pentium
_outside_	_outside_
الرعاية الطبية	Medicare
(1430	(1,430
html>	rauser@fraser.sfu.ca
الصور	hotuna
دجال	empiric
الدوري،	League,
العلامة &amp; lt؛	&lt;na
الدوري.	League.
كولورادو،	Colorado,
قوة	ƙarfin
متورط	akayi
HMMMMMMMMMMMMMMMMMMMMMMMMMMMMMMMMMMMMMMMMMMMMMMMMMMMMMMMMMMM	HMMMMMMMMMMMMMMMMMMMMMMMMMMMMMMMMMMMMMMMMMMMMMMMMMMMMMMMMMMM
القضايا.	al&#39;amurran.
حقوق	hakkokin
المدفوعات	biya
الاستعراض.	bitar.
(سيفيري)	(severy)
الرحالة	Voyagers
(	(kasance
السؤال)	tambaya,)
مقالات	articles
المعمد	Maibaftisma
و	Alhãli
الروابط	links
السعر	Farashin
منطقة،	zone,
أوبيرون	Oberon
برينر)	brenner)
ذلك .....	shi.....
.....	.....
عربة	Van
اثنان	biyu
جزئيا	partially
العلامة &amp; lt؛ 2958804@QUCDN.QueensU.CA&amp;gt.	&lt;2958804@QUCDN.QueensU.CA&gt;
مشمس	sunlit
واي مينغ	Wai-Ming
Majalisun	Majalisun
منزل	gida,
ذات الصلة	related
المنزل.	gida.
1979،	1979,
&#39;الأسلحة&#39;	&#39;makamai&#39;
وذكر،	bayyana,
1979.	1979.
مساعدة:	Taimakon:
واضح.	bayyana.
عرض	miƙa
مستهلك	mabukaci
طابعة	firinta
(اليورو تقريع؟)	(Yuro-Bashing?)
الأطر	frameworks
html>	gt7469a@prism.gatech.EDU
فرانك	Frank
تحول	canjawa
MUSCLE	TASHIN
لطيفة.	Nice.
622121	622121
DIGI-مفتاح	Digi-Key
بندقية ترخيص	bindiga-lasisi
العلاج &amp; GT؛	magani,&gt;
تدور	circling
1978	1978,
على &amp; quot؛ الهدف	&quot;haƙiƙa
دواء وهمي	placebo
1978.	1978.
Kreiling)	Kreiling)
ابن	Dan
أقل &amp; GT؛	kasa&gt;
منطقة	Regio
على &amp; quot؛ العربية &amp; قووت]؛؟	&quot;arab?&quot;
توسع	fadada
منزل	gidan
منخفض الكثافة	low-yawa
الخطايا.	zunubanku.
إندونيسيا.	Indonesia.
الخطايا،	zunubanku,
المدارية	orbiters
تكريم	girmama
حيرام	Hiram
html>	goolsbey@cs.utexas.edu
&#39;شروط	&#39;yanayi
دزينة	dozin
حقائق	hujjoji
سجل	rikodin
تدفق	ƙarƙashinsu
إشراك	unsa
على &amp; quot؛ أنت	&quot;Kai
Faehl	Faehl
1976	1976,
فريدمان:	Friedman:
تكنولوجيا	Fasaha
زواج	aure
نهائي	Karshe
القرص،	faifai,
الوزن	nauyi
في العام الماضي،	bara,
VLB	VLB
32-بت	32-bit
عبر	fadin
1974.	1974.
1974،	1974,
شطب	shafewa
الجليد.	kankara.
html>	king@reasoning.com
الجليد،	kankara,
486DX-33	486DX-33
4،0-4،3	4.0-4.3
المريخ	Martian
قياس.	auna.
المريخ؟	Mars?
غير موثقة	undocumented
المريخ،	Mars,
ستيف	Steve
المريخ.	Mars.
VLX	VLX
قوية،	karfi,
عمل	Mataki
1975	1975,
وكالات	hukumomin
؟	kai?
R &amp; GT؛	R&gt;
DLC	DLC
رسول،	manzo,
html>	blaisec@sr.hp.com
ثلاثة	Uku
أم	uwa
تحقق	rajistan
الملك)	Sarki)
عنصر	bangaren
الخالق	mahaliccin
أم،	Um,
على نطاق واسع،	fadi,
المناطق	yankuna
هيغنز،	Huygens,
1972،	1972,
فرار	kubuta
مستهزئ)	Mocker)
حق	DMA
1970s	1970s
على &amp; quot؛ مساعدة	&quot;taimaka
،	kai,
وصول	Samun
.	kai.
1973،	1973,
وGT.	daya&gt;
وGT.	cewa&gt;
حيازة	mallaki
(هال	(Hal
Mitsubushi	Mitsubushi
التصميم.	zane.
مونتريال،	Montreal,
غيبوبة	coma
خاص	mallaka
إشارة	zance
----	----
مجموعة	kafa
(هنري	(Henry
متابعة).	up).
جزء.	bangare.
الأحزمة،	belts,
التشفير ومثل؛ &amp; GT؛	boye-boye&quot;&gt;
المكسيك،	Mexico,
&#39;	&#39;to
______________________________________________	______________________________________________
(ولكن	(amma
نوم	barci
العلامة &amp; lt؛ May.12.04.27.47.1993.9935@athos.rutgers.edu&amp;gt.	&lt;May.12.04.27.47.1993.9935@athos.rutgers.edu&gt;
مصهور	zubi
html>	ron.roth@rose.com
صيغ	Formats
تعاون	haɗin
إجابة	amsar
سلطان	dalĩli
غير أخلاقية	unethical
في نهاية المطاف.	ƙarshe.
7.3.	7.3.
الإجابة:	amsa:
على &amp; quot؛ لوحة ومثل؛	&quot;nameplate&quot;
وأخيرا،	ƙarshe,
المواصفات	tabarau
1971،	1971,
تعديل	modified
الغزل	kadi
احد.	guda.
&#39;93).	&#39;93).
وحيد	guda,
هدف	Manufar
فعل	kada
خلاف	husũma
عموميات	sabani
خير	alhẽri
رقائق	kwakwalwan
(317)743-1394	(317)743-1394
(خطأ)،	(kuskure),
كيف	yadda
سلامة و GT.	kirki&gt;
ميكروفون	Mike
(2544	(2,544
قوية وGT.	ƙarfi&gt;
&#39;هاء	&#39;ve
متعدد الأعراق	Multi-kabilanci
140-165	140-165
sun4nl!	sun4nl!
(كلاوديو	(Claudio
استمع	saurari
الحالات	lokuta
تحية طيبة،	Gaisuwa,
قوة	karfin
أجهزة الكمبيوتر	Computers
نهاية	ƙarshen
html>	batman@cisco.com
صب	zuba
قادم،	cometa,
(-290	(-290
محرك،	drive,
الأرض الحجم	Duniya-sized
مصادر	kafofin
(-298	(-298
جوهر	core
التاريخ:	DATE:
ملك	Sarkin
وقال:	ce:
الخروج،	kashe,
[مثال	[misali
مسيرة	Maris
تطبيق	aiwatar
لمعان	kyalkyali
بها،	fitar,
الهندسة	Engineering
وقال،	ce,
قال.	ce.
ديفي هيلمان	Diffie-Hellman
شجار	tiff
مستوى	matakin
8.1	8.1
ساعات	hours
يصل.	up.
العالم &amp; GT؛	duniya&gt;
فوق	up,
الخلافات	bambance-bambance
ROSENAU)	Rosenau)
دقة.	daidaito.
المفتاح العام	jama&#39;a-key
على &amp; quot؛ أنت	&quot;Kun
شماعة،	fegi,
ثلاثة	uku
دراجة نارية.	babur.
_____________	_____________
ناد	Club
عدد المشاهدات	ra&#39;ayoyi
جزء	ɓangare
شكر	gode
الله).	Allah.)
نصيحة	shawara
التشفير	boye-boye,
المواد.	kayan.
Mouting	Mouting
التشفير)	boye-boye)
(5000	(5,000
طبيب	likita
شمال	arewacin
html>	alane@microsoft.com
ضرب &amp; GT؛	hit&gt;
afronted	afronted
رود	Rhode
ثيودور	Theodore
الحياة النباتية	ciyayi
أنت	kana
اليابان	Japan
لا شيء.	kome.
الكنيسة.	Church.
مزيج	gauraya
الكويكبات	asteroids
الأعضاء	mamba
مدمن	kamu
سيارات الدفع الرباعي	landiroba
رادار	radar
DEVICEHIGH	DEVICEHIGH
الدراجات النارية	babura
الينابيع،	Springs,
البعض.	sauran.
مزلاج	kama
نفط	fetur
خدمة	hidima
لو	&#39;le
التجربة.	kwarewa.
مقاومة.	impedance.
CLR	Clr
على؟	kan?
الخبرة،	kwarewa,
ثغرات،	gibba,
كدمة	uje
COM1	com1
بارد،	sanyi,
قوة	Power
شتاين	Stein
(كما	(kamar
شكل	format
العلامة &amp; lt؛ 1993Apr21.032427.22464@leland.Stanford.EDU&amp;gt،،	&lt;1993Apr21.032427.22464@leland.Stanford.EDU&gt;,
التشفير.	boye-boye.
وسيط	matsakanci
(-235	(-235
Gretzky	Gretzky
لا شيء	komai
559.	559.
تعمل بالطاقة	powered
مصمم	zanen
إنجلترا	Ingila
صغير	ƙanana
DOS	DOS
(ليونارد	(Leonard
العلامة &amp; lt؛ 1qvb5aINNmoi@darkstar.UCSC.EDU&amp;gt،،	&lt;1qvb5aINNmoi@darkstar.UCSC.EDU&gt;,
القانون و GT.	Attaura,&gt;
نقرات	akafi
المادة،	kasida,
الرعاية،	kula,
الرعاية.	kula.
التعامل &amp; GT؛	fama&gt;
(	(har
رسم،	kusantar,
أدنى	Magangara
مايكروسوفت	microsoft
القشرة	veneer
مسار	ɗã&#39;a
فصل الخريف	kaka
Deptt.	Deptt.
كنوكس)	Canucks)
الأكل	cin
راحة	sanyin
تعريف	definition
عام.	general.
تصميم،	zane],
(مايكل	(Michael
بارد.	Sanyi.
وعد	Alkawari
في كل مكان،	ko&#39;ina,
بشري	adam
حمى	zazzabi
فرص	chances
(إسبانيا)	(Spain)
[إدخال رقم التعريف الشخصي]	[ped]
السلامة ومثل؛	Safety&quot;
مريح	dadi
غزة	Gaza
الوسائل	nufi
بت	ragowa
utzoo!	utzoo!
معارضة	adawa
عنوان	nufa
مغنطيسي	Magnetic
: -) &amp; طن؛ &amp; GT؛	:-)&gt;&gt;
الصور.	images.
التعليمات	FAQ
الأطراف	jam&#39;iyyun
html>	sguerke@brahms.udel.edu
html>	koutd@hiramb.hiram.edu
لؤلؤة	lu&#39;ulu&#39;u
بطاقة،	katin,
البطاقة.	katin.
الجحيم &amp; GT؛	Jahannama&gt;
التحليق	Flyby
سلاح	makami
نقطة من رأي.	batu-na-view.
V9R	V9R
رجل	mutumin
المغول	mangolawa
على &amp; quot؛ مشاركة &amp; GT؛	&quot;karshe&gt;
مفتاح ومثل؛	mažalli&quot;.
ستالين	Stalin
مثلي الجنس	kishili
مدير	sarrafa
البيانات	maganganun
الدوري!	league!
خطوات	matakai
الدوري.	league.
على الانترنت	layi
23-25).	23-25).
على &amp; quot؛ مثلي الجنس	&quot;kishili
مناسب	dace
korenek)	korenek)
يرتكب	committ
واقفا.	tsaye.
مخططات	makircinsu
أيام	kwanaki
وتعبئتها	kunsasshen
نسخة	kwafin
ميزة &amp; GT؛	alama&gt;
كليوباترا.	Cleopatra.
التفاصيل	daki-daki
الهيئات،	gawarwakin,
سوء الفهم.	miscommunication.
اصلية و GT.	asali,&gt;
التي	wanda
الضغط المنخفض	low-matsa
دمرت ومثل؛	halaka&quot;
طويل	dade
lmouse	lmouse
زيادة	dada
على &amp; quot؛ قفل	&quot;kulle
(على سبيل المثال،	(misali,
تقريبا	Kusan
(على سبيل المثال)	(misali)
مدينة	birnin
المرحلة.	mataki.
النيوتونية	Newtonian
99.9	99.9
(29.95)	(29.95)
إنشاء	tsayar
فهم	fahimci
نفسه،	kansa,
ترحيب &amp; GT؛	maraba&gt;
البحارة.	Mariners.
يحتوي &amp; GT؛	kunshi&gt;
html>	nelson_p@apollo.hp.com
كاميرا	kamara
(932	(932
دوروثي	Dorothy
الأنابيب.	bututu.
.indiana.edu	.indiana.edu
موارد	Resources
6-7	6-7
ابن	dansa
صقل	lafiya-tune
الوقوف،	tsaya,
على &amp; quot؛ كونستانتينوف ومثل؛	&quot;Konstantinov&quot;
وون	lashe
6.4	6.4
الأب	uba
نقطة	maki,
راديو	Radio
لذلك،	wani,
الوسطى	tsakiya
عودة	SAMA
قطعة	bantara
الهوكي،	hockey,
السائقين والترخيص	direbobi-lasisi
الجهاز،	na&#39;urar,
التملق وGT.	adulation&gt;
THEWITNESS	THEWITNESS
تجربة	kwarewa
الفأس	gatari
كورينثيانز	Korantiyawa
دونات ومثل؛	Donut&quot;
على &amp; quot؛ أهمية ومثل؛	&quot;muhimmanci&quot;
الدعوة.	kira.
المتلقي،	karɓa,
المنتجات	Kayayyakin
في المئة.	kashi.
ينبغي	kamata
POSTITION	POSTITION
مرة وGT.	sau&gt;
نقص	rashin
. المرض ومثل؛	cuta.&quot;
waiiiiiit	waiiiiiit,
لأن	Saboda
S5R3.2).	S5R3.2).
&#39;M&#39;:	&#39;m&#39;:
من	wanin
يجب	Dole
شارون،	Charon,
في الواقع،	hakika,
ضبط،	daidaita,
متوسط	tsakãtsaki
مركز	Center
نافذة).	taga).
كاف	isasshen
الديكور.	ado.
4	4th
&#39;	ga&#39;
عرض	nuni
Shostack	Shostack
العنوان:	ashin:
ألف &amp; GT؛	dubu&gt;
تفه	frigid
النظام، ومثل؛	System,&quot;
قزم ومثل؛	Dwarf&quot;
هيوز	Hughes
تغيير.	sauya.
1968.	1968.
تصاعدت	escalated
الصفافير.	beeps.
294-8153	294-8153
مغلق	kulle
صفقات	kulla
مونتيس،	Montes,
الأجهزة	hardware
ألمانيا،	Jamus,
يعيد رسم.	redraws.
دائرة	da&#39;irar
(900	(900
أخلاقيا	ethically
معلومات	bayanai
رحلات	flights
مدير	Sarrafa
openlook.	openlook.
عدالة	adalci
دودسون	Dodson
عروض	nuna
VDC	VDC
بارد	sanyi
حاد	kaifi
النوافذ.	Windows.
5X9	5X9
الصخور.	dutsen.
الصخور،	dutsen,
تركيب	shigarwa
القانون و GT.	Attaura&gt;
التقاليد.	hadisai.
(يوحنا	(Yahaya
تعويضات	fansa
اندرز	Landers
جون؟	Yohanna?
غاري	Gary
مصنوع	sanya
جورجيا	Georgia
هوتان	hotan
html>	vax839@tid.es
يرتدي	sanye
خبز	Gasa
الإنسان.	adam.
استقاها	gleaned
الاسبوع،	mako,
الإنسان،	adam,
حدد	Gano
html>	MLINDROOS@FINABO.ABO.FI
مجنون	Gans
VGA	VGA
المعلومات:	bayani:
هجرة جماعية	Fitowa
640	640
المعلومات؟	bayani?
الآلاف	Dubban
التسميات	tasirin
جارية.	gudana.
ناد	kulob
الجليل	Bagalile
نعم.	Ee.
أسطول حربي	armada
1965،	1965,
أريد أن	wanna
(10،000	(10,000
الحل.	bayani.
(JT)	(JT)
أمراض	cututtuka
محكمة	kotun
علامات	ãyõyin
حول	Game
(	(kuma
علم	flag
منذ	tun
الزئبق،	Mercury,
ل	Gama
الوقود	haɓaka
الزئبق.	Mercury.
1964،	1964,
دبلوماسية	Diplomasiyyar
فخور	alfahari
مارتي	Marty
(I	(Ina
أتكينسون	Atkinson
(JPL	(JPL
تمسك	makale
أعلاه).	bisa).
مقبوض	gudanar
486DLC-33	486DLC-33
تخصص	fanni
تصميم	layout
1967،	1967,
بريان،	Brian,
نجمة	tauraron
الإيمان و GT.	bangaskiya&gt;
VHS	VHS
مقارنات	Kwatancen
سايفر	cypher
مولود بالفطرة	haifi
هيوستن	Houston
عكس	counterclockwise
حمم	lawa
650	650
APPRECITATED.	APPRECITATED.
FBI	FBI
quibble-	quibble-
إمرأة سليطة	Virago
كارلوس	Carlos
الموت	mutuwa
إلى	don
مرحبا	sannu
تحدى بإزدراء	izgili
html>	km@ky3b.pgh.pa.us
الأيونات	ions
سانجيف	Sanjeev
دوس	dos
مع	Tare
احتيال	zamba
البيسبول	baseball
(بخلاف	(wanin
(-366	(-366
DPI	dpi
البنطي	Buntus
html>	Nunnally@acs.Harding.edu
جلسة	zaman
(مات.	(Matt.
أمريكي	American
نوافذ	windows
خير	kirki
الأخاديد،	canyons,
الانتاج	fitarwa
كندا	Canada
مهتم	sha&#39;awar
رجل	mutum,
Baerecke)	Bading)
رجل.	mutum.
Siemon)	Siemon)
تركيز	hankali
قاطع	unalterably
نفسي	kaina
جوزيه،	Jose,
مذكرة	Lura
ستة	shida
معطيات	data
400dpi)	400dpi)
1962	1962,
الضباب.	hazo.
يكون؟	zama?
إشارة	sigina
ال	The
لوجيتك	Logitech
الميزات،	fasali,
northeners	northeners
مضر	cutarwa
قليل	&#39;yan
الميزات.	fasali.
أوتوكاد	AutoCAD
الخميس	Thu
حيث	sharuddan
الدوري	League
،	zama,
شخصية	adadi
الفائدة)	sha&#39;awa)
(إدمونتون،	(Edmonton,
الشفقي	auroral
(ديف	(Dave
مدرسة	School,
الشفق	auroras
بطء	&#39;jinkirin
الجدة)	Brenn)
)	zama)
تيم	Tim
الجدة،	Brenn,
(1500	(1,500
256K	256k
optilink	optilink
html>	newsdesk@jplpost.jpl.nasa.gov
اثنان	Biyu
الصرف،	musayar,
فهم	fahimta
خيال	almarar
العلامة &amp; lt؛ 1993Apr7.221357.12533@lamont.ldgo.columbia.edu&amp;gt.	&lt;1993Apr7.221357.12533@lamont.ldgo.columbia.edu&gt;
بادئة معناها معي	enteritis
تتلاشى	Fade
خدعة	hoax
عمر &amp; GT؛	shekaru&gt;
قوية،	ƙarfi,
مركبات	dari
تداعيات	fallout
ليل	dare
ثم	to,
كريستيان &amp; GT؛	Krista&gt;
html>	stephen@orchid.UCSC.EDU
لفترة وجيزة،	takaice,
معرفة	sanin
كل	duk
للأسف	takaici
لفترة وجيزة	takaice
امتلاكي	tajirai
شقيقة	&#39;yar&#39;uwa
(	(wanda
وطن؛ &amp; GT؛ &amp; GT؛	&gt;&gt;&gt;
المنشورات	wallafe
-----------------	-----------------
10:34	10:34
بيضاوي الشكل	elliptical
سوينغ.	lilo.
المبلغون.	communicants.
كاسيني	Cassini
النجوم.	taurari.
اسمك،	sunanka,
كانون الاول	Disamba
واردات	shigo
الصلب،	ƙarfe,
&#39;	&#39;
إذا	Idan
النجوم	taurari,
VL حافلة	VL-bus
(النسخة	(Version
وطن.	&gt;
مرت	shige
أشهر	months
دخول	shiga
html>	schauf@iastate.edu
ثم	To,
مسلسل	serial
وGT.	zama&gt;
دعوة	kiran
غير	shine
كل	Duk
يحمل	daukawa
قلق	damu
هؤلاء	Wadanda
المسيح، ومثل؛	Almasihu,&quot;
الحرم الجامعي)	Campus)
وطن؛ &amp; GT؛ &amp; GT؛ &amp; GT؛	&gt;&gt;&gt;&gt;
أيضا	Too
حدق	gazed
ازعجت	dame
متعلق بكوكب الزهرة	Venusian
حق	dama
توم	Tom
في نهاية المطاف.	karshe.
أخيرا)	karshe)
مقسم	divider
100 كم	100-kilomita
لى)	Lei)
السلاح:	Weapon:
مقالة	kasida
إله	bautãwa
تعليمات،	wa&#39;azi,
100،	100,
1000	1000
كثيرا	gwargwadon
Personaly	Personaly,
دير	der
(المصدر	(tushen
قصر	des
ألفا	Alpha
و،	kuma,
الإسلامية	islamic
على &amp; quot؛ للعلوم ومثل؛	&quot;kimiyya&quot;
قيادات	kaiwa
html>	&lt;31MAR199321091163@juliet.caltech.edu
و:	kuma:
دراجة هوائية	bike
يمني	Yemen
لاري	larry
عطلة	biki
مؤخرا	Kwanan
العلامة &amp; lt؛ p00261@psilink.com&amp;gt.	&lt;p00261@psilink.com&gt;
لويس	Luis
و.	kuma.
مليئة الحمم	lawa-cika
التصاميم	kayayyaki
تعلم؟	sani?
في	dake
أربعة	Hudu
الحرية.	&#39;yanci.
XRaiseWindow	XRaiseWindow
سوء التصرف	malpractice
الهاتف:	WAYAR:
المذنبات،	comets,
ظاهر	bayyane
أعرف.	sani.
الولايات المتحدة الأمريكية	USA
متوافق	jituwa
لوقا	Luka
فوز	nasarar
&#39;I	&#39;Ni
راقب	agogon
الراحة	dãɗin
أعلاه.	Sama.
مقارنات؟	kwatancen?
أعرف،	sani,
ظهر	bayyana
وحشي	daji
خطة	shiri
درجة.	digiri.
القولية	anecdotal
1ff &amp; GT؛	1ff,&gt;
واضح	tabbataccen
توجيه الاتهام	indicting
آب	Agusta
حلوى	alewa
عملية ومثل؛	tsari&quot;.
(	(yadda
تعداها	Länder
gilkey	gilkey,
الدكتور	Dr.
بالتناوب	alternating
على &amp; quot؛ البوب	&quot;pop
حرق	ƙone
متغطرس	kangara
أعلن	sanar
على &amp; quot؛ المزدوج	&quot;dual
متغطرس	kangare
الحيل &amp; GT؛	zamba&gt;
LaStrange	LaStrange
////	////
مغربي	Moroccan
html>	henry@zoo.toronto.edu
على &amp; quot؛ الصعب ومثل؛	&quot;wuya&quot;
عمالقة.	Kattai.
المعايير.	sharudda.
غير أخلاقية.	unethical.
Lindroos	Lindroos
وGT.	wanda&gt;
وزارة الدفاع	Dod
3511،	3511,
البتنت:	bitnet:
ناب	Fang
1024	1024
المناخ	sauyin
DOS6	DOS6
الضرب	batting
دعم	Support
هاه؟	Huh?
فيني	Finney
بسرعة	azumi
withs	withs
DOS.	DOS.
ومع ذلك،	dai,
على &amp; quot؛ X9 ومثل؛	&quot;x9&quot;
هوى)	Hui)
الفوائد:	amfanin:
شرطة	sanda
حرية	&#39;yanci
الظهر ومثل؛	baya&quot;.
لوسيفر،	Lucifer,
عفة	farjinsu
وGT.	cikin&gt;
نهاية	karshen
من	daga
دوس	Dos
منذ	Tun
100K	100k
إلى	Don
دونت	codified
أكثر من ذلك.	more.
أيد	goyan
جون.	Jon.
دراسة	Nazarin
لذلك،	haka,
.	haka.
حرفيا).	verbatim).
الخوف.	tsoro.
neccities	neccities
الألتميتر	altimeter
العقيدة	orthodoxy
حق	hakkin
حلم	Mafarki
(الأميركيين)	(Amirkawa)
الذكور،	namiji,
التدريب.	horo.
جاموس	Buffalo
مطالبة	da&#39;awar,
وكلاء	jamiái
*************************	*************************
قرون	ƙahonin
مجلة	Magazine
وعلاوة على ذلك	Ƙara
ال	cikin
اكسيبشن.	exeption.
زلزال	girgizar
كشف	wahayi
حقل	saura
الحجم.	size.
حجم،	size,
أسرع	sauri
(ستيف	(Steve
ازهر،	Bloom,
إلى أسفل.	saukar.
جورج تاون،	Georgetown,
منذ وGT.	tun&gt;
لغة	Harshen
إلى أسفل،	saukar,
مضلل	yaudarar
(كيرك	(Kirk
مسيحية	Kristanci
على &amp; quot؛ جميع	&quot;duk
لي	​​Lee
عيني	rem
مستحق	cancantar
ميلا).	miles).
الولايات المتحدة	{asar
TIFF،	TIFF,
فخور	Proud
-428-0800	-428-0800
الداخلية.	ciki.
بما في ذلك،	ciki,
جون	John
الرامي ومثل،،	Rifleman&quot;,
بلوتو،	Pluto,
بلوتو.	Pluto.
قاصر	qananan
تأمين	Assurance
سبنسر)	Spencer)
وصف	description
صوت	sauti
ديك	Ashe,
صحافة	latsa
عموما	Overall
عموديا	vertically
ديف	Dave
يوم الأحد	lahadi
ملاحظة: &amp; GT؛:	lura:&gt;:
مدبب	Tapered
تاجر	dila
tvtwm	tvtwm,
واحد ومثل؛	daya.&quot;
حرارة	Heat
تجاوز	override
-486-9975	-486-9975
17،	17th,
قصة	lãbãri
العلامة &amp; lt؛ رقم	&lt;Ba.
الخام	raw
ردود	martani
الدين.	din.
جون،	jon,
واحد	Daya
الحذر	taƙawa
أكد	Tabbatar
لأول مرة.	farko.
أولا،	farko,
html>	rind@enterprise.bih.harvard.edu
مرحبا،	Sannu,
... وطن؛ &amp; GT؛ &amp; GT؛	...&gt;&gt;&gt;
محول.	adaftan.
آلان	Alan
ل	Alal
لي	Ni,
5X9 &amp; GT؛ &amp; GT؛	5X9&gt;&gt;
الاضطرابات	perturbations
الغيوم.	girgije.
ارتكبت	commited
محور	axis
الغيوم،	girgije,
نظم &amp; GT؛	Systems&gt;
جديد	New
وقال،	gaya,
غير العضوية	inorganic
السائقين	direbobi
حياة	rai
متوقع	ran
على &amp; quot؛ نرى ومثل،،	&quot;gani&quot;,
مثليون جنسيا	luwadi
حسن البناء	rijiya-gina
الشرق إلى الغرب	gabas-da-yamma
رد فعل	Amsawa
^^^^^^^^^^^^^^^^^^^^^^^^^^^	^^^^^^^^^^^^^^^^^^^^^^^^^^^
كوب	kofin
أكثر	ƙarin,
الأسئلة	tambayoyi
هل	Yake
8000	8,000
Leifson)	Leifson)
في وقت مبكر	farkon
سنت!	aninai!
محاكمة	Shari&#39;ar
دمرت ومثل؛ &amp; GT؛	halaka&quot;&gt;
أنماط	alamu
المواد الكيميائية.	sunadarai.
إمكانية	yiwuwar
باختصار	gajeren
التهاب	kumburi
ميزة	alama
جديد &amp; GT؛	sabuwa&gt;
BUT	AMMA
1986	1986,
1986.	1986.
WNCI	WNCI
تغيير	sauya
مجانا،	free,
الفكرة؟	Ra&#39;ayin?
سوريا	Syria
نفسك،	kanka,
(22238	(22,238
السوفييتي	Soviet
10000	10,000
مجز	clipper
هل	Yana
خير؟	alhẽri?
1985.	1985.
العلامة &amp; lt؛ mvanheyn@cs.indiana.edu&amp;gt.	&lt;mvanheyn@cs.indiana.edu&gt;
Whethe	Whethe
عزر.	motif.
فينوس.	Venus.
UNIX	UNIX
أي شيء &amp; GT؛	kome&gt;
الجسم،	jikinsa,
أسطوانة	faifai
ثبات	clears
بصاق	tofa
فينوس،	Venus,
توفر	kasancewa
html>	nagle@netcom.com
محركات	gudãnar
التي	Wanda
الأستيلين غاز عديم اللون	acetylene
أرض	Ground
هنا	Nan
الكلمات.	kalmomi.
يغلي	seethes
المستكشف	Explorer
وقف &amp; GT؛	daina&gt;
البنادق	bindigogi
1983.	1983.
هذه وGT.	Wadannan&gt;
المدينة الفاضلة	Utopia
تفاحة	kwayar
الأساسية.	core.
المبادئ؟	ka&#39;idojin?
الأساسية،	core,
بكتيريا	kwayan
palastenians	palastenians
ulysses.att..com	ulysses.att..com
أوروبا،	Europa,
خلاط!	mahautsini!
بارد	kwantar
المبادئ.	ka&#39;idojin.
مثال	misali
الصحة.	lafiya.
أجيال.	al&#39;ummomi.
الصحة	lafiya,
القانون،	doka,
قانون.	doka.
كولومبيا،	Columbia,
التيارات	igiyoyin
التلاميذ)	almajiran)
***************	***************
كلام	kalmomin
مرتفع	dagagge
أخبار	labarai
تداخل	overlapping
1981.	1981.
مزيج	cakuda
حاد	tsanani
مخازن	Stores
استخدام &amp; GT؛	amfani&gt;
ثقافة	al&#39;adu
مزق	rip
هبوط	fadowa
هتاف	Bisimillah
الصحة	lafiyar
عرف	al&#39;ada
على &amp; quot؛ منذ فترة طويلة	&quot;dogon
1980،	1980,
الكتاب،	Littafi,
Bzzt!	Bzzt!
-rigth	-rigth
ذات الصلة	alaka
تيمونس)	Timmons)
تيمونس،	Timmons,
الكمبيوتر.	kwamfutarka.
انكمش،	shrank,
11/05،	5-11,
منحل ومثل؛	promiscuous&quot;
المريخ،	martian,
html>	hrubin@pop.stat.purdue.edu
أسلحة	makamai
نيسان.	Nissan.
مئوية،	Celsius,
المخزون،	kaya,
صلاح)	Salah)
المخزون)	kaya)
القانون؟	Attaura?
الاشياء.	kaya.
هاتف	wayar
أغلبية	rinjaye
يجري &amp; GT؛	kasancewa&gt;
(يونغ	(Leong
html>	martyj@mrcnext.cso.uiuc.edu
صعوبة	wahala
القليل	kaɗan
القانون،	Attaura,
قانون.	Attaura.
العلامة &amp; lt؛ 1qnb9tINN7ff@rave.larc.nasa.gov&amp;gt.	&lt;1qnb9tINN7ff@rave.larc.nasa.gov&gt;
accuire	accuire
بطبيعتها	inherently
على &amp; quot؛ تذكر	&quot;tuna
الدجال، وGT.	quack,&gt;
97.9	97,9
على &amp; quot؛ جميع	&quot;Duk
GSX-145	GSX-145
فرق	teams
مرتبط	nasaba
حاوية	akwati
الكوميديا.	Comics.
Mives	Mives
سيطرة	Control
الأرض مون سون	ƙasa-moon-rãnã
معدات	kayan
الطريقة.	hanyar.
ريفز)	reeves)
html>	cfaehl@vesta.unm.edu
الحد الأقصى.	hula.
الطريقة،	hanyar,
أعلاه،	bisa,
على &amp; quot؛ ف	&quot;q
الحدود	Iyakar
الطريق)	hanyar)
التشفير.	cryptography.
يربط	sadar
دعم	goyon
html>	brian@gab.unt.edu
comp.sys.ibm.pc.hardware	comp.sys.ibm.pc.hardware
الجحيم	Jahannama
تحتاج إليها.	bukatar.
كنوكس	Canucks
(سام	(Sam
المنتجات	samfurori
تدريب	horar
ستيفن	Stephen
ليفرمور،	Livermore,
يوميا	kullum
فريد	FRED&#39;S
&quot;مكون	&#39;halitta
الأطباء	likitoci
Redelfs)	Redelfs)
دي مثل	des-kamar
html>	nstassen@magnus.acs.ohio-state.edu
الصلاة و GT.	addu&#39;a&gt;
الحالات،	lokuta,
إبراهيم،	Ibrahim,
على &amp; quot؛	&quot;
لغة	harshe
صلاة	Addu&#39;a
تشكيل.	samuwar.
خبز	yisti
الانتهاء.	kammala.
يد	hannun
يتصرف	riko,
و،	Kuma,
ماكسويل	Maxwell
imputs	imputs
ودية؟	sada?
غضب	fushin
على &amp; quot؛. ذيول على &amp; quot؛	&quot;wutsiyoyi.&quot;
الإلكترونيات	Electronics
الهيئات.	jikinsu.
قيمتها،	daraja,
الرمال.	rairayi.
نبتون.	Neptune.
الأماكن	wuraren
نبتون،	Neptune,
486-33DX)	486-33DX)
فارغا.	blank.
قطرات	saukad
اتصال	hulda
القانون ومثل؛ &amp; GT؛	Attaura&quot;&gt;
أوم	ohms
المريخ	martians
أرضي	terrestrial
أسفل	saukar
ممكن.	yiwuwa.
ربما،	yiwuwa,
على &amp; quot؛ النهائي	&quot;karshe
==========	==========
نقاء)	Tsarki,)
(كارل	(Carl
Gnostein؟	&#39;gnostein?&#39;
اليد.	hannu.
المقارنات،	Kwatancen,
المحمول،	hannu,
1989	1989,
أعمى)،	makafi),
انهيار	durkushe
واغنر،	Wagner,
مرحبا	Howdy
كونز)	Coons)
نهر	kogin
ممكن	yiwu
الثورات	eruptions
-Karl وطن.	-Karl&gt;
(Ncsc8!	(ncsc8!
محطات	tashoshin
لين)	lin)
الاتحادية	tarayya
html>	fang@en.ecn.purdue.edu
شارما	Sharma
مستشفى &amp; GT؛	asibitin&gt;
تلسكوبي	telescopic
و	sai
العالم.	Duniya.
عالم	Duniya,
مكافحة بندقية	anti-gun
كربون	carbon
القولية	Anecdotal
من السهل.	sauki.
ترقية	upgradable
تفسير	tafsirin
ايفرست.	Everest.
تعرف	san
مرات	sau
spec&#39;d	spec&#39;d
سنوات	years
المعيشة	zaune
إقامة	zauna
خط	line
بول	Bulus
،	sa,
عقارات	Properties
المناطق.	yankuna&#39;.
الوزن وGT.	nauyin&gt;
(بريان	(Bryan
الكنوز	taskõkin
رسائل	saƙonni
(كيفن	(Kevin
SCSI	SCSI
الرجل الحر	free-mutumin
رحمة	rahama
داريل	Darryl
الطائر	jumper
مهم	muhimmanci
كل،	kowane,
لكل منهما.	kowane.
[بان كي مون	[ban
تصفح	lilo
العلامة &amp; lt؛ العلامة &amp; lt؛	&lt;&lt;
===	===
روسيا	Rasha
السعي)	nema)
أجنحة	fuka-fuki
كل وGT.	dukan&gt;
750.	750.
توماس	Thomas
لايم	lyme
على &amp; quot؛ كبيرة	&quot;manyan
على &amp; quot؛ ضربات	&quot;doke
RS-6903	RS-6903
العودة.	mayar.
كل شيء!	All!
ولكن وGT.	amma&gt;
أوهايو	Ohio
82٪،	82%,
Potvin،	Potvin,
الآيات	ayoyi
Gosh..I	Gosh..I
html>	J.David.W.Reeves@dartmouth.edu
م-الصخور	m-dutsen
على &amp; quot؛ ستيفن	&quot;Stephen
html>	aep@world.std.com
فم	baƙin
حارس،	Ranger,
بنتز	Bentz
خلافا ل	sabanin
(ربما	(watakila
شبه الإعصار	Kusa-guguwa
العلامة &amp; lt؛	&lt;
كتب	Littattafan
لذلك؟	haka?
يوم	yini
قدم &amp; GT؛	sanya&gt;
الجمال و GT.	kyau&gt;
natonal	natonal
سوزوكي	Suzuki
القوات	sojojin
سبنسر	Spencer
بسهولة	saukin
محاكاة	emulators
المركز.	Center.
بلانيتيا	Planitia
مختبر	awon
علم الميكانيكا	makanikai
اللون	launi
هناك.	akwai.
!! على &amp; quot؛	!!&quot;
مفاتيح	makullin
وينسلو،	Winslow,
شراب	sha
دورة،	zagayowar,
&quot;الله ومثل؛	&#39;Allah&quot;
SU &amp; GT؛	SU&gt;
16804	16804
الجامعة	University
الدراجات،	kekuna,
صباح	safiya
بعيدا،	bãya,
التالي	Gaba
بعيدا.	bãya.
تطبيقات	aikace-aikace
حي	unguwa
(JPS)	(JPS)
دين	bashin
هو	shi
(جميع	(All
قسم	sashen
واشنطن.	Washington.
فوز	nasara
الجرائم،	laifuka,
الإتصالات	sadarwa
الدروع	garkuwoyi
دايتون،	Dayton,
الخطوات.	matakai.
_in	_in
قدم	kafar
مساح أراضي	safiyo
المياه.	ruwan.
تحت	ƙarƙashin
الماء،	ruwan,
دودة	macijin
الإنفاق	ƙãrẽwar
أنت)	kuka)
ممتاز	madalla
المسلسل،	siriyal,
ترخيص	lasisi
مسرح	kwaikwayo
(______________________________________)	(______________________________________)
الصحة ومثل؛	lafiya&quot;.
أعلى وGT.	saman&gt;
Pgf@srl02.cacs.usl.edu|Like	Pgf@srl02.cacs.usl.edu|Like
10/82	10/82
الولايات المتحدة	Amirka
كاواساكي	Kawasaki
(معلومات	(game
منشور	ɗaba&#39;ar
تحت	karkashin
لوحة المفاتيح	keyboard
1990.	1990.
1990،	1990,
فم	bakin
فرامل	birki
قائمة	jerin
html>	ekdfc@ttacs1.ttu.edu
كلية	College
القتال.	fama.
4RUNNER &amp; GT؛	4Runner&gt;
ل	Domin
أوه،	Oh,
جاكرتا،	Djakarta,
4/26/93.	4/26/93.
طيب،	Ok,
كاليستو	Callisto
الروايات المتناقلة &amp; GT؛	anecdotally&gt;
اختلاط	promiscuity
الفضاء	Space
6/91	6/91
قاصر)	qananan)
عقيدة	akidarsu
ما وGT.	abinda&gt;
ضبط	daidaita
الجسيمات	barbashi
كندا،	Canada,
تعزيز	karfafa
فلوريدا.	Fla.
00ECGILLESPIE	00ECGILLESPIE
البلد	kasar,
اتساق	daidaito
-14	-14
انحطاط.	degeneration.
غير منتظم	irregularly
Scharfy)	Scharfy)
وGT.	ne,&gt;
ساعة).	hours).
بوابة	ƙofar
جهود	ƙoƙari
تحديد	ganewa
2230	2230
(ايمي	(Amy
PMS	PMS
قبل	kafin
التجارة،	fatauci,
أنت	Kuna
الشحن و GT.	biyan&gt;
إصابة.	rauni.
Franjione	Franjione
HOMOSEXUAL-	HOMOSEXUAL-
علم الصواريخ	rocketry
التعقيدات	complexities
كوفمان)	Kaufman)
Telecope	Telecope
و	Kuma
بركاني	Volcanic
إدوين	Edwin
النوم.	barci.
النوم،	barci,
صوت:	murya:
المنزل من	gida-daga
نظيف	cleanly
انتخابات	zaben
أعداء &amp; GT؛	maƙiya&gt;
الأبعد	outermost
رأي	Duba
حاشية الملك	retinue
Ludwick ومثل؛	Ludwick&quot;
المتعصبين.	bigots.
(أندرو	(Andrew
وGT؛ &amp; GT؛	game,&gt;&gt;
(توبياس	(Tobiya
(3010	(3,010
آسف.	haƙuri.
(-184	(-184
ملفات:	files:
آسف،	haƙuri,
عرض &amp; GT؛	mika&gt;
الأمينية	amino
جرة،	tulun,
حب	son
سحاب	girgije
لمس	shãfe
الجودة وGT.	inganci&gt;
I &amp; GT؛	ni&gt;
و&amp; GT؛	babban&gt;
---	---
&quot;.	&#39;.
الميول،	leanings,
الغازية	invading
ريان	Ryan
تسجيل	records
هوفمان	Hoffman
!	su!
themon	themon
الخيار.	zabi.
الكورية،	korean,
ملف،	File,
السرعة؛	gudun;
alt.atheism	alt.atheism
سانتا	Santa
1999.	1999.
يتنقل	crisscrossing
على &amp; quot؛ لايم	&quot;Lyme
مقطع شعري	Stanza
الفيضانات	ambaliyar
10 ومثل،،	10&quot;,
غازي	gaseous
مسدس،	handgun,
باهر	dazzling
منحدرات	gangaren
و&amp; GT؛	a&gt;
صلاة	addu&#39;a
20	20th
صفقة.	ma&#39;amaloli.
الضرائب	haraji
Multiprobe	Multiprobe
الميزة.	alama.
تقاليد	hadisai
--clh	--clh]
حكم	hukuncin
الشكل	dimbin
العلامة &amp; lt؛ C5r60r	&lt;C5r60r
مثلي الجنس.	kishili.
___	___
مثلي الجنس،	kishili,
الشحن	shipping
نموذجي	hankula
html>	lvc@cbnews.cb.att.com
جدول	tebur
1993	1993,
ها	sababinsa,
تحرير:	Gyara:
التباطؤ.	deceleration.
عراك	yaƙi
Altimas	Altimas
على &amp; quot؛ بمعنى ومثل؛	&quot;gabar&quot;
المبيضات	Candida
تجميد	freezes
واضح	bayyananniya
(السيانيد	(cyanide
ساعة،	awa,
فترة	tsawon
1992	1992,
html>	adam@das.harvard.edu
يجب.	dole.
القاضي.	hukunci.
اسلكيا	radioed
وليام	William
المعضلة!	kwanda!
هو	shĩ
مفاجأة	Mamaki
تعليمات	wa&#39;azi
&#39;:	&#39;:
لوري)	Lauria)
بعضها البعض.	juna.
يستخدمون اليد.	handers.
بعضها البعض،	juna,
حقيقي	real
مدار	kewayewa
الطاقة.	makamashi.
1995	1995,
عناوين مختارة	articals
دفع	Turawa
تفاح	apples
html>	daviss@sweetpea.jsc.nasa.gov
نجمة وابنه	tauraron-dan
ظهر	Bayyana
[حديث	[magana
19947	19947
أراد،	so,
FORSALE	forsale
تريد.	so.
ألتيما،	Altima,
أوبو	Obo
الوصايا.	so;
بدلا من	maimakon
سبب	dalili
^^^^^	^^^^^
فرق.	teams.
Gen3:	Gen3:
&#39;S	&#39;s
PCX	PCX
حرف ومثل؛	hali&quot;
حمض الهيدروكلوريك.	HCI.
لوحات	bangarori
تريد)	so)
قطر	diamita
M	&#39;m
منازل	gidajen
سيئة.	mugu.
الحظ.	luck.
الاهتمام.	hankali.
القواعد.	dokoki.
الاستخبارات،	hankali,
الملصق	Poster
هندسيا	ergonomically
التاريخ،	tarihi,
على نطاق الكوكب	tamu-fadi
التنبيه	wakeup
مخاضة	hyundai
برنامج	shirin
التاريخ.	tarihi.
واد بلغة الشعر	Dale
المعزل ومثل؛	isolator&quot;
خارج	Out
الدراجات النارية،	babura,
لنا	Our
32-بت).	32-bit).
مغامرة	kasada
happed	happed
الدراجات النارية.	babura.
strawman	strawman
27611@athos.rutgers.edu	27611@athos.rutgers.edu,
سايفر.	cypher.
96.5	96,5
html>	folta@zen.holonet.net
سكيلتون	Skelton
سائق	direba
ال	Cikin
بذرة	zuriyar
الكتاب	marubuta
منطقة.	yankin.
قوانين	dokokin
المنطقة	yankin,
-oOOO	-oOOO
برامج	shirye-shirye
html>	astein@nysernet.org
وحث	buƙaci
أصلي	asali
الأمراض، وGT.	cututtuka,&gt;
متأخر	marigayi
المنطقة:	yankin:
^^^^^^^^^^^^^^^^^^^^^^^^^^^^^^^^^^^^^^^^^^^^^	^^^^^^^^^^^^^^^^^^^^^^^^^^^^^^^^^^^^^^^^^^^^^
في كل مكان	ko&#39;ina
html>	sharma@monet.vill.edu
المريض طبيب	Patient-Likita
أرض	Qasa
Kolodny	Kolodny
(ديك	(Dick
توزيع	kasafi
BMP،	BMP,
html>	sguerke@ravel.udel.edu
OTOH،	OTOH,
أوليفيرا	Oliveira
لا شيء	kõme
GMT	GMT,
طوية	sadarin
html>	kfrank@magnus.acs.ohio-state.edu
الكمبيوتر؟	kwamfutarka?
9600	9600
أن	Wancan
الاستقلال.	Independence.
ملتئم	coalesced
القوس.	baka.
.	su.
،	su,
html>	hans@xelion.nl
مهتمة،	sha&#39;awar,
اللوحات الأم	Motherboards
أشعل النار،	rake,
عظة &amp; GT؛	Huduba&gt;
كما وGT.	kamar&gt;
&quot;العربية.	&#39;Larabawa.
SMARTDRV	SMARTDRV
قصة	labarin
lankford	lankford
وليامز،	Williams,
البيئة.	muhalli.
أي	watau,
على &amp; quot؛ نموذجي ومثل؛	&quot;hankula&quot;
بعد	Bayan
نقود	kudi
تقرير	Report
غرفة	ɗakin
ننسى	manta
تمسك،	makale,
مجلدات	kundin
هم	sun
تاريخ	tarihin
فرانك)	Frank)
جنوب	kudu
مكابس	rakes
تليفزيون ومثل؛	televison.&quot;
التمثيل	wakilci
زجاجة	kwalban
مصنع	shuka
أبدا	taɓa
معلم	malami
يمثل	Wakiltar
html>	holsend@mhd.moorhead.msus.edu
رسائل	Wasiku
من	Daga
فك تشفير	decrypting
كيبهيرس	cyphers
(روبرت	(Robert
الرئيسية الحزام	main-bel
subwindows	subwindows
الجمال	kyakkyawa
دين	addinin
FORSALE	FORSALE
عرض	sallama
كاليستو،	Callisto,
أسفل	sauka
نخلي:	Disclaim-ta:
المواقع	wurare
إحصاءات &amp; GT؛	statistics&gt;
صديق	aboki
حالة الطقس	weather
(12V	(12V
===========================================	===========================================
WP51	WP51
الدين،	addini,
المسامير	kusoshi
الدين.	addini.
حرف،	hali,
إشتهى ملك غيره	gurin
المجموعات	kungiyoyin
العلامة &amp; lt؛ 1993Apr22.153959.12328@ucsu.Colorado.EDU&amp;gt.	&lt;1993Apr22.153959.12328@ucsu.Colorado.EDU&gt;
الطابع.	hali.
لاتينية	Latin
الدين؟	addini?
أباريق	pitchers
ضجيج	hayaniya
(125	(125
السيانيد.	cyanide.
صنبور	tap
(JPL)	(JPL)
حزم	shiryawa
ظلام	Dark
تمريض	reno
لورانس	Lawrence
العلامة &amp; lt؛ 1qkoel$5fr@horus.ap.mchp.sni.de&amp;gt،،	&lt;1qkoel$5fr@horus.ap.mchp.sni.de&gt;,
إغلاق	rufe
موسى	Musa,
الأطباء).	likitoci).
(ستيفن	(Stephen
جيجر	Geiger
مجنون	mahaukaci
حرف	halin
السلامة ومثل؛	aminci&quot;
العلامة &amp; lt؛ C5DxBs.5ov@panix.com&amp;gt.	&lt;C5DxBs.5ov@panix.com&gt;
على &amp; quot؛ &amp; الرياضة مثل؛	&quot;wasanni&quot;
****	****
المزدوج الرياضة	dual-Sport
liscenced	liscenced
PS:	PS:
تجد	sãmun
الأسود،	baki,
الانصهار.	Fusion.
عودة	kõma
رئيس الوزراء	ƙwalo
في منتصف الطريق	halfway
(175	(175
إغلاق	rufaffiyar
حياة	Rayuwa
html>	NUNNALLY@acs.harding.edu
ديو)	Duo)
[...	[...
القنوات	canals
WOW!	WOW!
على &amp; quot؛ دو	&quot;Kada
اتجاهات	bearings
مجموعة،	kafa,
html>	psyrobtw@ubvms.cc.buffalo.edu
التدفق).	gudãna).
مسيحي.	Kirista.
جدا وGT.	sosai&gt;
(RvKampen)	(RvKampen)
القرن.	karni.
مجموعة.	kafa.
!!!!	!!!!
الإيمان.	bangaskiya.
فيل	Phil
كشف	unravel
دائما	yaushe
مسيحي؟	Kirista?
الترخيص.	lasis.
--- وطن؛ &amp; GT؛ &amp; GT؛ &amp; GT؛	....&gt;&gt;&gt;&gt;
(وعادة ما	(yawanci
html>	banschbach@vms.ocom.okstate.edu
ويليس)	Willis)
الذيل،	wutsiya,
)	ta)
،	ta,
ستارة	labulen
على &amp; quot؛ فتح &amp; مثل؛	&quot;bude&quot;
أوروبا.	Turai.
قلق	Damu
أوروبا	Turai,
PTO	PTO
يخبز	bakes
؟	ta?
المنح	bãyar
عظيم	babban
أجنبي	harkokin
قواعد،	dokoki,
ديني	addinai
(تيم	(Tim
بعد	bãyan
سهل	sauki
شخصيا،	kaina,
.	ta.
هادئ،	uneventful,
قطرة	sauke
^^^^^^^^^^^^^^^^^^ وطن.	^^^^^^^^^^^^^^^^^^&gt;
تعرف)	Sani)
العالم &amp; GT؛	Duniya&gt;
قطر،	diamita,
نفسي.	kaina.
عظيم	babbar
نائمة	dormant
:	ta:
يجب &amp; GT؛	dole&gt;
اللغة الفرنسية	French
فرع الموارد البشرية.	HRB.
المتداعية	crumbling
المشكلة.	matsala.
قبل	gabansa
قلل	shorted
طعام	abincin
14-19؟	14-19?
حفظ	Ajiye
رأي	View,
إله	bautawa
أنا	nake
نقطة	Point
.	nan.
ثم،	nan,
خواتم	zobba
html>	toml@boulder.parcplace.com
kenyee	kenyee
عام	shekarar
العزل	defenseless
إغلاق]	ƙulli]
قطعة	bit
20-39	20-39
مفتاح،	key,
(Gregh@niagara.dcrt.nih.gov)	(gregh@niagara.dcrt.nih.gov)
المفتاح.	key.
بن	bin
)	nan)
9256	9.256
....	....
غني بالمعادن	ƙarfe-arziki
الاحتمال،	yiwuwar,
الله &amp; GT؛	Allah&gt;
lankford	lankford,
غبار	kura
...:	...:
مونس)	Munns)
(39.95)	(39.95)
...؟	...?
مكبر الصوت	amfilifa
روجر.	Roger.
لا يحصى	imbin
بذرة	zuriyarka
(توم	(Tom
إيطاليا	Italiya
كما	tamkar
على &amp; quot؛ &amp; المصطلحات مثل،،	&quot;jargon&quot;,
موارد	albarkatun
عام	shekara,
مسح	binciken
قريب	kusa
خطة	dabara
خير	kyakkyawan
السنة.	shekara.
أجزاء	sassa
(آرون	(Hãrũna
keyat	keya
ألين	Allen
تقنيات	dabaru
الخبراء	masana
Goolsbey)	Goolsbey)
الهيئات	jikinsu
تمايل	bob
واحدة.	daya.
احد،	daya,
-Arlo	-Arlo
فلوريدا	Florida
رجل	Mutum
مسحوق	foda
المصنعين	kera
سمة	sifa
(	(mu
صدع	crack
إعلان	talla
البحث.	bincike.
على &amp; quot؛ 90٪	&quot;90%
(	(na
جيدة.	kirki.
المعرض،	kirki,
العلامة &amp; lt؛ rauser.734062608@sfu.ca&amp;gt،،	&lt;rauser.734062608@sfu.ca&gt;,
...)	...)
بي ام دبليو	bmw
...!	...!
تآكل.	yashwa.
ولا	balle
Spirit-	Ruhu-kai
السفر وGT.	tafiya&gt;
لنا	namu
(جديد)	(sabon)
كويستا)	Cuesta)
اختبار	gwada
(فرانك	(Frank
العلامة &amp; lt؛ C5r60r.4ID@megatest.com&amp;gt،،	&lt;C5r60r.4ID@megatest.com&gt;,
ديترويت	Detroit
حقا.	gaske.
حقا،	gaske,
روسيا،	Rasha,
إلهام.	wahayi.
هنا؟	nan?
في حين	wa&#39;adi
انتهاك	keta
مرة واحدة،	zarar,
ممتلكات	dũkiyõyinsu
مدارات	falakinsu
(	(ku
شملهم الاستطلاع	surveyed
هيئة	jikinsa
و	kuwa
وطن.	Za&gt;
html>	whitsebd@nextwork.rose-hulman.edu
الله	Allah
معرق	streaky
HITEN	HITEN
الشرائط	streaks
(أو	(ko
5500	5.500
مقاعد البدلاء.	benci.
html>	Rauser@sfu.ca
أنت	kuke
B433EI2.	B433EI2.
أنت	kuka
(اتبع	(bi
،	suna,
ملاحظة،	lura,
نوى	nuclei
4RUNNER	4Runner
(	(ba
RAM)	RAM)
خطر،	hadari,
خاص	nasu
المناطق	yankunan
رعاية	kula
1000	1,000
المؤمنين)	mũminai)
أنا	ban
computergenerated	computergenerated
ليس	bai
دليل	hujja
_your_	_your_
العاصفة.	hadari.
عصر	zamanin
على &amp; quot؛ روبرت	&quot;Robert
سيئة	bad
المقصودة؟	saukowa?
(كما	(as
و	kuma
المؤمنين.	mũminai.
شريط	bar
اللوحة الأم	motherboard
البحث.	bincika.
نعتقد	Imani
قطيع،	garken,
اسم	sunan
برنامج.	shirin.
ومضاء بنور الشمس	&#39;sunlit
فتات	niƙaƙƙun
التحليق،	flyby,
(Bentz.e.puryear)	(bentz.e.puryear)
التحليق.	flyby.
كذبة،	ƙarya,
المناطق.	yankuna.
كسر.	ƙarya.
يكون	Za&#39;a
النرويج،	Norway,
السعر	diyyar
رحلات الفضاء	spaceflight
ثاني أكسيد	dioxide
النرويج:	Norway:
أيلول	Satumba
النباح،	haushi,
ملء ومثل؛	cika.&quot;
مهندس	Engineer
رحالة	Voyager
قاع	gadon
تفعيل	Kunna
400	400,
***	***
هبوط	saukowa
الأموات؟	matattu?
ماء	ruwa
html>	gchin@Eng.Sun.Com
الشركات	kamfanoni
عملية تحليق	flybys
ريك.	Rick.
إلى	sabõda
منزل	House
طبق الاصل	Replica
الآثار	illa
طقطقة	clack
المهنية وGT.	sana&#39;a&gt;
حزام	bel
HIMEM.SYS	HIMEM.SYS
تعليم	ilmi
كولورادو	Colorado
قتلى.	matattu.
ميت	matattu,
(	(da
مغلف	wajaba
الأمونيا،	ammonia,
عمق	Zurfin
إحصائيات	kididdiga
أنت	kuna
مشكلة	matsalar
تدريس	koyarwar
Chryse	Chryse
المياه الجليدية،	ruwa-kankara,
إلى	domin
تشارك	tsunduma
منشئ	ƙãga
تلت ذلك.	bi.
الأقزام	dwarfs
لعب	play
يجي	Legge
لي	nawa
80111	80111
حقائق	BAYANIN
الشوك	ƙayayuwa
من مسافة قريبة	kusa-range
عشرة	Goma
أدناه:	ƙasa:
مثليون جنسيا	gays
الأرض؟	ƙasa?
فرقعة	pop
______________________________________	______________________________________
تباهى	fariya
وكالة	Hukumar
على &amp; quot؛ أوروبا	&quot;Turai
(	(Ya
الرسائل؟	sakonni?
تريتون.	Triton.
تعليم	ilmin
قال	gaya
جولة	kewaye
لا سامية	AntiSemitic
يكون	za&#39;a
كمبيوتر	Computer
المنتجات	kayayyakin
نتاج	samfur
مقاضاة	la&#39;anta
61153	61153
بلد	ƙasar
جويل	Yowel
(اقرأ	(karanta
التنقل	kewaya
شابيرو	Shapiro
خير	Good
التشفير	boye-boye
_him_	_him_
عشرة	goma
نجمة	Tauraron
قبل.	kafin.
اللوحات،	motherboards,
إزالة	kawar
مدرب؟	kocin?
الكهروميكانيكية	electromechanical
المعرفة،	ilmi,
فقط	kawai
مدرب)	kocin)
محركات	tafiyarwa
موقع	site
البنود	Items
فتحات	ramummuka
الآبار،	Wells,
تعزيز	ƙarfafa
يلال	Nunnally
التصاميم،	kayayyaki,
تغيير	musanyãwa
بلومبرغ	blomberg
القذف	tossing
الجانب.	gefe.
ذكر	namiji
قوة	Force
أرض	ƙasa,
583. وGT.	583.&gt;
جولة	Zagaye
الاتصالات.	sadarwa.
مستودع	sito
منع	rigakafin
قبل؟	kafin?
اللوحات الأم؟	motherboards?
أدناه.	ƙasa.
(مارك	(Markus
ملصقات	posters
1990s،	1990s,
التجريب.	experimentation.
أعضاء	mambobi
62.4	62,4
مختبر	Laboratory
ومثل؛،	su&quot;,
تليين	laushi
أفضل الممارسات البيئية)	bep)
ضربة	busa
واحد	ɗaya
الرئة)	Huhu)
وقال: &amp; GT؛ &amp; GT؛	ce:&gt;&gt;
منحل،	promiscuous,
قلب	Heart
الست	six-
موقع	Site
طيران	jirgin
^^^^^^	&#39;^^^^^^&#39;,
الذهب ومثل؛)	Gold&quot;)
محطة العمل	workstation
جانيميد	Ganymede
الأمم؟	al&#39;ummai?
المعتاد.	saba.
html>	dans@uxa.cso.uiuc.edu
مسألة	Tambayar
من الصعب	rumbun
-------------------	-------------------
تجمد	daskare
على &amp; quot؛	&quot;Sai
هناك	can
الحالات والشواهد	hali-kula
عادة،	saba,
خطر	hadarin
(من الواضح)؟	(fili)?
________)	________)
*******************	*******************
لانهاية	dawwama
سنوات،	shekaru,
تعرف &amp; GT؛	san&gt;
شركة	Company
سنوات.	shekaru.
زائف	ƙarya
صغير	karamin
سلطة المصادر الطبيعية معتمدة	NRA-bokan
(مايكروسوفت	(Microsoft
معلن	ayyana
أجنحة	Wings
إشارة	siginar
..:	&#39;..:
تمر،	auku,
الخيام،	alfarwansu,
X3153	X3153
أمواج	tãguwar
العلامه	weightier
ثوب	goon
عملاق، ومثل؛	giant,&quot;
اليهود	Yahudu
عشرة؟	Goma?
التسميات.	tasirin.
نشرت	buga
العلامة &amp; lt؛ Fenton@Kaleida.Com&amp;gt.	&lt;Fenton@Kaleida.Com&gt;
الذقن)	Chin)
كرات.	bukukuwa.
السياسات،	manufofin,
بوس)	Bos)
الانتهاء	ƙãre
جراحة،	Surgery,
إضراب	buge
الغاز.	gas.
الغاز،	gas,
البعثات،	expeditions,
نهائي): &amp; GT؛	karshe):&gt;
شراء ظهورهم	buy-bãyansu
المشترين	Buyers
شارع	Avenue
تجارة	fatauci
الجنرال	janar
عيسى	Ĩsã
تجريب	gwaji
(SF	(SF
عشتار	Ishtar
الثريا،	Pleiades,
الجزائر	Algeria
على &amp; quot؛ شراء	&quot;saya
(لا يوجد	(No
تفتيش	dubawa
الانتخابات)،	zaben),
(P.	(P.
سبيروس	Spiros
أساس	Foundation
نهائي	fanareti
B2: &amp; GT؛	B2:&gt;
html>	geb@cadre.dsl.pitt.edu
بحث	tattauna
(خوان	(Juan
مركبات	ɗari
الجيران	makwabta
روبين	Rubin
حماية ومثل؛	Kariya&quot;
(اثنان	(biyu
على &amp; quot؛ النسبية على &amp; quot؛	&quot;zumunta.&quot;
تخفيض &amp; GT؛	rage&gt;
خشب	itace
أساسا	principally
1Meg	1Meg
رومانسي	romantic
حزام.	bel.
حزام،	bel,
يخفض &amp; GT؛	lowers&gt;
حدد	gano
منحل؟	promiscuous?
THANX	Dabauá
المعترف بها	gane
قواعد	Dokoki
فتح	bude
كنتاكي	Kentucky
تيتانيا	Titania
سمعي	Audio
شمال	Arewa
رؤية	gani
386DX 40	386DX-40
حافلة	bus
المرتبة	ranked
Rauser)	Rauser)
تمتلك!	mallaka!
، يتكون طاقمها الإنسان	mutum-crewed
ترخيص	izni
جافا	Java
الإعلان.	talla.
ترحيب	maraba
المعالجين	healers
طبي	Medical
GMT &amp; GT؛	GMT&gt;
اثنان ل	biyu-domin
ملك	sarauta
على محمل الجد!	tsanani!
الحجارة.	duwatsu.
الهاتف المحمول	salula
شديد)	tsanani)
على محمل الجد.	tsanani.
html>	bc744@cleveland.Freenet.Edu
مؤقتة).	gadi).
سيريلي)	Cirelli)
Albertan،	Albertan,
مسار &amp; GT؛	ɗã&#39;a&gt;
html>	caldwell8102@mtroyal.ab.ca
متفق عليه،	amince,
إلخ	sauransu
مغلقة ومثل؛	rufe&quot;
كامل ومثل؛؟	cika?&quot;
بيتي،	gidana,
أمل	bege
أفضلية	vantage
تويوتا	toyota
جالانت	Galant
حضارة	wayewa
دعم	goyi
(آرثر	(Arthur
ويلز	Welles
كنس	sweeping
title-	title-
حاد	tsananin
الغذاء.	abinci.
المنحرفين.	deviants.
8.20).	8.20).
إلى	gare
اختبار	jarraba
html>	jhardono@nickel.ucs.indiana.edu
توجيه	shiriya
قوة	mallakar
تماما	quite
طاقة	Energy
زاوية	kusurwa
html>	gchin@ssf.Eng.Sun.COM
مينداناو ومثل؛	ARMM&quot;
ROM	ROM
كان	aka
النجوم.	taurãri.
هي	ake
هراء	bullshit
مع الأخذ	shan
مسافرين	matafiya
صحيح ومثل؛	gaskiya.&quot;
الشاحن)	Shipper)
فئة	aji
آية	Verse
مسافر	matafiyi
مجعد	curly
ارتفاعات عالية	high-tsawo
9128	9.128
اتفاقية	Yarjejeniya
الناس.	mutane.
نشرت،	posted,
الناس،	mutane,
الآلاف	dubban
مجرم	laifuka
منهم	yawansu
خمسة	biyar,
أرسلت	aika
AUTOEXEC.BAT	AUTOEXEC.BAT
صورة	image
بدلا من ذلك،	baicin,
القدرة:	Capacity:
خلاف	jayayya
مبادئ	akida,
عري	tsirara
البريد الإلكتروني	Email
موضوع ومثل؛	batun&quot;
فيني)	Finney)
*****************	*****************
بطاقة)	Card)
بين	Tsakanin
التحكم ومثل؛؟	iko?&quot;
ومن المثير للاهتمام	Sha&#39;awa
الدوائر؟	haihuwarka?
مثليات؟	madigo?
بلدنا.	tamu.
لدينا،	tamu,
فعل	Kada
المسيح.	Kristi.
الدوائر،	haihuwarka,
السحاق.	madigo.
8300	8300
أو-	-or-
إرهاب	Ta&#39;addanci
الناس	mutanen
تسمية recyle	recyle
السكاكين:	wukake:
VLB.	VLB.
وGT.	daga&gt;
الدجال،	quack,
تعليم	Ilmin
المجرب وGT.	empiric&gt;
html>	engp2008@nusunix1.nus.sg
عمل	Dokar
التزام	sadaukar
قواعد	kwasfansu
مختلف	daban
على حدة	dabam
جدوى.	wadãtar.
بهيمة	dabba
12-14)	12-14)
\ &amp; طن.	\&gt;
بارد	chilly
لين	Lynn
وGT.	ne&gt;
ألاباما	Alabama
متفق عليه	amince
العلامة &amp; lt؛ 1r1i7mINN4n4@cronkite.cisco.com&amp;gt،،	&lt;1r1i7mINN4n4@cronkite.cisco.com&gt;,
سلامة	aminci
وGT.	wurin&gt;
اتحاد	Tarayyar
^^^^^^^^^^^^^^^^^^^^^^^^^^^^^^	^^^^^^^^^^^^^^^^^^^^^^^^^^^^^^
لايم	Lyme
لي اهله.	Isreal.
بووربووك.	powerbook.
اختبار	gwajin
هي	ana
جديد	sabon
الأنبياء.	annabawa.
المصطلحات)،	sharuddan),
ضاربا	Hitter,
الريبو	Repo
،	shi,
فيلانوفا	Villanova
أورسون	Orson
ضجيج	amo
.	shi.
ضارة،	cutarwa,
خطايا وGT.	zunubansu&gt;
تم	ANYI
معلومات خاطئة	misinformed
---------------------------------	---------------------------------
أدنى	kananan
عمل	aiki
بحث	neman
P7625)	P7625)
درجات	darajõji
مجمع	hadaddun
الممسوحة ضوئيا	leka
أرسلت	aiko
الشعور بالوحدة)	Punjabi)
على &amp; quot؛ برنامج الأمم المتحدة للأذن ومثل؛	&quot;un-izini&quot;
الاختبار.	gwaji.
الميثان،	methane,
الميثان.	methane.
حول	game
أصفر	rawaya
لي	raina
؛-)	;-)
صغير	kankanin
500.	500.
بالضبط.	daidai.
+31	+31
S.)	S.)
الحق،	daidai,
سوق	kasuwa
إلى	gama
(طلب	(nemi
مسالم	pacifist
المعاهدة،	Alkawari,
ممثلة تمثيلا زائدا	overrepresented
بلوتو	Pluto
بالضبط!	daidai!
نشرت.	buga.
أيضا،	suma,
الأعمال العدائية	Tashin
الحارة.	dumi.
المطالبات	iƙirari
&#39;&#39; وطن.	&#39;mu&#39;&gt;
الاخوة	&#39;yan&#39;uwa
أرض	ƙasã
أوتاوا،	Ottawa,
شيء	abu
=============================	=============================
ميزة	siffa
الولايات المتحدة.	Amurka.
417-4101	417-4101
راندال	Randall
عيب	aibi
الكاهن.	firist.
المشي.	tafiya.
الثيموثية عشب	Timothawus
html>	willisw@coe-nw.clemson.edu
ثابت	gyarawa
الحديث ومثل؛	magana&quot;.
نهاية	Karshen
MICRONICS	Micronics
جنيه)،	fam),
اضطهاد	tsananta
القانون ومثل؛؟	Attaura&quot;?
شوستر)	Schuster)
لهم، ومثل؛	musu,&quot;
أسابيع.	makonni.
العلامة &amp; lt؛ 1993Apr21.182606.6798@ra.royalroads.ca&amp;gt.	&lt;1993Apr21.182606.6798@ra.royalroads.ca&gt;
CHRISTIAN.	Krista.
سيارة	mota
DR350S	DR350S
على &amp; quot؛ دفع &amp; مثل؛	&quot;biya&quot;
ذكية!	wayo!
بحث	nazari
**********	**********
الإيطالي	Italian
فريق	tawagar
الوثائق	daftarorin
زحل	Saturnian
الجاذبية	gravitationally
اليمين)،	DMA),
على &amp; quot؛ A	&quot;A
فنتون	Fenton
سفر	tafiyar
القوانين بندقية.	bindiga-dokokin.
القيمة،	darajar,
يعيش &amp; GT؛	rayu&gt;
قريب	zumunta
على &amp; quot؛،	&quot;,
نبي	Annabi
على &amp; quot؛ -	&quot;-
اسم،	sunan,
على &amp; quot؛.	&quot;.
html>	m-it2691@cs.nyu.edu
&#39;السبب	&#39;hanyar
إسحاق،	Ishaku,
أرض	ƙasa
أنت	Kana
. المعلم ومثل؛	malami.&quot;
فعال	inganci
التلاميذ	Almajiran
html>	dlb@hudson.wash.inmet.com
التالي	gaba
الأرجون،	argon,
الملكية،	dukiya,
الملكية.	dukiya.
SUPERVGA	SUPERVGA
ربما.	watakila.
ملحقات	ƙari
حماية	ƙare
المزيد	ƙara
منحرف	Askew
مزلاج	Kama
الهوية وGT.	ainihi&gt;
وGT.	ka&gt;
^^^^ وطن.	^^^^&gt;
طلاب	daliban
من السهل &amp; GT؛	sauki&gt;
والدجالين	quacks
نتروجين	Nitrogen
طلاب	dalibai
مجوهرات	ado
أوليسيس،	Ulysses,
هلال	moon
إلكتروني	Lantarki
على &amp; quot؛ أسرار ومثل؛	&quot;asirai&quot;
مؤتمر	taron,
Whitsell	Whitsell
المسيح	KRISTI
الأصل	Asalin
مؤقت	gadi
OFF	KASHE
جمهور	jama&#39;a
الطرق	hanyoyi
جسر	gada
الطاقة الشمسية	Solar
بالتناوب	alternately
++.	++.
شفاء	warkar
عملية وGT.	aiwatar&gt;
613)	613)
العلامة &amp; lt؛ 15378	&lt;15378
المثلية	liwadi
كوستنر	Costner
تستهلك	cinye
الكلمة.	bene.
و،	har,
html>	hambidge@bms.com
18:33	18:33
مقعد	benci
الكلمة،	bene,
يدويا	hannu
السلطة،	iko,
html>	DBD@ICF.HRB.COM
السيطرة)	iko)
(كلايتون	(Clayton
خاطئ	zãlunci
الخروج من الملة)	theists)
Guerke	Guerke,
Guerke)	Guerke)
رياء	Cant
الخروج من الملة،	theists,
أحباء	masõyansa
&#39;فتح&#39;.	&#39;bude&#39;.
أثار	tãyar
مشروع	Project
حمل	aza
المرض،	cuta,
مفاجأة:	mamaki:
المرض.	cuta.
كيب	Cape
(	(ya
تحية	gaisuwa
جولة	Kewaye
كيبهيرس؟)	cyphers?)
المفاجئة	untimely
النسخ الاحتياطي وGT.	madadin&gt;
خارج.	waje.
11:26)،	11:26),
الأعمال ومثل،،	kasuwanci&quot;,
كارل	Karl
ديني	addinĩna
السيوف،	Sabres,
البلاستيك	filastik
كآبة	ciki
3-8)،	3-8),
كامل	cike
مساح أراضي	Surveyor
راكبي الدراجات	kekuna
متقدم	ci-gaba
المقدمة	azurta
(هيرمان	(Herman
استولى	kãma
html>	ai843@yfn.ysu.edu
html>	thomasp@ifi.uio.no
ينبثق	spouts
درع	garkuwa
مرض	cutar
ثلاثي	Three-Way
شغل	cika
كيبيك &amp; GT؛	Quebec,&gt;
السعي) و GT.	nema)&gt;
حقيقة	gaskiya
أرض	Kasa
(بيتر	(Peter
تقع	ayi
السيطرة؟	iko?
مراجعة	mujalla
بروتيوس	Proteus
(21648	(21,648
الحجر)	Stone)
الناس.	mutãnenta.
قلق،	damuwa,
السيطرة.	iko.
مجلات	mujallu
السحر،	sihirin,
قلق)	damuwa)
تعويضات	diyya
عادة	yawanci
الخامس	aya
23-26،	23-26,
ورقة	takarda
سلوك	hali
،	ba,
html>	alung@megatest.com
منطقة	yankin
.	ba.
عالم	masanin
معلومات.	info.
أدنى	ƙasƙanci
الباب الخلفي	baya-kofa
FJ1200	FJ1200
الهيئات	gawawwakin
الوثائق	takardu
مسؤولون	jami&#39;an
أبرد	coldest
الذهاب-الخروج من العمل	faruwa-fito-na-aiki
هكذا	haka
(دان	(Dan
Thorson	Thorson
قوة	ikon
؟ ومثل؛	mu?&quot;
الاسترخاء وGT.	shakata&gt;
الهوكي	hockey
Pharasees	Pharasees
المسروقة.	sace.
المتنصت	eavesdropper
نجوم	Stars
استقرار	ƙarfafawa
إلى	dõmin
(1100	(1,100
المقاومة.	juriya.
--------------------------	--------------------------
كم	kilomita
تويج	Corolla
منع	hana
التراخيص،	lasisi,
مسلم	Musulmi
كيو	que
Nagle	Nagle
مجمع	hadadden
هلال	Moon
ربما	tabbas
إلى	wajen
كل	Kowane
==========================================	==========================================
على &amp; quot؛ أوه،	&quot;Kaitona,
Rauser	Rauser
يساري	leftist
2.5 كيلومتر	2.5-kilomita
جهود	kokarin
HAMZA	HAMZA
معنى.	ma&#39;ana.
(نيكي	(Nicki
أصدقاء	abokai
عدد أولي	Firayim
# &amp; طن.	#&gt;
أصدقاء	abokan
باري بوندز	Barry-hadar
الحمأة.	sludge.
رسول	Manzo
أوليسيس	Ulysses
دون تغيير	canzawa
فلسطين	Palestine
يتراكونازول	itraconazole
سنوات).	shekaru).
على &amp; quot؛	&quot;Kuma
415-688-8231	415-688-8231
نوبواكي	Nobuaki
غاز الأمونيا	Ammonia
).	kasance).
20Meg	20Meg
البلدان؟	kasashen?
Nowadys	Nowadys
بروكس	Brooks
غطاء	murfin
التحول	sheka
هوامش	ribace-ribace
رصدت	hange
لمعان	sheki
الرواد	Pioneers
مرحبا،	Hello,
تقنيات المعلومات	Telematics
مختلفة.	daban.
قسم	sashe
سفينة	ship
--------	--------
ضباب	hazo
اسم	Sunansa
JESUSCHRIST	JESUSCHRIST
مراقب	Monitor
: &amp; GT؛	cewa:&gt;
مرشح	takarar
باختصار	kankanen
قطع.	chunks.
عبرت	haye
(روك)	(dutse),
نفذت.	za&#39;ayi.
بشكل منفصل.	dabam.
خردة	takarce
دراسة	nazarin
كوكومو،	Kokomo,
خفي	ulterior
البنزين،	fetur,
ذلك؟	shi?
ل؟	for?
اشارة ل	refering
استخلص	deduced
بوق	ƙaho
نزع	cire
نعتقد	imani
(	(su
قطعا	shakka
(دير	(der
المضادة للفطريات	anti-fungal
عثماني	Ottoman
ارتفاعات عالية،	high-tsawo,
فقير	talakawa
منحرف،	Askew,
(	(ta
شيكاغو.	Chicago.
مفاجأة)،	mamaki),
reasonning	reasonning
سؤال	tambaya
تحسن	inganta
مراجعة	nazari,
ضمير	lamiri
ساعات	awa
تصوير	imaged
تطلب	tambayi
طلب	tambaye
unclumped	unclumped
وهذا يعني	Ma&#39;ana
(1170	(1,170
معنى	ma&#39;anar
التكرار.	Freq.
الحيوانات	dabbobi
الصور	images
غير فعال	ƙeƙasasshiya
صغير	Small
مسعف	Palmer
الأب	uban
ملايين	multimillion
قبل	gabãnin
يلال)	Nunnally)
ترتيب	Order
Alyosha	Alyosha
مفاتيح	Makullin
على &amp; quot؛ هذا من نوعها	&quot;Wannan-da-irin
منحرف)	Askew)
Lankford	Lankford
التلاميذ	almajiransa
RSEVERY	RSEVERY
كارل	Carl
الصخور.	boulders.
حيث &amp; GT؛ &amp; GT؛	cikinta&gt;&gt;
بطاقة	Card
(أين	(inda
ممثلة	wakilcin
لي	ni,
الرأس،	gangarawa,
Justification_	Justification_,
لي.	ni.
تامبا	Tampa
اتصال ومثل؛	dangane&quot;
html>	pgf@srl03.cacs.usl.edu
الولادة،	Natal&#39;,
ضار	detrimental
دور	rawa
UUNET:	UUNET:
أفضل!	Best!
I)	ni)
مؤتمر	taron
8.1	8.1,
homosexal	homosexal
الإعدادات	saituna
بكتيريا	Kwayoyin
وحي	Ruya
يسوع	Yesu
على &amp; quot؛ كامل &amp; مثل؛ &amp; GT؛	&quot;cika&quot;&gt;
سفك	zubar
لي؟	ni?
المفارقة	paradox
لمس	touch
رمد	incinerate
الحفر	craters
لذلك،	wata,
أ.	wata.
تناوب	Sãɓãwar
إجابات	amsoshin
على &amp; quot؛ الراحة	&quot;sanyin
AT)	AT)
بيع	sayarwa
كنديينز؟	Canadiens?
على &amp; quot؛ المحادثات ومثل؛	&quot;tattaunawa&quot;
_____	_____
شبكة	net
مشهد	ganinsu
رؤية	ganinsa
مفهوم &amp; GT؛	ra&#39;ayi&gt;
تنمية	raya
التلاميذ	almajiran
السجناء	fursunoni
نطاق	Range
يبدو &amp; GT؛	ze&gt;
لا	Babu
يسوع	yesu
اختراع	Ira
الكويكب	asteroid
الاخوة	&#39;yan&#39;uwanku
من:	Daga:
الخبراء	Masana
سيد	Ubangiji
الإتصالات	Communications
الصف،	aji,
040	040
معرفة	Masani
20X-60X60mm	20X-60X60mm,
إبادة	wargajewa
مغاير	hetero
جبل	dutse
الناس	Mutane
عرض النطاق الترددي	bandwith
وبطبيعة الحال،	Hakika,
،	ne,
.	ne.
رأيي).	ganina).
طول،	tsawon,
سبعة	bakwai
طريق	hanya
الفائق الدقة	ultrahigh-ƙuduri
غامر	ventured
إغلاق	ƙulli
مصباح	fitila
لغة	Yaren
AIAA	AIAA
من.	fito.
الرجال)،	maza),
هوائيات	antennas
تجنب	kauce
الالتزام	madawwama
_______________________	_______________________
ألغت.	rescinded.
فوبوس	Phobos
تعصف بها.	assirtar.
العلامة &amp; lt؛ C5xxq0.18M@cs.columbia.edu&amp;gt.	&lt;C5xxq0.18M@cs.columbia.edu&gt;
سكن	rayu
بالفرنسية	French-
كارلتون	Carlton
قرأ	Karanta
===============	===============
هو:	ne:
مشكلة	matsala
(صقور	(shaho
.	aikin.
kasassun	kasassun
هنا	nan
المشرق	Orient
منخفض	maras
طريقة إدارة آلة التصوير	Panoramic
البيسبول	Baseball
التفاف.	kunsa.
قبل	KAFIN
هيونداي	Hyundai
WinJPEG	WinJPEG
على &amp; quot؛ جعل	&quot;Yin
ماجلان،	Magellan,
تمديد	faɗi
لها	Its
(OO)	(OO)
عراك	faɗa
(رون	(ron
كلاسيكي	classic
تذاكر	tikiti
على &amp; quot؛ &amp; GT؛	&quot;&gt;
5VDC	5vdc
000	000
نشاط	ayyuka
أي	watau
شهر	watan
همفريز	Humphreys
3.1	3.1,
على &amp; quot؛ رسم	&quot;zana
يمر	Wucewa
سحرها ومثل؛	Mystique&quot;
)	na)
الصيف	rani
يوم	rana
.	na.
تطبيقات،	apps,
،	na,
إحصائيات	ƙididdiga
132،252	132,252
مقدمة	GABATARWA
أحزمة	belts
حكم	mulki
نشط	Active
html>	toml@boulder.ParcPlace.COM
هيرمان،	Herman,
حفرة	rami
أعلن	shelar
الكلمة؟	maganar?
^^^^^^	^^^^^^
ترنيمة	Zabura
أكسجين	oxygen
AL - 92-186،	al--92-186,
يسوع.	Yesu.
السفينة الفضائية	kumbon
يسوع؟	Yesu?
دقيقة.	minti.
معنى	ma&#39;ana
(رومية.	(Romawa.
فيليكس	Felix
فيلم	movie
على &amp; quot؛	&quot;yin
كل وGT.	duka&gt;
يسوع،	Yesu,
ضوء.	hasken.
كلاوديو	Claudio
يسوع)	Yesu)
عصيان	sãɓã
شرائح	chipset
مربع	square
3.1؟	3.1?
مثل الإعصار	guguwa-kamar
الهواء،	iska,
جارية	gudana
الأميركيون).	Amirkawa).
مساعدة!)	taimake!)
(بيل	(Bill
ضائع	rasa
على &amp; quot؛	&quot;Ya,
نادر	rare
يسوع وGT.	Yesu&gt;
مقابلة	hira
وGT.	suka&gt;
مرة	zarar
| &amp; طن؛ &amp; GT؛	|&gt;&gt;
توقف	tsayi
TranslateCoordinates	TranslateCoordinates
هجوم	farmaki
آل /	al-/
مارلين	marly
TIFF	TIFF
غرب	yamma
تيمونس	Timmons
حرفيا &amp; GT؛ &amp; GT؛	zahiri&gt;&gt;
الصياد	Fisher
تفاحة	apple
مكانة	tsaye
موقف	tsaya
على &amp; quot؛ &amp; مثل؛،	&quot;suka&quot;,
12 عاما	12-shekara
التي	waxanda
الذاكرة.	memory.
أسابيع	makonni
تشكيل	samuwar
6/92،	6/92,
MWM	mwm
توقف	daina
وطن.	Shi&gt;
الطريقة: &amp; GT؛	hanya:&gt;
الموت	mutuwar
الصور	Photos
html>	mlee@post.RoyalRoads.ca
إيجار	tsãge
حب	kauna
صديقة.	budurwa.
html>	v124p7kk@ubvmsc.cc.buffalo.edu
عمل	Aikin
neccacery	neccacery
عرقي	kabilanci
تغيير	Canza
ارتفاع	tsawo
هناك &amp; GT؛	Akwai&gt;
شمل	kunshe
ملامح	siffofi
يحتوي على	kunshi
خارج	fitar
تجاوز	zarce
____________________________________________	____________________________________________
1992-1993	1992/93
الاضطرابات	Perturbations
طائرة نفاثة	Jet
شركة	Inc.
قابل للشفاء	curable
تاريخ:	Date:
حالة	matsayi
ردود الفعل	feedback
لاعب	kunnawa
عمل	kasuwanci
Triantafyllopoulos)	Triantafyllopoulos)
الأصغر	karami
اليوم.	rana.
يوم	rana,
سلامة	Safety
Mitchum)	Mitchum)
مكتشف،	discoverer,
وGT؛ &amp; GT؛	da&gt;&gt;
في حين	yayin
دورة	zagayowar
القانون	Attaura
إنجلوود،	Englewood,
وهي،	wato,
معلومات)	Bayani)
الأسئلة.	tambayoyi.
مجتمع	al&#39;umma
مختلف	daban-daban
الدوافع	muradi
آدم.	Adam.
(CRAF)	(CRAF)
قيادة	shugabanci
آدم،	Adam,
اليابان،	Japan,
السماح	Bari
طيران	Flying
مدفون	binne
الأقل	ƙanƙanta
سكاكين	knifes
مسار	Track
(هانز	(Hans
html>	jaskew@spam.maths.adelaide.edu.au
باسادينا،	Pasadena,
النظائر المشعة.	radioisotopes.
جاي	Jay
الأرض والقمر	Duniya-Moon
فانكوفر	Vancouver
Faehl)	Faehl)
ثاني أكسيد الكربون.	dioxide.
الضوئية	photovoltaic
حكومة	gwamnati
نظام.	tsarin.
البنادق.	bindigogi.
المقبل.	gaba.
(اليهود).	(Yahudawa).
الخيار.	zabin.
نظام،	tsarin,
البنادق،	bindigogi,
الانبعاثات	watsi
كي	ƙi
مسرع	totur
(AIR)	(AIR)
معطيات	Bayanan
فوق	dashi
كلية،	College,
المقاومات	resistors
بالوعة	nutse
مرة أخرى))	sake))
المعلمات	sigogi
الوسائل	nufin
الخلفي)	Back)
على &amp; quot؛ electroglow على &amp; quot؛	&quot;electroglow.&quot;
أحيانا	lokaci-lokaci
آدامز	Adams
الماجستير،	Masters,
هؤلاء	wadannan
العدو	maƙiyi
تقاليد	Lore
ذيل	wutsiya
حيث	Inda
البريد الإلكتروني	email
الأعداء	maƙiya
النتائج	Sakamakon
^)،	^),
الموصل	haši
تهب	hurawa
الوجود &quot;	wanzu&#39;
الذهب	zinariya
اليهود	Yahudawa
(303)488-6120	(303)488-6120
قبل	gaban
[386enh]	[386enh]
(_______________________)	(_______________________)
. ومثل؛	yi.&quot;
طرق	hanyoyin
خير	nagari
الشرق	gabas
(مات	(Matt
سرعة	Gudun
ممتص الصدمات	damina
منخفضة.	Low.
التفاعلات	interactions
رعشة	burge
الفطرية	fungal
(	(sai
النقطة.	nufi.
الإسكندينافي	Viking
لغة	harshen
عام	general
Nagle)	Nagle)
في	ranar
النظام؟	tsarin?
في المرة القادمة؟	gaba?
انتقال	watsa
غاليلي،	Galilei,
atraction	atraction
التاريخ،	Tarihi,
laetril	laetril
(الوطني)	(National)
تفحص	scan
معلومات	Info
عقارات	kaddarorin
ارتفاع	high
بسهولة	Saukake
النظام؛	tsarin;
ماكراي)	MacRae)
فيما بعد	Baya
سطح	surface
مجيئه،	zuwansa,
العلامة &amp; lt؛ 1993Apr17.125545.22457@rose.com&amp;gt.	&lt;1993Apr17.125545.22457@rose.com&gt;
صديق	abokina
AIR	AIR
^^^^^^^^^^^^^^^^^^^^^^^	^^^^^^^^^^^^^^^^^^^^^^^
طرق.	hanyoyi.
حورس	Horus
غرب	yammacin
(Aili	(ailin
تعريف،	definition,
التشابه،	kamance,
المسيحيين،	Kiristoci,
هناك	Akwai
المسيحيين.	Kiristoci.
rigths	rigths
قضايا	al&#39;amurra
html>	xx155@yfn.ysu.edu
يوسف	Joseph
قارئ	karatu
قضايا	al&#39;amurran
اشتقاق	deriving
OR.	KO.
بحر	tẽku
مايكروسيستمز	Microsystems
غاليليو،	Galileo,
استوائي	Equatorial
(437	(437
(ريك	(Rick
صديق.	abokin.
المسافة.	nisa.
بلومبرغ،	Bloomberg,
ملف	fayil
إدارة	Management
مهدئات	placebos
نطاق	range
قلوب	zukatan
******************	******************
ارتفاع	tashi
أشهر.	watanni.
أثار	tashe
أشهر	watanni,
اقتصاد	arzikin
100 &amp; GT؛	100&gt;
عدد أولي	Firaministan
آخر ومثل؛	Ayyuka&quot;
منجم	mine
الآلهة	alloli
(بريان	(Brian
حب	soyayya
لي	mini
فولت &amp; GT؛	volts&gt;
يخفض	lowers
راديو	rediyo
803-654-8817	803-654-8817
مذهلة	dizzying
البريطانيون	British
بين الجنسين.	jinsi.
منزل الحجم	gidan-sized
علم	Science
تدفق	gudãna
عظيم)	girma)
على &amp; quot؛ الصعب	&quot;wuya
الجيران	maƙwabcinsa
الكثير	Kuri&#39;a
عظيم،	girma,
الإنترنت:	Yanar-gizo:
جهود	ƙoƙarin
2400	2,400
التناوب	rotational
رائد فضاء	jannati
أشباه الموصلات	semiconductor
الأغنياء!	arziki!
(فقط	(kawai
أغلقت ومثل؛؟	rufe&quot;?
الكلمة؟	kalmar?
سحابة مثل	girgije-kamar
يحتوي على	kunshi,
عنصر،	bangaren,
الجريمة.	laifi.
باسو	Basu
راديو شاك-	Radio-Shack-iya
34،839	34,839
على &amp; quot؛ هذا	&quot;Wannan
حجم	girman
sci.crypt	sci.crypt
حساب	lissafi
دولة	furta
ولاية اريزونا.	Arizona.
(اليونانية	(Greek
جون	Jon
(447	(447
جزيرة	Island
غير كفؤ	inept
رأيي،	ganina,
جو	Joe
معارضة	Adawa
-club	-club
سجل	rubũta
الخليج،	Bay,
قبل	Kafin
[LDS]	[LDS]
40Meg	40Meg
دقيقة	minutes
صفقة	kunshin
جرائم الاعتداء	molesters
غير مقبول	unacceptable
دلكو	Delco
ضمان	tabbacin
آثار	burbushi
إنفينيتي؟	Infiniti?
مجموع	total
أشياء &amp; GT؛	Things&gt;
جو)	Ju)
حياة	rayuwata
أي	KOWANE
السماح)	bari),
15:	15:
رادار التعادل	radar-zana
هارفي)	Harvey)
150	150
حر	free
فقط	Kawai
أنت	muku,
15،	15,
ستانلي	Stanley
`` &#39;.	``.&#39;
BBS:	bbs:
تذكر،	tuna,
رغم أن	Kodayake
تباع	sayar
على &amp; quot؛ يشعر	&quot;jin
شراء	sayan
92.8	92,8
تفاحة	Apple
التحليق	flyby
في أول الزمان	primeval
ضخ	infusions
يزارد	Wizzard
علامة	Tick
Rkba.	RKBA.
الخطايا.	zunubansu.
فقط &amp; GT؛	kawai&gt;
(215)645-6463	(215)645-6463
16،	16,
الانتظار؟	jira?
البلد.	ƙasar.
العلاقة.	dangantaka.
البلد	ƙasar,
تصنيع	masana&#39;antu
176	176
17:	17:
170	170
الآن،	Yanzu,
مسخن	warmer
_hard_	_hard_
المرضى	marasa
بدراية	sane
موعد	rendezvous
تعرف	sani
شراء،	saya,
X-النافذة	X-Window
(Brian@gab.unt.edu)	(Brian@gab.unt.edu)
أعتقد.	tunani.
نفسه.	kansa.]
التحديث	sabunta
فكرت،	tunani,
أكثر	Mafi
أعتقد!	tunani!
NCI.	NCI.
جونسون	johnson
وجدت	sami
شريط	guntu
(ديفيد	(David
الجنة	sama
(المشاركة	(post
الوقت.	lokaci.
مباشرة	mike
الوقت،	lokaci,
العلاقات	dangantakar
عنوان.	address.
عرض	mika
انتقال	yaɗuwar
عمدا	ganganci
1984 &amp; GT؛	1984&gt;
A،	Mai,
11.	11.
أرقام	lambobin
DEVICE	NA&#39;URA
Noring)	Noring)
وجدت	samu
20850	20850
شراء	sayen
الخطوط العريضة	Shaci
وquot؛ كما	&quot;Amma
html>	cramer@optilink.COM
أعرف،	san,
122	122
كوخ	Shack
ميلا)	mil)
الحكمة)	hikima)
بيع	sale
لعب،	wasa,
(	(aka
اللعب.	wasa.
الرسالة إلى العبرانيين	Ibraniyawa
أمس	jiya
تخيل	tunanin
عرب،	arab,
120	120
12)	12)
12،	12,
وGT.	haka&gt;
كوين)	Quinn)
هاتف	Phone
إطلاق	saki
معنى	ma&#39;anarta
ثانية	sake
المعالجين	Healers
أدخل	saka
(408)	(408)
أطلقت	kaddamar
التحرش الجنسي	molestation
حقيقي	ainihin
الخصائص	halaye
المتتبع	Orbiter
فلسطين؟	Palestine?
مقزز، وGT.	sickening,&gt;
ميسليف)	myslef)
Camary	Camary
13،	13,
كلارك.	Clark.
بريد	Mail
نافذة &amp; GT؛	taga&gt;
------------------------------	------------------------------
العلامة &amp; lt؛ timmbake@mcl.ucsb.edu&amp;gt؛ &amp; GT؛ &amp; GT؛	&lt;timmbake@mcl.ucsb.edu&gt;&gt;&gt;
مرح	ba&#39;a
انتظار	jiran
149	149
14:	14:
موزع	rabawa
تنبأ	annabta
********	********
شركة	kamfani
ضيق	ƙanƙan
مباراة	wasan
14،	14,
cryptoanalysis.	cryptoanalysis.
نظر	la&#39;akari
الكويكبات،	asteroids,
جميع)	duka)
كل	duka,
توري	Torre
عاصفة	hadari
مادة كيميائية	Chemical
قلق	perturbed
قطع	yanke
قسم	Sashen
منطقة	yanki
الأسواق	kasuwanni
متوسط	Bamediye
شراء	saya
شقيق،	ɗan&#39;uwansa,
شراء	saye
شراء	sayi
html>	wagner@mala.bc.ca
Latonia)	Latonia)
ودعا).	kirawo.)
(Noring	(Noring
التوسيع قاسية	Fadada-muguwar
كنيسة	Ikilisiya
الأرقام.	lambobi.
الشرائط،	streaks,
فيتامين &amp; GT؛	bitamin&gt;
أحداث	al&#39;amuran
السندات.	hadar.
بذرة	zuriya
LA	LA,
الجري،	yawo,
CRAF	CRAF
خيال	kwatanci
(مسموع	(audible
باطل	ɓãta
العلامة &amp; lt؛ 93095@hydra.gatech.EDU&amp;gt،،	&lt;93095@hydra.gatech.EDU&gt;,
قطع	yanka
readiing	readiing
المريخ	martian
المحظورة،	haramta,
مجموعات	gungu
مرض	cuta
جرس الشمالية	Bell-Northern
19،	19,
يعني؟	nufa?
html>	mouse@thunder.mcrcim.mcgill.edu
Fraering	Fraering
(أوه،	(Oh,
المايا	Mayans
VESA	VESA
RA &amp; GT؛	RA&gt;
نصب	pitching
سياحة	yawon
19؟	19?
الرئيس.	shugaban.]
&#39;من	&#39;Wanda
19:	19:
على &amp; quot؛ ستاندرد اند مثل؛	&quot;misali&quot;
حياة	rãyuwar
وجه	fuskar
مجموعة	tsararru
تعليقات؟	Comments?
هالي	Halley
أمراض	Cututtuka
رئيس	Kai
تريليون	trillionth
مفاتيح.	makullin.
تافه	tausayin
على &amp; quot؛ إذا	&quot;Idan
زئبق	Mercury
بطاقة	katin
مؤشرات	pointers
VE7GDA	VE7GDA
---------------	---------------
كل	dukan
معدات	Boats
البحارة	seafarers
التركيب.	Resp.
LDS	LDS
راقي	nagartaccen
القارة القطبية الجنوبية.	Antarctica.
سندات القادمة	gaba-hadar
الصمام	LED
الصحة ومثل؛	lafiya&quot;
لقب	lakabi
مرتبة الشرف	karrama
~~~	~~~
يمكن،	iya,
سائق،	direba,
(إسحاق	(Is&#39;hãƙa
المتهم	zargi
خلق	haifar
أساس	filaye
وGT.	sa&gt;
كين	Ken
إلزامي	wajibi
مخفض	rage
مساء	maraice
مجموعة	saita
خروف	rago
في حين	matukar
الحياة.	rai.
قرأ	karanta
مرنة	floppies
مات	Matt
ستة.	shida.
ذيول.	wutsiyoyi.
نقصان	ragu
ذيول،	wutsiyoyi,
&quot;طبيعي	&#39;al&#39;ada
فرق	bambancin
gravitacional	gravitacional
العلامة &amp; lt؛ 1993Apr4.221228.17577@bsu-ucs&amp;gt.	&lt;1993Apr4.221228.17577@bsu-ucs&gt;
الزراعة.	noma.
سلبية.	korau.
ذلك،	Shi,
زيارة	ziyartar
&quot;ثيوس&quot;	&#39;Theos&#39;
ال	Masu
الأشجار،	itatuwa,
كتابات	rubuce-rubucen
ولد،	haife,
نية	niyyar
المشاكل	matsaloli
غبار	ƙura
تصدير؟	fitarwa?
(جوردون	(Gordon
(510)	(510)
الدول الاسكندنافية	Scandinavians
(مثلي الجنس	(kishili
لعموم أوروبا	Pan-Turai
واشنطن	Washington
عراك	fada
معقول	plausible
الجبال	duwatsu
تجد &amp; GT؛	samu&gt;
عامل	factor
html>	astein@israel.nysernet.org
التغييرات	canje-canje
(كيث	(Keith
رافي	rafi
اصطدام	collisions
سواء	Shin
الموت.	mutuwa.
مسابقة	gasar
الموت،	mutuwa,
بقع	faci
100،000	100,000
مغلق	Rufe
صورة زائفة	travesty
الجمال	kyan
التعبير	Express
الرياضة	Sports
شمالي	northerly
إنفينيتي	Infiniti
تمديد	fadi
الشاهد	shaida
جبل	tudu
إخلاؤها.	kwashe.
html>	vacsc0qe@VAX.CSUN.EDU
keybd	keybd
html>	scott@asd.com
مؤشر	index
انتقائي	zababben
26/01	1-26
تعليم	ilimin
المكتب:	Ofishin:
كيبلينغ	Kipling
الألوان وGT.	launukansa&gt;
الطلب الهاتفي	dialup
سنوات	shekaru
دفع	propulsion
ديفيد.	Dawuda.
html>	starowl@rahul.net
خير	kyau
التصفيات!	playoffs!
التبغ،	taba,
تم تحويله	tuba
حركة	motsi
نبوي	annabci
أنبوب	tube
خطوة	motsa
مكافحة بندقية،	anti-gun,
عام	shekara
مقاومة	juriya
على &amp; quot؛ Borshevshky ومثل؛	&quot;Borshevshky&quot;.
تبريد	sanyaya
(آلان	(Alan
جوردون	Gordon
فايس)	Weiss)
النص المشفر	ciphertext
الجهاز)؟	injin)?
مايكل	Michael
5.0.	5.0.
بينيدكت	Benedikt
الرجال	Maza
PB170	PB170
سوريا.	syria.
M.)	M.)
النفط،	Man,
الهجرة	migrating
أعمدة	plumes
كسر والمعلمين؟	karya-malami?
الألغام!	mine!
أو،	Ko,
الموسم،	kakar,
بيتسبرغ،	Pittsburgh,
المريض	haƙuri
الألغام.	mine.
في	akan
غطاء	cover
بارمان)	Barman)
أساس	akai
شفاء	warkewa
الشفرات؟	cipher?
البعض.	wasu.
Folta	Folta
فلسطين.	Palestine.
آخرون	wasu,
1.3	1.3
رجل	Male
1.1	1.1
ذات	Shafi
ممثلة.	wakilta.
نظام	tsarin
كثيرا	akai-akai
html>	bep1@cbnewsg.cb.att.com
5 دقيقة	5-minti
العلامة &amp; lt؛ lsj4ruINNl7o@saltillo.cs.utexas.edu&amp;gt.	&lt;lsj4ruINNl7o@saltillo.cs.utexas.edu&gt;
شعر	gashi
له؟	masa?
1-2	1-2
10.	10.
10،	10,
0،14	0,14
التبديلات؟	relays?
تشفير	encrypting
إنقاذ	ceton
إعادة صياغة: &amp; GT؛ &amp; GT؛	fasara:&gt;&gt;
حقا	gaske
حاجز	shãmaki
(مالكولم	(Malcolm
intollerent	intollerent
جنيه)	fam)
البراكين.	volcanoes.
يمثل	wakiltar
كو	Kou
سينج	saing
100	100
اشترى.	sayi.
القنوات	tashoshi
مكتب	ofishin
غائب	faku
ادمونتون	Edmonton
مناقشة	shawarwari
كاهن	Vica
مقارنة	kwatanta
الأيونوسفير،	ionosphere,
مروحة.	fan.
02/01	1/2
نقاء	tsarki
قصر النظر،	myopic,
(خبز	(Gasa
تحميل مجاني،	Bure,
على الخط	on-line
ضحايا	fama
جاهل	clueless
(غاري	(Gary
آدامز.	Adams.
يشع	radiated
آدامز)	Adams)
حفظ،	ceto,
فصل	rabu
تذكر	tuna
حكم	Mulkin
شجار	Tiff
برنار)	Bernard)
_National	_National
المزدوجات الحرارية	thermocouples
MIniVas	MIniVas
انتقال	Watsin
التبديل &amp; GT؛	sheka&gt;
في الواقع،	zahiri,
الأسئلة	Tambayoyi
أمن	tsaro,
قبيح	mummuna
الأمن.	tsaro.
الكواكب.	duniyoyi.
أطلال	kufai
الكتب	littattafai
بوريش	Bures
على &amp; quot؛ T &amp; مثل؛	&quot;T&quot;
assult	assult
المريخ	Mars
الخ &amp; GT؛	sauransu&gt;
حلقات،	zobba,
شاشة	allon
قيادة	tuki
حلقات.	zobba.
على &amp; quot؛ والأمن	&quot;tsaro
يمكنك نقل وGT.	tranfer&gt;
علامة	Mark
مارك	Marc
احتياطي	ajiye
حصة	rabo
GIF.	GIF.
بلدنا.	namu.
حكم	Rule
GIF،	GIF,
بلدنا،	namu,
نصف	rabi
لي؟	mini?
الغازات	gases
لم يدم طويلا.	short-rayu.
العلاج،	far,
العلاج.	far.
جمل	ƙawãta
حصة	raba
الحرارية،	thermocouple,
سنغافورة	Singapore
مراقبوا النجوم	stargazers
ExposureMask	ExposureMask
المجالات	duniyoyin
العام الماضي	bara
أدناه.	kasa.
بيع؟	sayarwa?
مساعدة	taimako,
من أعلى إلى اليسار	saman-hagu
آلام	raɗaɗin
بلوتو)،	Pluto),
التبديلات	relays
بيع.	sayarwa.
نيل	Neal
المائتين.	Bicentennial.
السماح	bari
مسح،	barrantar,
vshield	vshield
وصية	wasiyya
ساعة	sa&#39;a
...	...
فانغ)	Fang)
سؤال	tambayar
مقدر	kiyasta
جبل	Tsauni
يوروسبورت	Eurosport
TIMES	lokatan
تأثير.	sakamako.
تخمين	tsammani
مكافأة	sakamako,
مكافأة:	sakamako:
و &amp; GT؛	kuma&gt;
الفوسفور)	phosphorus)
بلد	kasar
الكمبيوتر.	kwamfuta;
تشبرياني)	Cipriani)
مساعدة	taimakon
خطأ	bata
بكفاءة	competently
ليس	basu
قضاء	ciyar
رطانة	jargon
الكمبيوتر؟	kwamfuta?
ماثيو	Matiyu
الفاكس:	fax:
&#39;&#39;	&#39;a&#39;
الحديث).	magana).
تحليل الشفرات.	cryptanalysis.
الفاكس.	fax.
جزيرة	tsibirin
مستحق	cancanta
الوقود وGT.	makãmashin&gt;
بديل	sauyawa
النتائج	sakamakon
تجارة	ciniki
أووزيد	oozed
عبر،	fadin,
الكمبيوتر.	kwamfuta.
نافذة	taga
الكمبيوتر،	kwamfuta,
لنا	bamu
نذير	precursor
صورت	photographed
بشرة	fata
هلاك	bane
الكنديين	Canadians
البرمجيات	software
فرقة	band
(أبريل	(Afrilu
غير	tana
محفر	lumpy
الآباء	iyaye
الاستفادة،	tap,
سيارة.	mota.
لنا	tamu
المكالمات	kira
جزء في المليون،	ppm,
ساعة.	sa&#39;a.
تمثال نصفي	fasa
جميع.	dukan.
المخنثين.	bisexual.
كل	dukan,
جميع)	dukan)
لا أحد	NOBODY
مذنب	laifi
القتل &quot;	kisankai&#39;
على &amp; quot؛	&quot;wani
الأميركيون،	Amirkawa,
أو	ko&#39;
مكتوب.	rubuce.
-Karl	-Karl
الكتابة،	rubuce,
العالم.	duniya.
لون،	launi,
مما تسبب في	haddasa
عالم	duniya,
الأميركيون:	Amirkawa:
النيكل النواة	nickel-core
شاشة	allo
آخر	jũna
[الشعب]	[mutãne]
بداية	fara
المهارات	basira
الصوت.	audio.
بالتأكيد.	tabbatar.
جفاف	fari
بالتأكيد،	tabbatar,
أحداث	faru
الشبكة المحلية	lan
مقابض	iyawa
الاستشارات،	Consulting,
العلامة &amp; lt؛ 15464@optilink.COM&amp;gt.	&lt;15464@optilink.COM&gt;
اليسار،	bar,
بيتسبرغ	Pittsburgh
الصوت،	audio,
كرة الثلج.	snowball.
و	sa&#39;an
تخيل.	tunanin.
التي	wadda
تعليم	Ilmantar
بيان.	sanarwa.
بيان،	sanarwa,
Kaldis	Kaldis
SRESURRECTION ::::	&#39;SRESURRECTION::::
بحار	Mariner
شباب ليث)	matasa-Leith)
المسبار	orbiter
لعب	taka
تدور	orbited
لقب	take
مستشفى	asibiti
حكمة	Hikimar
سماد	taki
فولت.	volts.
اللون	launin
عندما	sa&#39;ad
مهم	muhimman
شاشات &amp; GT؛	fuska&gt;
عالم	duniyar
الجلوس وGT.	zauna&gt;
بعيدا	kashe
نسبة &amp; GT؛	rabo&gt;
خطوط.	Lines.
في المئة	kashi
مؤتمر	taro
البعض	sauran
لعبة شد الحبل من الحرب	Tug-na-yaƙi
ميراندا	Miranda
مع	tare
هو	tanã
الحرب.	yaki.
مفتاح	mažalli
عائلة	iyali
بندقية.	bindiga.
زبدية	tasa
&quot;التفسير&quot;	&#39;fassarar&#39;
أنت	kun
بندقية،	bindiga,
استثناء.	togiya.
معا	taru
ذيول	wutsiyoyi
لحم	naman
كف	itãcen
الاختلاط وGT.	promiscuity&gt;
حواء	Hauwa&#39;u
html>	mls@panix.com
قابل للتعديل	Daidaitacce
التماثيل	Gnomes
استغلال	tozarta
عائلة	iyalinsu
زيادة.	dadewa.
لي	Lee
تسعة	tara
الموقف.	matsayi.
العلامة &amp; lt؛ C4vG3F.Kx3@apollo.hp.com&amp;gt،،	&lt;C4vG3F.Kx3@apollo.hp.com&gt;,
مناقشة	Shawarwari
السعر	Price
محدود	iyaka
فيما بعد	baya
المضافة).	kara).
بيان	sanarwar
انتشار	shimfiɗa
إنجلترا	England
Thorson)	Thorson)
حرب	yakin
الله	Allahn
شابيرو)	Shapiro)
لك؟	ku?
سباق	kabila
فهم	fahimtar
Dr.Banzai	Dr.Banzai
فهم	hankalta
الكواكب.	planetology.
،	ku,
(0،0)	(0,0)
القانون	Law
........	........
.	ku.
الدعم)	Support)
وطن.	Yana&gt;
حركة الديمقراطيين الاشتراكيين	MDs
الوضع،	yanayin,
واسطة.	yanayin.
توفير	arziki
عزر	motif
0.45	.45
html>	dbd@icf.hrb.com
الإنجليزية	Turanci
الوضع:	yanayin:
كما	matsayin
1-800-344-4539.	1-800-344-4539.
فأر	Mouse
الجزر	tsibiran
.	yake.
،	yake,
وGT؛ &amp; GT؛	cewa&gt;&gt;
400 &amp; GT؛	400&gt;
MC)	MC)
الكنديين:	Canadians:
استبدال	gurbin
تمهيد	rebooted
روبين)	Rubin)
هو:	yake:
دقيقة	minti
OOOO	oOOO
نقد	tsabar
FJ1200 &amp; GT؛	FJ1200&gt;
مضاعفات	rikitarwa
روبين.	Rubin.
روبين،	Rubin,
X11R5	X11R5
X11R4	X11R4
الصحاري،	hamadar,
الإيثان،	ethane,
على &amp; quot؛ &amp; الأعمال مثل؛	&quot;kasuwanci&quot;
على &amp; quot؛ تسعون	&quot;Casa&#39;in
الأخطاء	kuskure
&quot;السطح،	&#39;surface,
المصنف	seeded
فعل	aikatãwa
قضية	batu
html>	kmac@cisco.com
مجموع	jimlar
عملية وGT.	tsari&gt;
سمة &amp; GT؛	halayyar&gt;
نيون	Neon
الكهنة	firistoci
اللاأدرية	Agnosticism
ماكدونيل	McDonnell
مجموعة.	range.
الأشكال	suranta
html>	hal@cco.caltech.edu
إدارة	Administration
هوندا،	Honda,
جوا	Flown
(38.8	(38.8
أعدت	shirya
قسم.	dept.
مياه الجليد	ruwa-kankara
عوامة	taso
استعداد	shirye
وصف	faye
على &amp; quot؛ ملاحظة	&quot;lura
خطوة	matsa
الذائبة	narkar
ننتقد	excoriate
html>	joshuaf@yang.earlham.edu
SETVER.EXE	SETVER.EXE
html>	munns@cae.wisc.edu
مجموعة	kungiyar
نموذج	Model
العلامة &amp; lt؛ 19613@pitt.UUCP&amp;gt،،	&lt;19613@pitt.UUCP&gt;,
البريد الإلكتروني	e-mail
المثلية و GT.	liwadi&gt;
جنس	jima&#39;i
html>	Steve.Shapiro@f440.n101.z1.fidonet.org
بعد	Nesa
هيئة	jiki
على &amp; quot؛ رخصة	&quot;lasisi
مرة	karon
Siemon	Siemon
إشارة	tunani
دقيق	rigorous
الحق وGT.	daidai&gt;
التسريب	jiko
XR250L	XR250L
أندرياس	Andreas
الصحافة الديمقراطي،	Latsa-Democrat,
ل&amp; GT؛	saboda&gt;
رؤية)،	ganin),
تيرا	Terra
قرن	karni
منخفض	low
شرف	girmamawa
لويس &amp; GT؛	Luis&gt;
المزدوج الهواء	dual-iska
سابق	Tsohon
دائري	madauwari
باتريشيا	Patricia
مخطوطات	rubutun
نجمة	Tauraro
طويل	lengthy
سكرتير خاص	p.s.
طفل	baby
دولي	International
وGT.	kan&gt;
لا	babu
مساعدة!	taimaka!
العروض	tayi
يرتفع	yakan
كوني	cosmic
LMH	lmh
العلامة &amp; lt؛ Apr.9.01.09.22.1993.16580@athos.rutgers.edu&amp;gt.	&lt;Apr.9.01.09.22.1993.16580@athos.rutgers.edu&gt;
الخدمة.	sabis.
صممت في	tsara-in
(الخميرة)	(yisti)
على &amp; quot؛ السليم	&quot;Proper
إعطاء	bada
الخدمة،	sabis,
MLS	MLS
فصل الشتاء.	hunturu.
توري	torre
رئيس الوزراء،	ƙwalo,
القيام به.	aikata.
خاص	musamman
سيسكو	Cisco
زيارة.	ziyarci.
search-	bimbinin
يعتقدن	beleive
الايثان غاز الميثان	ethane-methane
قراءة &amp; GT؛	karanta&gt;
UUCP:	uucp:
(هذا	(wannan
الأنشطة	ayyukan
Korenek	Korenek
(ريان	(Ryan
المخدرات	kwayoyi
أكثر	karin
nicad	nicad
الصواريخ ومثل؛	Rocket&quot;
_ARE_	_ARE_
المذنبات	Comets
اليهود؟	Yahudawa?
على &amp; quot؛ بندقية	&quot;gun
عرض	hadaya
مركز	Cibiyar
html>	192.100.81.100
على &amp; quot؛ همي	&quot;placebo
3 ومثل،،	3&quot;,
جميل	kyawawa
html>	lmh@juliet.caltech.edu
صريح.	outright.
من الأم	mother-
كاب	hula
ملامح	fasali
التفسيرات.	fassarori.
لا يجوز	bazai
صوت	Sauti
ديفيس	Davis
الإنترنت:	Internet:
مقيد	daure
هنري	henry
(بالمناسبة،	(Af,
إعادة تعمير	repopulation
BIND	daura
البريد الإلكتروني:	Mail:
ستالين؟	Stalin?
ديفيد	David
دم	jinin
الجبال	Duwatsu
الكرادلة	Kadina
مساعدة!	taimake!
(Starowl@a2i.rahul.net)	(starowl@a2i.rahul.net)
مهم	muhimmiyar
الأساسية	Basic
على الأقل	akalla
PCX،	PCX,
؟؟؟	???
مؤسسة	Institue
5-7)	5-7)
العلامة &amp; lt؛ May.7.01.08.16.1993.14381@athos.rutgers.edu&amp;gt.	&lt;May.7.01.08.16.1993.14381@athos.rutgers.edu&gt;
و	kuma&#39;
المورمونية	Mormonism
سابق	gabata
.....)	.....)
نصب تذكاري	tunawa
تنظيم	ka&#39;ida
موشور	Prism
الشفق	faduwar
على &amp; quot؛ شراء	&quot;Buy
(225	(225
فقط.	kawai.
أطقم	crews
مستوى	baje
بالسعة	capacitive
CAS.	CAS.
حزقيال)	Ezekiel)
فقط	kawai,
سبب	dalilin
عدة ومثل؛	dama&quot;
NatLamp	NatLamp
عودة	komawa
المرأة؛	mata;
بوكي	Bucky
احصائيات.	stats.
النساء،	mata,
5-6.	5-6.
وحدات التحكم	rinjãya
التكنولوجيا،	Fasaha,
N81	N81
كانافيرال	Canaveral
أسود	baki
مهتمة،	interested,
مفلس	fatara
بكسل	pixel
... وطن.	...&gt;
تلميح	ambato
مخبأ.	lair.
حرارة	zafin
بعدل	fairly
أرسلت	Sent
مداري	orbital
بيع	sell
على &amp; quot؛ كاف	&quot;mayalwaci
المسافة.	nesa.
أم	uwar
زائف	karya
يطير التغيير	tashi-canza
كرة	ball
بعد	post
مخبأ	cache
اليوم).	ran).
(الحياة	(Life
تريليون	tiriliyan
تأمين	amintattu
حقل	fagen
تشرين الثاني	Nuwamba
انتظر	jira
ذكر	ambata
إله)	bautãwa)
html>	m-it2691@DOC.CS.NYU.EDU
سحابة،	Cloud,
الله،	bautãwa,
الله.	bautãwa.
الماوس)	Mouse)
الحرارة.	zafi.
الحرارة،	zafi,
مدينة	garin
لعبة!	wasan!
وكالة ناسا،	NASA,
مرض	Cuta
حقوق	hakkoki
اللعبة.	wasan.
الروماني	Roman
يوم الأربعاء	badi
أكياس)	bags)
18	18th
--------------------------- وطن.	---------------------------&gt;
اللعبة؟	wasan?
html>	folta@well.sf.ca.us
مرة	lokacin
إلى:	zuwa:
أزرق	shuɗe,
الشرق)	gabas)
السعر.	price.
ل.	zuwa.
Landmann)	Landmann)
مظهر زائف	facade
السعر	price,
استبدل	Sauya
يتراجع	recedes
خشب	Itace
من.	daga.
symbolisms	symbolisms
من	daga,
ربما	Watakila
الناس	Mutanen
إلى	zuwa,
)	zuwa)
TIDSA	TIDSA
(نحن	(muna
تريتون نصف إله عند الإغريق	Triton
السؤال؟	tambaya?
الخوارزمية؟	algorithm?
مسيحي	Kirista
1742	1742a
أربعة	hudu
هالي،	Halley,
الأصل	asalin
يسوع المسيح	Kiristi
لوك	Loc
السؤال،	tambaya,
المسألة.	tambaya.
1.00	1.00
===================================	===================================
(	(wadanda
اتخذت	dauka
(800)	(800)
درجة	digiri
الخوارزمية،	algorithm,
كرات	bukukuwa
سبب.	dalili.
ماجلان	Magellan
دم	jini
رائد فضاء.	jannati.
مركز	cibiyar
رد فعل	dauki
رائد فضاء،	jannati,
حمل	dauke
welshed	welshed
خيارات	zažužžukan
الأجهزة	na&#39;urorin
قيادة.	gubar.
تحديد	ƙaddara
Schaufenbuel)	Schaufenbuel)
مساعدة:	Taimako:
أجنبي	Harkokin
LM350T	LM350T
الألوان	launukansa
الإلكترونية؟)	lantarki?)
خيط	thread
أيضا،	ma,
الهيئات	gawarwakin
أيضا.	ma.
عام 1759،	1759,
الألوان،	launukansa,
بلد	qasar
ديمقراطية	demokraɗiyya
يميل	tipped
الوجود؟	wanzu?
منظم،	kayyadewa,
18EB	18EB
مدرب	kocin
بالعكس ومثل؛	versa&quot;
جانب	gefe
الوثائق	takardun
الآن	Yanzu
Postbus	Postbus
أسرار	asirai
{UUNET	{uunet,
الطبيب.	likita.
fortay	fortay
لجنة الهدنة العسكرية	mac
-km	-km
///	///
الموضوع:	Subject:
دراجة نارية	kawasaki
MC05A	MC05A
ل	mai
الطبيب؟	likita?
رسالة	saƙon
مكان	Makan
الآيات.	ayoyi.
وGT.	yi&gt;
ومن المثير للاهتمام	sha&#39;awa
نهر	River
نفط	man
مع الأخذ	daukar
الظلام،	duhu,
الفنلندية،	Finnish,
(بيلي	(Billy
يأخذ	daukan
كعب،	diddige,
رشوة	kickback
كعب.	diddige.
الصليبيين	Salibiyyar
عام &amp; gt؛	janar&gt;
عدد	adadin
عديم الضمير	unscrupulous
التوزيع	rarraba
الأساطير	camfin
(متحدى	(kalubalanci
مميز	rarrabe
15-إن	15-The
(مكان	(Makan
10--	10--
html>	gt4417a@prism.gatech.edu
اثنين وGT؛ &amp; GT؛	biyu&gt;&gt;
غالية	tsada
بورلاند	Borland
تبادل لاطلاق النار	harba
لكن	amma
وكالة)	Agency)
إطلاق نار	harbi
الوكالة.	Agency.
على &amp; quot؛ اضحة	&quot;bayyana
عملة	kudin
يتلون	karãtun
الشحن.	shipping.
مسؤولية	alhakin
حكومة	Gwamnatin
**************************************************	**************************************************
اختبارات	gwaje-gwaje
غريغوري	Gregory
-------------------------------------------------	-------------------------------------------------
وضع	sakawa
الشحن)	shipping)
نتروجين	nitrogen
(إلين	(Elaine
المعلم	guru
معدل:	kudi:
فتحات	vents
الألغام)؟	mine)?
نطاق	sikelin
حكمة	hikima
المال،	kudi,
&quot;دوران	&#39;juyawa
صلاح	alherin
بيان	sanarwa
رئيس	shugaba
وفقا ل	cewar
___________________	___________________
إجابة	amsa
القاضي	hukunta
الجسيمات النيزكية الدقيقة،	micrometeorites,
تذكر	ambaci
html>	lmh@shakes.caltech.edu
MS-ويندوز؟	MS-Windows?
شكرا لك!	gode!
Joshuaf	Joshuaf
لماذا؟	Me?
23:17:25	23:17:25
الدمار.	halaka.
..:. &#39;	..:.&#39;
html>	Cl056@cleveland.Freenet.Edu
شكرا لك.	gode.
شكرا لك،	gode,
[إدراج	[saka
اليهود،	Yahudawa,
حفظ	ceto
زيارة	ziyarci
اليهود.	Yahudawa.
عظيم	Great
مناقشة	debating
الأيام؟	kwana?
بعد الخروج	bayan-kashe
ماء	ruwan
ميج	Meg
قرن،	ƙarni,
فلكي	astronomical
أن.	cewa.
أن	cewa,
NHL	NHL
sattellite	sattellite
قدم.	ƙafafunsa.
معدن	karfe
ما يلي:	cewa:
تورونتو	Toronto
قوة	karfi
ولاية فلوريدا.	Florida.
البحارة	Mariners
تجربة	fuskanci
Parsli	Parsli
غوثري	Guthrie
التسلسل الزمني.	Chronology.
المسيحية.	Kristanci.
الغموض.	asiri.
المكافآت،	kari,
ملحقات)	kari)
نوافذ	Windows
مجموعة	rukuni
ثلاثة &amp; GT؛	uku&gt;
المياه.	ruwa.
أقواس،	arcs,
بكتيريا	kwayoyin
المنحدرات	cliffs
ويليامز	Williams
SMARTDRV.EXE	SMARTDRV.EXE
جريج،	Greg,
مكتب،	ofishin,
^^^^^^^^^^^^^^^^^^^^^^^^^^^^^	^^^^^^^^^^^^^^^^^^^^^^^^^^^^^
عمدا.	ganganci.
حقيبة ظهر	knapsack
بندقية.	gun.
html>	km@cs.pitt.edu
كيفن	Kevin
فيليب)	Phillip)
نفط	Man
النسب المئوية.	percentages.
شاشات	fuska
هاتف	Wayar
الرقم.	adadi.
دايتون	Dayton
A	Mai
في الواقع	Hakika
صعب	wuyar
ماك	Mac
العنق	wuyan
عطلة	hutu
نيويوركر،	Yorker,
كبريتي	sulfuric
أشهر)	months)
دوامات	swirling
مقاومة	Impedance
كتابي	rubuce
طاقة	kuzarin
html>	rls@uihepa.hep.uiuc.edu
فرنسا	Faransa
أن	cewa
طيران	guje
التصدع.	fractured.
الكذب	kwance
مايو	May
الوجود.	wanzu.
عد	kidaya
الوجود،	wanzu,
html>	ethan@cs.columbia.edu
القليل	kadan
NET	NET
خاص	takamaiman
الدول	jihohin
مؤخرا	kwanan
الأطفال	&#39;ya&#39;ya
قائمة	list
الهاتف:	Waya:
(بينيدكت	(Benedikt
أزرق	&#39;blue
اكتب.	irin.
فقط	kadai
استنادا الظاهري-	rumfa-tushen
يدور	spins
تلقى	karbi
غاضب	fushi
من الصعب،	wuya,
--------------------------------------------------	--------------------------------------------------
مستحق	cancanci
بالضبط	daidai
وطن؛ &amp; GT؛ &amp; GT؛ &amp; GT؛ &amp; GT؛	&gt;&gt;&gt;&gt;&gt;
كوخ	shack
سلاح ناري.	firearm.
الآن	NOW
1975	1975
(إعادة:	(Re:
سلاح ناري؟	firearm?
التطبيق.	aikace.
اعتقد	zaton
1977	1977
1979	1979
فهرس	Catalog
شهادة ومثل؛	wasiya&quot;
فيشر)	Fisher)
التواء	buckling
الدفع عندالتسليم	C.O.D.
خلية	cell
محسوب	lasafta
العليم،	Masani,
_____________________________________________________________________	_____________________________________________________________________
- وطن؛ &amp; GT؛	-&gt;&gt;
مداخن	stacks
طبخ،	dafa,
1990	1990
alyoung@kiwi.ucs	alyoung@kiwi.ucs
كوك.	dafa.
المسألة،	batun,
7.00.	7,00.
486/33	486/33
اتخذت	Dauka
ديموس.	Deimos.
الاسم.	sunansa.
لكن	Amma
سياسي	siyasa
منقطعة النظير.	unrivaled.
عقد	kwangila
الشجب	reprehensible
الإنجازات	nasarorin
شغل،	cika,
اللوحة الأم.	motherboard.
كارامازوف	Karamazov
SMALL.	qarami.
1991	1991
تركيب	composing
1992	1992
معظم	mafiya
القلوب.	zukatansu.
جانيميد،	Ganymede,
1993	1993
1994	1994
LM350K.	LM350K.
سلطة المصادر الطبيعية	NRA
1999	1999
| &amp; طن.	|&gt;
الحركة.	motsi.
اقتراح	tsari
كيف	Yaya
بؤس	mũnin
أمن	tsaro
مع.	tare.
الأنبياء	Annabãwa
زينو	ZENON
يكون؟	kasance?
مذكرة	Note
سمك	kifi
تصميم	tsara
لوح التزلج	skateboard
رمح	shaft
حارس	tsare
و&amp; GT؛	wani&gt;
الإحداثيات	co-ordinates
أليس،	Alicea,
الرياح	iskõki
03:31	3:31
تتأثر	shafa
مدير،	sarrafa,
القيادة.	tuki.
العلامة &amp; lt؛ 1993Apr22.153000.1@vms.ocom.okstate.edu&amp;gt؛ &amp; GT؛	&lt;1993Apr22.153000.1@vms.ocom.okstate.edu&gt;&gt;
.	kasance.
ذات	shafi
،	kasance,
تعلم	Koyi
القضاء	shafe
في الواقع	haƙiƙa
------------------------------------------	------------------------------------------
(360	(360
(العودة)	(baya)
متاح	samuwa
ماكراي	MacRae
المهنية،	sana&#39;a,
الخطايا	zunubanmu
&quot;المنشطات&quot;	&#39;doping&#39;
مزيج	Mix
القيادة؟	tuki?
قصف	bombarded
تنظيم	ordering
دمل	tafasa
العودة)	baya)
أدنى	sassauta
في وقت لاحق،	baya,
العودة.	baya.
موسيقى	kida
الصحة	lafiya
الوديان،	gorges,
استقراء	extrapolation
وحيد	guda
(NIV)	(HAU)
العلامة &amp; lt؛ thomasp@ifi.uio.no&amp;gt.	&lt;thomasp@ifi.uio.no&gt;
الجودة؟	quality?
ونحن،	mu,
ميت	matattu
ODDS	shaho
لنا.	mu.
خارج	fita,
مركز	hedkwatarsu
html>	carl_f_hoffman@cup.portal.com
كل شخص	Kowa
html>	jodfishe@silver.ucs.indiana.edu
html>	shapiro@sofbas.enet.dec.com
جولة	gudu
نحن؟	mu?
القضية.	batun.
يستريح	Allaha
العلامة &amp; lt؛ 1993Apr16.173252.7393@asd.com&amp;gt،،	&lt;1993Apr16.173252.7393@asd.com&gt;,
(الغربية	(yamma
استقراء	extrapolating
مزدهر	thriving
قوة	Tilastawa
إطفاء &amp; GT؛	bice&gt;
. فوق &amp; GT؛	sama.&gt;
الأسوأ من ذلك،	muni,
جاف	bushe
المقدمة	bayar
ما هو أسوأ.	muni.
كريسويل،	Kawaguchi,
العمر.	haihuwa.
بعد	bayan
صيانة،	tabbatarwa,
--- وطن.	....&gt;
طبقات	yadudduka
وجدت	sãmu
الكيمياء الضوئية	photochemistry
-----------------------------	-----------------------------
(لاري	(Larry
ستيف.	Steve.
نحن	mun
المؤمن	theist,
عقد	riƙe
قليلا.	kadan.
html>	slegge@kean.ucs.mun.ca
اتخذت	riƙi
وجدت	sãme
وكالة ناسا	NASA
فأر	linzamin
المبررات	justifications
فريق،	tawagar,
فريق.	tawagar.
الله،	Allah,
احد،	ɗaya,
الله.	Allah.
مهلا،	hey,
تقارير	rahotannin
(A	(wani
فعل	aikatawa
الأعداء	makiya
بروكلين،	Brooklyn,
عدالة	shari&#39;a
تدفقت	flowed
أورانوس	Uranian
السيطرة، البديل، ديل	Ctrl-Alt-Del
1200-1500.	1200-1500.
مركبات	Ɗari
أنثى،	mace,
نحن	Mun
حفظ	cece
هؤلاء	wadanda
(323	(323
انقسام	tsaga
عالية السرعة	high-gudu
لحظة وGT.	yanzu-yanzu&gt;
حفظ	ceci
المرض ومثل؛	cũta&quot;.
مناقشة	Tattaunawa
القادة	shugabannin
كو)	Kou)
حامض.	acid.
ارييل،	Ariel,
netters،	netters,
====================================	====================================
أخدود	tsagi
عالم	Duniya
إجابة	Amsa
إيجار	tsage
ستيفن	Steven
السماوات	sammai,
العلامة &amp; lt؛ wnk.734824081@aquifer.geology.uiuc.edu&amp;gt،،	&lt;wnk.734824081@aquifer.geology.uiuc.edu&gt;,
جمع	tarin
ناقص	ɗebe
الخروج من الملة	theists
أوج	culmination
5.25	5,25
Nicji	Nicji,
أن	Cewa
-dk	-dk
منحرف	fãsiƙai
غاب عن النظر	nisa-jẽfa
أكد	tabbatar
المسيح	KRISTI&#39;S
الجدول.	tebur.
نسخة	version
؛-).	;-).
كلية الوجود	ubiquitous
ميل	mil
وصفت	labeled
تحت	Ƙarƙashin
الآن؟	yanzu?
أبدا	taba
بطارية	baturi
(818)	(818)
فخ	tarko
زيادات	qara
بطاريات	batura
[	[shi
الآن،	yanzu,
... &amp; قووت]؛	...&quot;
الآن)	yanzu)
بقعة	tabo
كور.	Kor.
الآن.	yanzu.
مرشح	tace
ربما	kila
الأرض.	Qasa.
الصحة و GT.	lafiya&gt;
وحده.	kadai.
نص	rubutu
مارتن	martin
أهمية	dacewar
إرسال	rubuta
مغنطيسي	&#39;Magnetic
الجاذبية	Gravitational
كتب:	rubuta:
1947	1947
1949	1949
دراجة نارية	Babur
و	Sa&#39;an
ورقة	takardar
بالتأكيد	haƙĩƙa
تطبيقات	Aikace-aikacen
سيد	Mr.
كيلو	kilo
مكتوب.	rubuta.
الكتابة،	rubuta,
تكنولوجيا	Technology
شفاعة	cẽto
1959	1959
وGT.	yadda&gt;
القيمة).	darajar).
سلبي	Mummunan
حصة	share
أكثر كثافة	denser
صورة	gunkin
باري	Barry
هلام	jelly
INFJ	INFJ
reparented	reparented,
الكتاب المقدس و GT.	Mai-Tsarki&gt;
===========================	===========================
ورقة:	takarda:
عقلية	haukan
أنت	kika
1969	1969
المحكمة.	kotun.&#39;
1962	1962
1964	1964
[يسوع]	[Yesu]
الخدمات اللوجستية	sarrafawa
(بعض	(wasu
نسعى جاهدين	jihãdi
عبر.	fadin.
(راي	(Ray
الوقود النووي المشع)	INF)
اذهب	tafi
(310	(310
----------------- وطن؛ &amp; مثل؛	-----------------&gt;&quot;
