ملفات	Fayllar
مائة	yuzdan
XR650L	XR650L
اقتراح	taklifni
(إريك	(Erik
على &amp; quot؛ سحابة	&quot;bulut
535	535
تنمية	rivojlantirish
الفضاء	Kosmosdan
كهنوت	ruhoniylikni
طائرة نفاثة	jet
حساسية	jilo,
بريد	pochta
أوربت	orbitalar
#	#
العمل،	mehnat,
مجموعات:	Guruhlar:
جيمس	James
تشرين الثاني	noyabr
$	$
*	*
فقط	Yagona
+	+
(جون	(Jon
(	(
الشمال والجنوب	shimoliy-janubiy
)	)
accusors	accusors
على &amp; quot؛ فارغة	&quot;bo&#39;sh
فريق	Team
.	.
RKBA	RKBA
/	/
،	,
السجناء	mahbuslar
-	-
ونتيجة لذلك،	natijasida,
3	3
2	2
عاد	qaytdi
1	1
7	7
6	6
5	5
رجل	odamni
4	4
:	:
9	9
8	8
العلامة &amp; lt؛ 94318@hydra.gatech.EDU&amp;gt.	&lt;94318@hydra.gatech.EDU&gt;
معنى	ma&#39;no
أخرق	Gauche
=	=
المواصفات	spec
D	D
رشوة	Kickback
النرويج	Norvegiyada
البيئة	muhitni
E	E
F	F
SetWUTime	SetWUTime
@	@
A	A
B	B
الدعم	qo&#39;llaydi
C	C
L	L
وGT،،	faoliyati&gt;,
لأنه،	tufayli,
M	M
H	H
أنا	I
.	tufayli.
J	J
هو	U
تي	T
تثقيف.	tarbiyalang.
على &amp; quot؛ I	&quot;Men
(713)	(713)
Q	Q
S	S
R	R
(ولكن،	(balki,
\	\
_	_
^	^
الضغط	bosish
حكومة	hukumat
X	X
مزلاج	qo&#39;lga
1846	1846
واع	ongli
html>	mmm@cup.portal.com
أدوات	asboblarini
ز	g
ج	c
ل	a
العلامة &amp; lt؛ 1r10jcINNt1g@lynx.unm.edu&amp;gt.	&lt;1r10jcINNt1g@lynx.unm.edu&gt;
ليس	berilmaydi
في	yilda
فرقة	tarkibda
س	o
السكان	aholiga
سعر	narxi
م	m
ميثاق	ixcham
ط	i
طيران	uchish
ث	w
الخامس	v
هو	u
حديث	so&#39;zlashish,
التجريبية وGT.	empirik&gt;
520	520
ص	p
ستيف	Stiv
~	~
وكيل	qanotga
|	|
س	x
الإنجازات	yutuqlar
الوزن	og&#39;irligi
أتساءل؟	Wonder?
أعجبتني	yoqdi
الغربي	g&#39;arbiy
البؤر الاستيطانية	karakollardan
ميلنك)	Melnick)
منذ فترة طويلة،	uzoq,
مملكة	shohlik
على &amp; quot؛ فتح &amp; مثل؛،	&quot;ochiq&quot;,
الضغط	bosimi
المنظمين	muharriridan
JPEG،	JPEG,
،	qayta,
0.14	0.14
html>	ocom.okstate.edu
MAX641	MAX641
580	580
آدم	Adam
GIF	GIF
الزعيم؟	rahbar?
583	583
تأريض	tuproqli
وعود	va&#39;dalarining
معدل:	darajasi:
(__)	(__)
من	olishga,
مفرط	haddan
على &amp; quot؛ مؤقتا	&quot;vaqtinchalik
تقارير	hisobot
المناطق،	hududlarida,
مجانا.	ochiq.
عدد:	raqami:
مفتوحة،	ochiq,
XBEL	XBell
مسحوب	chiziladi
الشمس،	Quyosh,
لواء	brigadasi
بسبب ذلك.	tufaylidir.
559	559
منتظم	muntazam
المناطق	hududlarida
ومع ذلك،	birga,
خسارة	yo&#39;qotish
علم	xabardordir
سكر	Sugar
الشركات	kompaniyalari
LPT1	lpt1
إدمان	giyohvandlik
أقول،	aytaylik
سيكون.	o&#39;tadi.
المواد	materiallar
الوعظ.	va&#39;z.
السكان	aholining
متهم	zaryadlangan
الذاكرة،	xotirasida
انقر	bosing
pgf@srl02.cacs.usl.edu|Like	pgf@srl02.cacs.usl.edu|Like
.	olingan.
أقل من	ostida
الرواد،	kashshof,
تقسيم	Division
بقيادة	boshchiligida
كما	sifatida
الرجال،	guys,
المحيط	okean
اتجاه	yo&#39;nalishda
قريب	yaqin
(آرثر	(Artur
عرض	kengligi
TASCO	Tasco
المراجع	murojaatlarni
DR250ES	DR250ES
وتحدث.	suhbatlashdi.
صعب	murakkab
الغربية.	vesterman.
دين	dinim
تباهى	maqtana
وطن؛ &amp; GT؛	&gt;&gt;
في	ichidagi
الجذور،	ildizlari,
بيئة	muhitda
كثافة	zichligi
ديني	diniy
تدفق	oqimining
نرى.	ko&#39;rishadi.
النبي.	Payg&#39;ambar;
المخلفات،	Detriot,
معرفات	identifikatorlari,
الرعاية &amp; GT؛	bo&#39;limi&gt;
PATH	PATH
فقط	shunchaki
.	etilgan.
معنى،	ma&#39;no,
لي	meni
مع الأخذ بعين	hisobga
DEVICE	QURILMA
غامض	sirli
المعادلات التفاضلية	termoq
متوسط	o&#39;rtacha
الفلسطينيين	Falastinliklar
مما لا شك فيه.	shubha.
بائع	sotuvchi
الماء السائل	suyuq-suv
ثقيلة المظهر	og&#39;ir-qarab
دفيئة	issiqxonada
بين	orasida,
مكان	joy
نظيفة،	tozalaydi,
مفهوم	tushunchasini
وGT.	mumkin&gt;
إلى الوراء	qaytib
المعنى،	ma&#39;noda,
عدد	raqami
مكاتب	vakolatxonalar
سحاب	bulutlar
تحويل	Converter
التكامل	integratsiya
وGT.	xil&gt;
الإنترنت:	internet:
تشمل	kiradi
على &amp; quot؛ الخميرة	&quot;xamirturush
وأوضح.	bayon.
010-A	010-A
استثناء	mustasno
أنا	men,
التصاميم	dizaynlashtirilgan
سيكون	qilinadi
المطلوبة.	majbur.
أدان	mahkum
4H7	4H7
فلسفي	falsafiy
غربا	g&#39;arbga
قديم	eski
مقدمة	echilishi
وراء الخبر	indepth
الإعداد	sozlanmasi
1ff &amp; GT؛	1ff&gt;
أن تكون	Bo&#39;lishi
تيار	Hozirgi
الشمس	Quyoshga
باب ومثل؛	eshik&quot;
دواء	Tibbiyot
وكالة ناسا	NASAning
CIP	jip
ابدأ)	boshlash)
ممتلكات	mulk
ذهبنا	bordik
نبتون	Neptune
على &amp; quot؛ الأبيض	&quot;oq
المثارة.	ko&#39;tardi.
بكثير.	olmas.
حول	to&#39;g&#39;risida
ميرين	tranfer
المكونات،	qismlariga
دقيقة.	daqiqa.
الاتجاه،	yo&#39;nalishi,
على &amp; quot؛ بمعنى ومثل؛	&quot;hislar&quot;
في الجزيرة،	orolida,
فترة	davrning
DOUBLE_BUFFER	DOUBLE_BUFFER
500	500
على &amp; quot؛ البديل &amp; مثل؛	&quot;muqobil&quot;
خلية	hujayra
--------------------------------------------	--------------------------------------------
00:26	12:26
في الواقع،	Aslida,
إنتاجية	unumdor
سكرتير خاص	P.s.
إدموند	Edmond
العراق	Iroq
آثار	ta&#39;siridan
محور	tizmasiga
نسخة	nusxasini
المضيفين	mezbonlar
الأعمال.	ish.
kludgy	kludgy,
المذنب	cometa
توسع	kengaytirish
نيبتون	Neptun,
طبل	drum
غطاء	qopqoq
5.7	5,7
المراقبين	kuzatuvchilar
شتاين)	Stein)
ودعا)	chaqirdi)
5.0	5.0
عينة	namuna
خيارات	variantlari
1870	1870
الكاميرا	mashinasini
^^^^^^^^^^^^^^^^^^^^^^^^^^^^^^^^^^^^^^^^^^^^^^^^^^	^^^^^^^^^^^^^^^^^^^^^^^^^^^^^^^^^^^^^^^^^^^^^^^^^^
763-5889	763-5889
تسجيل	Ro&#39;yxatdan
ليس	berilmaydi,
آب	avgust
3: &amp; GT؛	3:&gt;
ممتع	qiziqarli
يد	qo&#39;l
هل	olasizmi,
html>	timmbake@mcl.ucsb.edu
إلى	qilishga
هل.	olasizmi.
نافذة	Window
Kabolsuz	Kabolsuz
بنتيوم	Cyrix
على العكس تماما	aksincha
في نهاية	uchida
نصيحة	maslahat
الوعد	va&#39;dasiga
من أنت؟	olasizmi?
إله	xudosi
العالم	olamlar
علم الآثار	arxeologiya
الجزر	orollari
منشور	nashr
16-169	16-169
من حيث	jihatidan
قاعدة البيانات	bazasi
شمس	quyosh
تقريبا	Deyarli
صلة	ulanish
موسمي	mavsumiy
التحكم ومثل؛	nazorati&quot;
1ff	1ff,
ما يدعو للقلق	tashvishlanib
ألف	mingdan
الخيال العلمي	ilmiy-fantastik
احتياطي	zahirasi
الخ	Etc
شرح.	tushunib.
أسفل	pastga
اليهود وGT.	yahudiylar&gt;
فعل	qilishim
اتصالات	kontaktlar
Cyric	Cyric
NUETZMAN	NUETZMAN
يلات	qamchilagan
الكتب	Yozuvlarga
هنا،	erda,
الشروط	sharoitida
الجيش الجمهوري الايرلندي	Ero
FTP	FTP
هنا.	erda.
علاج	davolanish
العلامة &amp; lt؛ sl3b+@andrew.cmu.edu&amp;gt.	&lt;sl3b+@andrew.cmu.edu&gt;
(زائد،	(plus,
مسلم بصحته	qabul
تصميم	mo&#39;ljallangan
دين	e&#39;tiqod
هوندا	Honda
superencipherment	superencipherment
من آن لآخر	vaqti-vaqti
العلامة &amp; lt؛ 1rbn60$gs7@usenet.INS.CWRU.Edu&amp;gt.	&lt;1rbn60$gs7@usenet.INS.CWRU.Edu&gt;
كندا	Kanada,
وGT.	bo&#39;ladi&gt;
خرافة	irim
فصل	alohida
الحياة	hayotida
انحطاط	nasli
مرة	vaqt
في نهاية	tugagach
(82178	(82,178
الإنسان	Inson
محفر	topaklı
لا شيء	vaqo
واحدة-	bir-biridan
(&#39;ريال مدريد&#39;	(«real»
البنجابية)	Panjobcha)
خاص).	maxsus).
إنتاجية	mahsuldorlikka
متقدم	ilg&#39;or
ينبغي	kerak
نفرح.	quvonamiz.
حب	muhabbat
html>	noring@netcom.com
طرد	otilishiga
688-8231	688-8231
الطاقة،	energiyasi,
XXX	XXX
دخل.	anglatdi.
طيران	uchib,
المذنب	kometa,
الطيران.	uchib.
المجمدة.	muzlatib.
إبهام اليد	thumb
html>	hays@ssd.intel.com
أثقل	og&#39;irroq
الآراء.	fikrlar.
...........	...........
شخص ما	Kimnidir
عدد	soni
تيار	joriy
أدنى	pastki
وGT.	bor&gt;
،	esa,
عمل	ish
استسلام	taslim
الشمس	Quyoshni
على &amp; quot؛ I	&quot;men
تساي)	Tsai)
.	qilinadi.
أرض	Earth
متاح	mavjud
مقارنة،	taqqoslab,
11:25	11:25
المزيد	yanada
(604)	(604)
كعب	tovonini
GMT &amp; GT؛:	GMT&gt;:
غمرت	bosmoqchi
سيفيم	sevinglar
حرق	yondirib,
بيلاطس	Pilat
الخلافات	tafovutlar
مرور	trafikni
PPM	PPM,
أشياء	narsalarni
تربة	tuproqqa
اللعب	o&#39;yinchoqlar
نظرت،	qaradi,
أقرب	yaqinroq
الكلام	gapiradigan
سلاح	qurol
لمس	tegish
من الصعب	qiyin
باور	PowerPC
الحق وGT؛ &amp; GT؛	o&#39;ng&gt;&gt;
(الذاكرة	(xotira
قادمة من؟	kelayotgan?
العلاجات	Muolajalar
تسجيل	ro&#39;yxatdan
عنيف	zo&#39;ravon
أنفسهم	o&#39;zlari
العلامة &amp; lt؛ rauser.734062608@sfu.ca&amp;gt.	&lt;rauser.734062608@sfu.ca&gt;
كروفورد)	Crawford)
قشرة)	Rind)
الإنترنت	Internet
زيتي	moyli
============ ECHO	============ECHO
في المساء،	kechqurun,
عمل	biznes
حذف	o&#39;chirilgan
بالضبط	AYNAN
طلاب	talabalar
Topspeed	premade
تنظر.	sol.
خواتم	halqalar
القارات	qit&#39;ada
يقول	Deydi
مسبار	prob
البنطي	Pontiy
فوق	yuqorida
جعل	qilmoq
توماس	Tomas
مسافرين	sayohatchilar
المحبة)	mehribon)
بقي	Qoldi
موافقة	roziligi
الذهب	tillo
فريق	jamoasi
بنيوي	tarkibiy
قطر،	diametri,
هاوية	tubsizlik
html>	jaskew@spam.maths.adelaide.edu
لا ينسى	unutilmas
معظم	Eng
فينوس	​​Venera
وGT-المعلمين الزائفة.	Psevdo-o&#39;qituvchi&gt;
كلينت	Clint
تصوير	fotosuratlar
واضح	ochiq-oydin
التقنيات،	Technologies,
صنبور	teging
اتفاق	Accord,
الوزن	vazn
المخنثين	biseksüel
الأردن	Jordan
تنتظر.	kutayapmiz.
قطاع	soha
عرضة لل	moyil
دعا.	ataladi.
كلمة	so&#39;zning
القدس	Quddusda
سمعت	eshitdim
الأهداف،	maqsadlari,
حياة	hayotini
مارتي	Marty,
انتهى)	tugagan)
باطل	yaroqsiz
مصباح	chiroq
تتويج	kulminatsion
طاقة	energiyasidan
المفتاح ل	kaliti
1.770	1.770
percieved	percieved
لماذا	NEGA
(المرأة	(Ayollar
أسطورة	afsona
-391	-391
؟] ومثل؛]	ning?]&quot;]
العثمانيين	Usmonlilar
مشفرة	shifrlangan
الحالات	hollarda
مرح	quvnoq
كولومبيا	Columbia
أكثر	ko&#39;proq,
مزقتها	yirtilib
الأصل	Original
وأكثر من ذلك.	ko&#39;proq.
دراماتيكي	dramatik
جاف	quruq
بعد	post,
(بيبي	(chaqaloq
لعبة شد الحبل من الحرب	tug-of-urush
غير واضح	noaniq
قارب	qayiq
والأمبير.	&amp;
الرقصات	Dances
تتبع	ergashish
العلامة &amp; lt؛ C5r60r.4ID@megatest.com&amp;gt.	&lt;C5r60r.4ID@megatest.com&gt;
html>	rscharfy@magnus.acs.ohio-state.edu
العمل	ishlaydigan,
لكن	lekin
على &amp; quot؛ السماء	&quot;osmon
خدمة	xizmatini
سمعت؟	eshitdi?
G20	G20
بشكل كبير	sezilarli
&#39;	«Agar
اليوم	bugungi
تدفق	oqib
الصربي	Serbiya
إسرائيل	Isroilga
قال.	ta&#39;kidladi.
الإنتاج	chiqarila
دليل	dalil
الذي	kim
اهدر	behuda
البرمجيات	dasturiy
.4ID	.4ID
نظام	tizimiga
وظائف	postlar
لويس	Louis
دور	o&#39;rnini
البعض	boshqa
حماية ومثل؛	himoya&quot;
مدير	boshqaruvchisini
طريقة	usuli
#	#,
إذا كنت ترغب في	istasangiz,
معنى	ma&#39;nosini
على &amp; quot؛ والأمن	&quot;xavfsizlik
القشرة	qobig&#39;ini
نيزك	meteoroid
العرب	arablar
أرسلت.	yubordi.
خوارزمية	algoritmi
أنا	qilaman
فوق بنفسجي	ultrabinafsha
تشارك	shug&#39;ullanadi
354-1333،	354-1333,
حسن النية،	niyat,
#:	#:
401	401
400	400
هكذا	Xo&#39;sh
ويسكي	viski
Henly	henling
ساعة	soat
وطن.	Yuqori&gt;
الضغط	bosimli
المحلية،	mahalliy,
Cryptologia	Cryptologia
أشياء	narsalarga
كنا محظوظين.	omadli.
ناد	klub
على &amp; quot؛ ^^^^^^^^^^^^^^^^^^^^^^^^^^^^^^^^	&quot;^^^^^^^^^^^^^^^^^^^^^^^^^^^^^^^^
عمل	harakat
1610	1.610
مقدما	oldindan
عنيد	qaysar
(62 ميل)	(62-mil)
تأثير	ta&#39;sir
زينة	bezaklar
اقتراح	taklifi
إجابة	javob
عديم الفائدة	foydasiz
أنا!	qilyapman!
مجموعة	guruhini
الحب	SEVGINI
غير الأطباء	non-shifokorlar
أنا	qilyapman,
عن كثب	yaqindan
عدد صحيح	integer
أسباب	sabablari
أمن	securital
ثانية	qayta
عموما،	qaralganda,
!!	!!
أنا.	qilyapman.
الحريات	erkinliklarini
تضحية	qurbonligi
فهم	tushunish
html>	artmel@well.sf.ca.us
(______	(______
في وقت مبكر	erta
جريمة	Jinoyatchilik
أنا؛	qilyapman;
مصلحة	foyda
هيئة	body
************	************
ألفيس	Elvis
أن reponse	reponse
مادة كيميائية	kimyoviy
14-19	14-19
مواطن	Milliy
غطاء	qoplama
(كارل	(Karl
مارتن،	Martin,
انت ذاهب الى القيام به؟	qilmoqchisiz?
التي	qaysi
العلامة &amp; lt؛ RVESTERM@vma.cc.nd.edu&amp;gt.	&lt;RVESTERM@vma.cc.nd.edu&gt;
html>	engp2008@nusvm.nus.sg
الجنيه)	funt)
إذا)	bo&#39;lsa,)
كندا	Kanada
سابق	Avvalgi
كين	ken
التكنولوجيا.	Tech.
مكتب،	paneli,
سحابة	bulut
على &amp; quot؛ عالية	&quot;yuksak
الوصايا	amrlarning
التطبيق	dasturni
الجسم.	tanasi.
صحيح	to&#39;g&#39;ri
القدرة على	imkonini
35789	35.789
وGT.	u&gt;
دور،	o&#39;rni,
العروض	taklif,
تعيش	salqinlash
قرون	asrlar
أمواج	to&#39;lqinlar
مشجع	dalda
100 &amp; GT؛ &amp; GT؛	100&gt;&gt;
مصدر	manbai
نزع	chiqarib
08:31	8:31
ركوب	chiqishdan
النظام	tizimida
أوروبا	Evropa
معروف	nomlanuvchi
أرسلت	yubordi,
الجيران	qo&#39;shnilari
الجليل	Jalilalik
بوسطن	Boston
مصنع	o&#39;simlik
عاريا،	yalang&#39;och,
الشمس،	Sun,
نفقات	xarajatlar
عاطفي	hissiy
حيوية	animatsiya
نعمة	inoyati
في مثل هذه الحالة،	Bunday-va-,
الآلهة	xudolarga
خطوط.	liniyalarida.
[ستسن]	Stassen
كنت	edim
جسر	ko&#39;prik
سمعي	audio
قهري	jabbor
أسباب	sabablarini
emulyatorlarni	emulyatorlarni
خرج	chiqdi
(وعادة ما	(odatda
467	467
نية	niyati
- وطن.	-&gt;
أولا،	birinchi,
التفوق	afzallik
مصهور	erigan
تجاهل	e&#39;tiborsiz
الصورة	ning
ش.	o&#39;qib.
الذهب	oltin
تليها	ta&#39;qib,
قرأ	o&#39;qib,
بسهولة	osongina
نصف	yarim
التي	olgan
الجدائل	ringlets
هوية	kimligi
سائق	Driver
كل	hammasi
على &amp; quot؛ &amp; مثل؛،	&quot;ko&#39;rish&quot;,
ضل	adashgan
مختار	Tanlab
بعيد	masofadagi
*	*,
منطق	mantiq
إلى	gacha,
**	**
الفضاء	koinot
لإذابة	eriy
قيامة	tirilmas
سو،	Sue,
واي	Wai
كوكب المشتري	Yupiter
في	yilda,
اليسار	Chap
خارج	amalga
في.	yilda.
مجموعة	guruhiga
استيقظ	uyg&#39;otishning
القانون	Qonunni
أولا	birinchi
المقعدة	zaiflashtirish
ما	nima
(الآن	(hozirga
+1	+1
++	++
العشاء.	supper.
حالة	mavqeini
مايكل	Maykl
(A	(A
html>	phj@remus.rutgers.edu
ومثل؛	bo&#39;ladi&quot;
*************************************	*************************************
الموسم	mavsumda
طفل في الدوري	bola-ligada
look-	look-
تقدم،	ta&#39;minlaydi,
(؛	(;
عمليا	amalda
plexiglassso	plexiglassso
(:	(:
4094	4.094
قلق	tashvishlantirgandir
(؟	(?
على &amp; quot؛ البرد ومثل؛	&quot;soğukluk&quot;
فرانكو	franko
(2	(2
الآن	hozir
CSHOW	CSHOW
وظائف	o&#39;rinlarini
(1	(1
(7	(7
والغرض من	maqsadi
التي	etgan
وGT؛ &amp; GT؛	narsa&gt;&gt;
()	()
(A	(a
بعض	ba&#39;zi
المالك.	egasi.
المدرجة	keltirilgan
سحر	Magic
(\	(\
يقولون،	Deydilar,
على &amp; quot؛ حقيقية ومثل؛ &amp; GT؛	&quot;haqiqiy&quot;&gt;
يسوع،	Iso,
سماوي	samoviy
html>	ritley@uimrl7.mrl.uiuc.edu
(T	(T
المهنيين.	professionallar.
بين الوالدين	ota-o&#39;rtasida
النمو	o&#39;sadi
(I	(I
الشباب-ليث)	yosh-Leith)
)	),
المذنبات	Cometary
Puryear	Puryear
استوائي	ekvatorial
حتى	hatto
كارثي	halokatli
المفصل	Qo&#39;shma
AMERICA	AMERIKA
مقالة	Maqolasidan
دواء وهمي	platsebo
المتشددين	hardcore
عملي	amaliy
..	..
html>	gonzaled@ucsu.Colorado.EDU
ألتيما	Altima
(Korenek@nmti.com)	(korenek@nmti.com)
عقلانية،	oqilona,
رمي.]	tashlaydi.]
زيادة.	oshdi.
4.6	4,6
المجموعات	guruhda
1759	1759
مصباح	Chiroq
مرغوب	istagan
1610	1,610
بني	barpo
//	//
أكثر	ko&#39;proq
التزام	majburiyatini
زر	tugmasini
الأوروبيون	evropaliklar
حرية التصرف	ixtiyori
-!	-!
مقص	qaychi
html>	ge!severy%severy@uunet.UU.NET
مكتب	ofisiga
في:	yilda:
فهرنهايت).	Farangeyt).
فهرنهايت)،	Farangeyt),
[الجنرال	[Gen
يموت	o&#39;lasizlar
الحدود	chegarasida
المخاطر	xatarlar
الخوارزمية،	algoritm,
البريد الإلكتروني:	e-mail:
منذ	yildan
اليهود،	Yahudiylar
html>	ILV20078@UDELVM.UDEL.EDU
مثلي الجنس	Gay
وGT.	bo&#39;lsa&gt;
السوفييتي	Sovet
كريمر	Cramer
-.	-.
النقطية	raster
مفتاح ومثل؛	kalit&quot;
على &amp; quot؛ Borshevshky ومثل؛	&quot;Borshevshky&quot;
البريد الإلكتروني،	e-mail,
الخوارزمية؟	algoritm?
HCI	HCI
حزين	ma&#39;yus
Kloo	Kloo
مزيج من	birikmasi
عدة	necha
namelplate	namelplate
.	bor.
السلوك:	xatti:
)	bor)
35	35
هناك،	bor,
في المكتب	ofisida
3:	3:
العلامة &amp; lt؛ 1993Apr21.170403.22855@yang.earlham.edu&amp;gt.	&lt;1993Apr21.170403.22855@yang.earlham.edu&gt;
الظهور	ko&#39;ringan
ري	sug&#39;orish
4.	4.
تاريخ	sanasi
4	4,
الملك)	King)
42	42
هناك؟	bor?
40	40
مفهوم	tushunchasiga
تقييد	cheklash
الملون	ligini
هناك:	bor:
العمل	ishlayotgan
أليس كذلك؟	o&#39;ng?
(613)	(613)
تلقى	tushgan
دين	dinni
2:	2:
تحذير.	ogohlantirish.
المضادة	anti
نوع	turi
نصف	yarmidan
بيع	sotish
22	22
سيفرن	severy
اليك	senga
23	23
قبل احتساب	befor
24	24
25	25
تصاعد	TAKOZLARI
التغييرات	o&#39;zgarishlar
موقف	tura
26	26
تدور.	Spin;
27	27
28	28
1W	1W
29	29
3	3,
3.	3.
html>	stephen.guerke@mvs.udel.edu
30	30
1M	1m
32	32
إيشي	Ishii,
31	31
فترة	davrida
المد والجزر	fasllari
تآكل،	eroziyasi,
خطي	chiziqli
3)	3)
حيث	qaerda
السطوع	nashrida
أيد	qo&#39;llab-quvvatlanadigan
عدم وجود	kamchilikka
19	19
السلوك.	tutish.
1:	1:
أنا	qilyapman
17	17
18	18
المعترف بها	e&#39;tirof
15	15
16	16
13	13
14	14
11	11
12	12
السلوك؟	tutish?
21	21
20	20
2.	2.
8.20)	8.20)
2)	2)
الأقمار الصناعية،	yo&#39;ldoshlarini,
2٪	2%
هنا	erda
كمبيوتر	Kompyuter
رئيس	bosh
html>	erikb@idt.unit.no
قال.	aytdi.
وقال:	aytdi,
ترخيص	litsenziya,
1.	1.
10	10
الإسلام	Islom
1)	1)
1	1,
نظرة،	qarash,
1٪	1%
سوارتز	Swartz
5VDC	5VDC
التنسيق	formatlash
7:	7:
السعر)	narxi)
78	78
من الواضح،	Shubhasiz,
أنشطة	faoliyatini
B	yotgan
prohipiting	prohipiting
آدم،	Ato,
بعيدا عن	tashqarisiga
نية	niyat
لقطة؟	uzgan?
المذنب	kometasi
في وقت مبكر	Erta
حلوى من سكر أسمر وزبدة	butterscotch
شرعية	qonuniyligini
الأرض	Yerning
6:	6:
الكلمات	so&#39;zlari
الناس	insonlar,
قمري	Lunar
ومثل؛، لا	olmaydilar&quot;,
كل ساعة	soatiga
الهدف	maqsad,
ومع ذلك،	Lekin,
(	(o&#39;sha
7)	7)
الأطباء	Shifokorlar
!!!! &amp; قووت]؛	!!!!&quot;
لحظة	zum
70	70
تقريبا	qariyb
72	72
76	76
التشخيص	kasaliga
مودم	modem
غير الشرعيين مفتاح	Noqonuniy-Key
5:	5:
نعمة.	inoyati.
html>	martyj@uiuc.edu
Solomita)	Solomita)
56	56
التحديث	Update
في بعض الأحيان،	ba&#39;zan,
55	55
قواعد	qoidalar
كثيرا	ancha
الكوكب	sayyoraning
اختطاف	o&#39;g&#39;irlab
حقا	chindan
الماء	Suvga
خط الصدع-	xato-line
مقاضاة	ayblov
60	60
مجموعة	guruhni
على &amp; quot؛	&quot;barcha
تعريف	belgilangan
احتراق	yonayotgan
أرض مستأجرة	tutib,
أنا لا أريد	istamayman
^^^^^^^^^^^^^^^^^^^^^^^^^^^^^^^^^^^	^^^^^^^^^^^^^^^^^^^^^^^^^^^^^^^^^^^
4:	4:
عضوي	organik
إلى الوراء	orqa
______	______
4؟	4?
مؤقت	vaqtincha
WW2	WW2
70000	70,000th
زيادة.	ko&#39;paydi.
5	5,
حي	mahallada
نطاق	oralig&#39;i
مجز	Clipper
يتحدث].	gapirganda];
شيء	Narsa
العيون،	ko&#39;zlarini
ماء	suvni
5.	5.
توري:	Torre:
50	50
فراغ	vakuum
(508)	(508)
خيارات	imkoniyatlari
بعد	masofa
أعتقد، على الرغم من	o&#39;ylayman-da,
عزام)	Azzam)
والده	otasi
التشريعات -gun	qurol-qonunchiligi
التي تم الحصول عليها	olingan
علماء الفلك	astronomlar
هم:	edi:
؛	edi;
486	486
شكر	Thanks,
*************************************************	*************************************************
؟	edi?
99.8	99,86
إطلاق	chiqarish
طبي	tibbiy
482	482
مرة	paytda,
توقف	to&#39;xtating
،	edi,
هنا	Erga
.	edi.
لا أعتقد،	o&#39;ylamanglar,
الناس	xalqiga
واللفتنانت؛ /	&lt;/
فوضى	tartibsizlik
الموت،	o&#39;limi,
الاحتياجات	ehtiyojlarini
مدريد	Madrid
أقل من	kam
تعليم عن بعد	telematik
نظمت	tashkil
القلب والأوعية الدموية وGT.	tomir&gt;
المقصودة؟	maydonchada?
بفضل!	Thanks!
قاطع طريق	qaroqchi
أولكر	Ulker
الأنبياء	payg&#39;ambarlarning
Lankford	Lankform,
::	::
القراء	O&#39;quvchilarning
10:39:15	10:39:15
فلوريدا	Fla
النظام	tizimini
كانون الاول	dekabr,
مسح	tozalanadi
انقر.	bosing.
واضح	aniq
الفحص	ekspertiza
(اليونانية	(yunoncha
يوميا	kundalik
العمل.	ishlamaydi.
مكسور	singan
الكوكب	Sayyoraning
:)	:)
حركة الديمقراطيين الاشتراكيين	MDs,
النجوم	yulduzlarni
إذن	ruxsat
قرأ	o&#39;qigan
الاستعداد،	moyilligiga,
)	edi)
Lankford &amp; GT؛	Lankford&gt;
95	95
فسيفساء	Tavrot
html>	sbp002@acad.drake.edu
نواة	yadrosi
93	93
90	90
!	edi!
استقامة	tekislash
هنا	Erda
غير راضين	qoniqmagan
طيار	uchuvchi
إعلام	ma&#39;lumot
على &amp; quot؛. ذيول على &amp; quot؛	&quot;dumlar.&quot;
فرصة	Imkoniyat
وظيفة	funktsiyasi
هم	​​ular
تشرين الأول	Oktyabr
Alt.atheism	Alt.atheism
تنازل	Voz
معرق	donali
تباع	sotilgan
خارج	chiqib
==================================================	==================================================
88	88
الماوس)	Sichqoncha)
عروض	ko&#39;rsatmoqda
آمنة،	xavfsiz,
مؤكد	Muayyan
على &amp; quot؛ أوه،	&quot;Oh,
كانون الاول	dekabr
؟؟	??
صبي	bola
رحلة	safari
ماكراي): &amp; GT؛ &amp; GT؛ &amp; GT؛	MacRae):&gt;&gt;&gt;
بناء	binoning
،	kiritish,
في المئة	foizi
إغلاق	yopib
مقالات	maqolalar
خلاف	nizo
الإخوة والأخوات،	birodarlar,
لم يحدث ذلك	qilmaydi
إحصائيات وGT.	Statistika&gt;
رأي	nuqtai
؟!	?!
عندما	qo&#39;nganda
المبادئ	printsiplari
لدفع	buyuradi
يونغ	Leong,
الأشكال،	formatlar,
المطلوبة.	qolaman.
مشاكل،	muammolar,
كرة ثلجية	kartopu
الحضنة	zoti
X11	X11
الماء	suvga
الناس	xalqini
(LGV	(LGV
القدرة على	imkoniga
؟!؟	biladimi?!?
بوري	Bure
إغلاق	yopiq
(كين	(Ken
الطريق	tarzda
المشاكل؟	muammolar?
خلل	qusur
في الواقع،	aslida,
إريك	Erik
html>	gt4417a@prism.gatech.EDU
في المئة	foizga
WNI	WNI
المحمول	Portable
شيء	narsa
لاتينية	Lotin
هناك!	bor!
قراءة	o&#39;qish
النتائج	topilmalar
حدث إعلامي	media-tadbir
طبيعي	tabiiy
سيتم عرض.)	ko&#39;rinadi.)
خطأ	yorig&#39;i
(5000	(5000
motherships	motherships
منطقية.	mantiqiy.
مساو	teng
في	Da
ديسيبل	Db
خدمة	xizmat
4850	4,850
ناقص	nomukammal
الصور	rasmlar
E.	E.
أرض	Land,
استطلاع	razvedka
المضادة للفطريات	anti-qo&#39;ziqorin
(Korenek@nmti.com) وGT؛ &amp; GT؛ &amp; GT؛	(korenek@nmti.com)&gt;&gt;&gt;
إلى	qilish
DH	DH
(ديترويت،	(Detroyt,
بركان	vulqon
نشرت	nashr,
(وهذا هو،	(ya&#39;ni,
كلية	kolleji
على &amp; quot؛ المرض	&quot;kasalliklar
معروف	ma&#39;lum
الشروط	sharoiti
(الماضي &amp; GT؛	(«oxirgi&gt;
بوريش &amp; GT؛	Bures&gt;
ليس	bo&#39;lmas
رأسه	boshini
تسليم المجرمين	ekstraditsiya
مسلم	musulmon
virus..It	virus..It
340	340
الآن ومثل؛.،	endi.&quot;,
السطح	yuzasining
درجة الحرارة	temp
طبق الاصل	nusxasidan
تقارير	hisobotlarida
شكوى	da&#39;vo
مدير	boshqaruvchiName
ترتيب	konfiguratsiya
GE	GE
ون تشنغ	Wen-Cheng
الدينية وGT.	diniy&gt;
أن	Shundan
نعم،	ha,
هكذا	Shunday
تعيين ل	eşlenen
؟)	qilish?)
أرض	Er
amp &amp; GT؛	amp&gt;
فأر	Sichqoncha
الكويكبات	asteroitler,
G.	G.
FM	FM
النجوم	yulduzlarga
التماثيل	gnomes
مريحة.	qulay.
الأمونيا،	ammiak,
كيلومتر	kilometrlik
التفاضلية	differensial
HG	HG
العلامة &amp; lt؛ C5t7Gs.7v3@news.iastate.edu&amp;gt.	&lt;C5t7Gs.7v3@news.iastate.edu&gt;
أدرجت	Incorporated
الدول،	davlatlar,
IP:	IP:
763-2626	763-2626
وتستخدم	ishlatilgan,
GP	GP
تقدم	beradi
GM	GM
H.	H.
تكوين	tarkibidan
(بول	(Paul
توصيات المؤتمر	recomendations
غريب الاطوار	oddball
و	ham
QUACK	QUACK,
الشائعات	mish-mish
itself_	itself_
(مارتن	(Martin
من:	From:
إلى	davomida
الحل	hal
05:17	5:17
بقي	qoldi
jusgement	jusgement
رسوم	haq
أورت	Oort
كل	har
مرة	Vaqt
عملاق	Titan
(لا	(emas,
صحافة	matbuot
قادم	kelayotgan
من	From,
قادم	kelishida
أوربت	Falakda
A.	A.
سنغافورة	Singapur
====================================== وطن.	======================================&gt;
AT	AT
300	300
منزل	Home
رصد	monitor
IMMMMMMMMMMMMMMMMMMMMMMMMMMMMMMMMMMMMMMMMMMMMMMMMMMMMMMMMMMM.	IMMMMMMMMMMMMMMMMMMMMMMMMMMMMMMMMMMMMMMMMMMMMMMMMMMMMMMMMMMM;
متوقع	kutilayotgan
الإلغاء،	bekor,
القنوات،	kanallari,
عكس ذلك.	qarama-qarshi.
البعض	Boshqa
درقي	Tiroid
جودة	xislat
30٪	30%
ايفرست	Everest
III	III
قطعة	bo&#39;lagini
AM	AM
B.	B.
BV	BV
C:	C:
العلامة &amp; lt؛ C5qsBF.IEK@ms.uky.edu&amp;gt.	&lt;C5qsBF.IEK@ms.uky.edu&gt;
على أي حال	baribir
على &amp; quot؛ &amp; مثل مناقشة.	&quot;muhokama&quot;
مواطن	yashovchi
الوديان	vodiylar
CA	CA
قبضة	musht
بلد	mamlakati
BI	BI
حظرت	ta&#39;qiqlangan
أوتوماتيكي	avtomatik
وGT.	tarzda&gt;
الرسول	havoriy
كوكب	sayyora
ل	An
الجذر الظاهري	virtual-ildiz
مظاهرة	namoyish
C	C,
جدول	stol
شركة	Al
شمل	kiritilgan
مهمة	missiyasi
تستخدم؟	foydalanayotgan?
3.0	3.0
المسؤول	javobgar
على &amp; quot؛ مطلق النار ومثل؛ &amp; GT؛	&quot;mergan&quot;,&gt;
3.1	3.1
(على &amp; quot؛ بلدي ومثل؛	(&quot;vasiyatini&quot;
إيستوود	Eastwood
هذا	Bu
الحفاظ	tutish
تشارك.	shug&#39;ullanadi.
،	iborat,
.	iborat.
botir	botir
العلامة &amp; lt؛ بدلا من ذلك	&lt;o&#39;rniga
هكذا	shunga
نشر.	yoyib.
من فضلك.	iltimos.
جوفي	Jovian
Ganimedes	Ganimedes
من فضلك،	iltimos,
التكلفة،	xarajat,
كذب	botil
القرص المضغوط	CD
تهدف إلى	qaratilgan
. ومثل؛	ekan.&quot;
D.	D.
معظم	ko&#39;pchilik
!!)	!!)
لكل	boshiga
العلاج	uzog&#39;i
الأسد	Assad
ربما،	Ehtimol,
!!!	!!!
أوهايو	Ogayo
لنا	bizga
السلطة الفلسطينية	zbekiston
التوأم	Twin
يحتوي على	ichiga
هو	zot
(الجذر	(root
مهلا	hey
(NASA	(NASA
الله	Xudo
لا متماثل	assimetrik
متهالكة	cratered
الكرادلة	Cardinals
أصحاب	egalarining
ليونارد	Leonard
MD	MD
تقييد	cheklanishiga
شجاع	jasur
MB	MB
انه،	He,
موارد	resurslarini
وGT.	da&gt;
المحمول	mobil
مربع	kvadrat
رمي	tashlamoqchi
N.	N.
بركان	Vulqon
حيث &amp; GT؛	qaerda&gt;
شهود	guvohlar
Gilkes	Gilkey
على &amp; quot؛ X9 ومثل؛	&quot;X9&quot;
MS	MS
إلكتروني	elektron
وزن	tarozida
NI	NI
3.8	3,8
3.5	3,5
الارتفاع.	tirilaman.
NA	NA
(آخر	(oxirgi
html>	dlb@fanny.wash.inmet.com
إيمان	imoningiz
تحدث؟	gapirdi?
الجزائر	Jazoir
لي	My
وهذا هو،	ya&#39;ni,
الإلكترونيات	Electronics,
من؟	kimsiz?
---------------------------	---------------------------
التبديل &amp; GT؛	Kommutatsiya&gt;
NO	NO
منطقة،	tuman,
P.	P.
المفتاح	kalitiga
ON	ON
عاصفة	bo&#39;ron
حسنا	OK
أنا رن	chaldi
المواطنين	fuqarolari
بووربووك؟	PowerBook?
موقع	Sayt
(سكوتر	(Scooter
القرص	diskdan
،	nisbatan,
الشاهد:	shohidlik:
مجتمع	hamjamiyat
على &amp; quot؛ المغناطيسي	&quot;magnit
(6200	(6200
P5	P5
على &amp; quot؛	&quot;..
الدوائر	mikrosxemalar
نصائح؟	maslahatlar?
أغلقت:	yopildi:
لا	No
مجموعة.	oralig&#39;i.
OP	OP
html>	lei@rtsg.mot.com
OR	OR
حذف،	o&#39;chirildi,
PL	PL
في	On
مملكة	Shohligida
(ون تشنغ	(Wen-Cheng
يا	Oh
عودة	qaytarib
إعلان	Od
الدوري	Ligasi
PB	PB
PC	PC
معرفة	bilim
ظلام	qorong&#39;u
تاريخ	tarixi
انبعاث	emissiya
اذهب	Go
بارنجر	Barringer
سيتم عقد.	o&#39;tkaziladi.
مجعد	jingalak
على &amp; quot؛ فتح &amp; مثل؛	&quot;ochiq&quot;
غامض	qorong&#39;i
أبجدية	nomaqbul
على &amp; quot؛ كفى	&quot;Etarli
علم الاحياء	biologiya
يشعر	his
مجلس	taxta
الهوية	ID
نعم	Ha
لمعرفة	o&#39;rganish
هو	He
html>	nuet_ke@pts.mot.com
بقع	dog&#39;larni
مرحبا	Hi
ناد	Club,
توم &amp; GT؛	Tom&gt;
لاندر	Lander
تموز	iyul,
J.	J.
IN	IN
IO	IO
انت ذاهب الى القيام به؟	qilasiz?
أداء	bajarish
في مجال	sohasida
السطح	yuzasi
مسروق	o&#39;g&#39;irlangan
IS	IS
IT	IT
html>	dh782@cleveland.Freenet.Edu
ثمار	mevalaridan
النادي.	Club.
نعم.	Ha.
هرتز	Hz
نعم،	Ha,
يعلم،	o&#39;rgatsa,
شبكة	Network
تعلم	bilib
الملاحظات	kuzatuvlar
حيازة)	EGALON)
JB	JB
الإعلام والتوعية	Io
على &amp; quot؛)،	&quot;),
توفي	vafot
في	In
قناة	kanal
هكذا	shuncha
كينا	kinoya
كريمة &amp; GT؛	marhamatli&gt;
JT	JT
الوسائل	demak
قادمة	kelishini
AUTOCAD	AUTOCAD
(حماس	(Hamaza
سخيف	kulgili
،	qo&#39;lga,
IBM	IBM
عكس	zid
على &amp; quot؛ فقط	&quot;Faqat
html>	st1ge@Elroy.UH.EDU
تويوتا	Toyota
مستقل	mustaqil
نائم	uxlab,
(جوزيف	(Joseph
صحيح	To&#39;g&#39;ri,
منافس	emulator
L.	L.
منافس	raqib
النسخ الاحتياطي	zaxira
الناس	kishi,
رياضة	sport
أنفسهم	o&#39;zlarini
الصف،	sinf,
منخفض	past
كدمة.	chaqasan.
IBM	IBMning
الحل	Hal
ضمن	ichida
لسبب ما	negadir
قيمة	qiymati
و	Ham
الإخوة والأخوات،	Birodarlar,
LH	LH
كل	Har
FROMTHEDEAD:	FROMTHEDEAD:
المسيح على &amp; quot؛	Masihdir.&quot;
مختلف	boshqacha
قول	aytishim
VL	VL
W.	W.
أوليسيس	Ulysses&#39;in,
تقرير	hisoboti
İşret	Isreal
حقوق	huquqlarini
ستارة	parda
العالم	dunyolar
تكساس	Tx
لنا	bizni
رأيت.	ko&#39;rganlar.
وGT.	qoldi&gt;
فارغ	bo&#39;sh
أستاذ مشارك	dotsent
الغيرية	heteroseksüel
مخازن	saqlaydi,
القارة القطبية الجنوبية	Antarktida
لا ننسى	unutmang
شكرا لك.	rahmat.
الضحية	qurboni
وجه	yuz
دون تمييز	Gelişigüzel
تنويه!	kechish!
عشر	Th
في وقت مبكر	erta,
بنك الاحتياطي الفيدرالي	oziqlangan
أطلقت	ishga
PROOFOF :::	PROOFOF:::
هادئ	olaysız
حمل	yuk
الاستخدامات	foydalanadi
التلفزيون	TV
شركاء	hamkorlar
على &amp; quot ؛.	&quot;bilan.
html>	wnk@aquifer.geology.uiuc.edu
المقدس	Muqaddas
إخلاء المسئولية؟	kechish?
الإقامة	turar
الميثاق	Charter
المفتاح	kalitini
[ذكر]	[erkak]
XT	XT
نورتون	Norton
Landmann	Landmann
سابق	Oldingi
ثانيا،	ikkinchisi,
سري	maxfiy
تعليمات	ko&#39;rsatmalar
على &amp; quot؛ &amp; مثل؛	&quot;soat&quot;
مستوى	darajada,
ممل	zerikarli,
إلى أوروبا	Yevropaga
زئبق	simob
الزاوية)	burchak)
حكاية	ertak
المشاكل	muammolarni
في الصيف	yozida
الزاوية،	burchak,
و	Va
------------------------	------------------------
جونيشيرو	Jun&#39;ichiro
تألق	porlab
على الرغم من أنني لست	emasman-da,
فتح	Open
لإثبات	isbotlash
باثفايندر &amp; GT؛ &amp; GT؛ &amp; GT؛	Pathfinder&gt;&gt;&gt;
S.	S.
المشروع،	loyiha,
البقع	qoralangan
غرفة	xona
خروج	chiqish
اتصال	murojaat,
حيث	Qani,
فولتس)	Folta)
كتلة.	blok.
أثار	tirilmagan
حسن!	yaxshi!
RA	RA
تركيز	qaratib
سلاح	Qurol
قرون	shoxini
أسفل &amp; GT؛	pastga&gt;
لي	Meni
البديل	muqobil
قرأ	o&#39;qib
وGT؛ &amp; GT؛	bo&#39;lsa,&gt;&gt;
جذر	ildiz
على &amp; quot؛	&quot;Bu
قيود	aylantirilib
بدون	turib
مثل)	singari)
العقبات	to&#39;siqlar
إذا	qilinsa
R.	R.
html>	alin@nyx.cs.du.edu
خطأ.	xatoyim.
(1.5 ميل)	(1.5-mil)
هايز)	haysi)
المواطنين،	fuqarolar,
كذلك،	yaxshi,
يستحق ومثل؛	arziydi.&quot;
الموضوع:	Mavzu:
هدف	gol
للعودة	qaytishini
وبالسعة	kapasitif
شهر	Oy
فايس)	Vayss)
على المشي	yurishni
،	qilib,
نافذة	oynasini
جريمة	jinoyat
OOOO	oooo
أو &amp; GT؛	bo&#39;lmasa&gt;
جرس	qo&#39;ng&#39;iroq
درس.	o&#39;rganildi.
هكذا	So
أنقاض	qoldiqlari
دواء	dori
SS	SS
الصيف	yoz
ل.	uchun;
من حيث	nazaridan
؟	uchun?
الفرص	imkoniyatlarini
صحيح	Chin
تشديد	urg&#39;u
إلى:	uchun:
أنا	Men,
إلى	uchun,
إعادة	Re
الاستخبارات،	Aql,
.	uchun.
ذهب	ketdi
.	joylashtirish.
SI	SI
رحمة	rahmati
٪	uchun%
في الصباح،	ertalab,
-120	-120
فريق	yoq
)	uchun)
RR	RR
؛	kelgan;
الرجل	Insondir
!	uchun!
///////	///////
على &amp; quot؛ بطيئة	&quot;sekin
html>	franjion@spot.colorado.edu
.	qilib.
الألغام	minalar
سائق &amp; GT؛	Driver&gt;
تم العثور عليها.	topildi.
البرق،	chaqmoqni
يتحدث	So&#39;zga
قديم	Eski
حرم الجامعة	Campus
حلزون	Snail
عبر	orqali
زهرة	gul
N3JXP	N3JXP
متنوع	turli
عاش.	yashagan.
المريد	shogird
الوها	yoqishingiz
المرضى،	bemorlar,
^)	^)
الكوكب	sayyoramizning
(ويلز	(xohlagan
واحد	birini
متزايد	o&#39;sayotgan,
سيفرن	Severy
ذاكرة	xotira
الحب،	sevib,
أعلى	yuqoridagi
كبريتات	sulfat
الأصلي،	xos,
القديمة،	qadimiy,
\\	\\
. ومثل،،	uchun.&quot;,
CONFIG.SYS	CONFIG.SYS
موضوع	Mavzu
=============================================	=============================================
حسنا،	Xo&#39;sh,
وسيط	mediator
عدم مسؤولية	Ogohlantirishlar
الكتيب	risolaning
أهمية	ahamiyatga
متغطرس	mutakabbir
الشرق)	sharqqa)
وصف الدواء	buyuriladi
على &amp; quot؛ الفواكه ومثل؛	&quot;qovun&quot;
توقع	kutish
مذبحة	qirg&#39;in
قارئ	o&#39;quvchi
رواد الفضاء	astronavtlar
__	__
(لين	(Lin
تحول	switch
فأر	sichqoncha
اتجاه	yo&#39;nalishini
الخبز المحمص.	tushdi.
نخب،	tushdi,
MouseWare	MouseWare
رحلة	safarga
html>	dbernard@clesun.Central.Sun.COM
الكاردينال	tubdan
إرسال	jo&#39;natish,
هوتشيسون ومثل؛	Hutchison&quot;
الاتصال؟	murojaat?
نمط	naqsh
قوانين	qonunlarini
.	`.
[2]	[2]
^^	^^
في الفضاء	Kosmosda
سبحانه وتعالى،	Taoloning
الآلهة	xudolar
3-8)، وGT.	3-8),&gt;
متخصص	ixtisoslashtirilgan
شقيقة،	singlim,
-183	-183
نافذة &amp; GT؛	oyna&gt;
أفضلية	ustuvor
على الصخور الصلبة	mustahkam-rock
382	382
حزين &amp; GT؛	hafa&gt;
في الولايات المتحدة	AQShda
على &amp; quot؛ أنسنة ومثل؛	&quot;insonparvarlik&quot;
على &amp; quot؛	&quot;Shaxsiy
فلسطين	Falastin
المحافظ.	konservativ.
معمودية	cho&#39;mish
الكاتب	muallifi
(سكيلتون	(Skelton
-179	-179
تظهر.	ko&#39;rinmaydi.
على &amp; quot؛ غامض	&quot;loyqa
معلم	ustoz
إلى الوراء	orqaga
دولة	Davlat
ضربة	portlatishga
نماذج	modellari
أقواس	yoylari
لحن	sozlamoq
إرسال	yozish
عار	yalang&#39;och
(دوغلاس	(Douglas
375	375
في النهاية،	oxirida,
رئيس	boshga
باهر	qamashtiruvchi
على &amp; quot ؛:	&quot;:`
بلون البيتزا	pizza-rangli
[A	[a
الفضاء	Kosmosga
(على سبيل المثال)	(masalan),
نانايمو،	Nanaimo,
واحدة من	biriga
إسرائيل	israel
360	360
المعيشة	turmush
تاريخ	Sana
بدلا من	o&#39;rniga
النمو)	o&#39;sish)
الآلاف	Minglab
وجه	Yuz
غزة	G&#39;azo
[U	[u
HRB	HRB
الدراسة،	o&#39;rganib,
فحصها.	o&#39;rganib.
سامس	Sams
المؤمنين	mo&#39;minlar
[I	[I
كريس	Chris
الدعوة	chaqirishni
\)	\)
نموذج	chiqarilgan
عضو	organ
&#39;أنت	»Siz
\؛	\;
48؟)	48?)
ضوئية ومثل؛	fotokimyo&quot;
دراسة؛	o&#39;rganib;
دعوة	chaqiriq
نزع	tashlash
K1Y	K1Y
وquot؛ إلغاء	&quot;bekor
أرض	Land
مندهش	hayron
اللعب.	o&#39;ynaydi.
نسبيا	nisbatan
جنرال الكتريك	ge
المشترين	qiluvchilarni
اليورانيوم	Uran
المشكلة،	muammo,
العدوى	infektsiyalari,
إلى	ga
أعمدة	qutblarda
العلامة &amp; lt؛ 1qksc2$2mr@fido.asd.sgi.com&amp;gt.	&lt;1qksc2$2mr@fido.asd.sgi.com&gt;
الشركة المصنعة	chiqaruvchi
الأقمار الصناعية	yo&#39;ldosh
لي	o&#39;zimning
JPL	JPL
رمي	tashlaydi,
مثل	bunday
بول	Paul
ميلا في الساعة)	milya)
203	203
الأطفال	bolalarni
200	200
قاموس	lug&#39;at
20:	20:
على &amp; quot؛	&quot;Va
التلاميذ	shogirdlari
html>	SLEGGE@kean.ucs.munc.ca
على &amp; quot؛	&quot;Uy
القوات	kuchlari
20٪	20%
توسيع الروح)	kengaytirish-nafs)
ط	i,
ممكن	imkon
يبدو	tuyulardi
لنا	bizning
قال	dedi
نهائي): &amp; GT؛	oxirgi):&gt;
فعلت.	qildim.
ملفات	fayllarni
خدمة	xizmati
محطة	stantsiyani
غادر.	qoldirgan.
التويج	Corollas
بيتا	Beta
رائد	kashshof
تأويل	talqini
تلاميذه،	shogirdlariga
مستحق	munosib
في:	In:
التحدث).	gapirish).
.	o&#39;tgan.
على &amp; quot؛ ...	&quot;...
جورجيا	Gruziya
لحظة وGT.	oniy&gt;
نجمة	yulduz
Aili في	ailin
سبعة	etti
هو.	sanaladi.
مناقشة	munozaralar
21)	21)
فعل	do
Iftccu:	Iftccu:
في.	In.
صور	portretlar
باستمرار	doim
21	21,
وفقا ل	ko&#39;ra
الجيران	qo&#39;shni
مجانا،	bo&#39;sh,
أقواس	kamon
بالإضافة إلى ذلك،	bundan
JPB	JPB
مادة	ashyo
اللاأدرية	Agnostitsizm
مقبول	maqbul
الوهمية وGT.	delusional&gt;
عدة	Necha
التوقيع،	ishora,
أرض	yer
المتقدم	Advanced
الإعلام والتوعية	Io,
النيازك	meteoritlarning
لدينا.	qildik.
التوقيع.	ishora;
أرض	er
منخفض	Past
Fraering)	Fraering)
تصميم	dizayn
! على &amp; quot؛	Bu!&quot;
ومثل؛	yaxshi&quot;.
انتس)	Lantz)
وGT.	qanday&gt;
هذا	bu
إبريق	ko&#39;za
فرنك بلجيكي	bf
.	qilingan.
،	qilingan,
باستخدام	foydalangandan
ثنائية	bi
التأريض.	Topraklama.
اليوم	Bugun
ذلك؛	deb;
زوج	juft
في	da
ما يلي:	deb:
حوض	havzasi
ذلك؟	deb?
2.5	2,5
السفينة	kemada
تيمو	Teemu
(زوجتي)	(xotinim)
.]	bosh.]
فقط	faqat,
،	deb,
منطقة	maydon,
.	deb.
كمبيوتر	kompyuterga
شبشب	shippak
التحقق)	tekshiriladi)
للتخفيف من	yumshatish
XT350	XT350
html>	ab245@cleveland.Freenet.Edu
تاريخ	Tarix
هلام	jele
).	edi).
حقيقي	ko&#39;chmas
يخلق.	yaratadi.
تقريبا	deyarli
)	edi),
html>	geb@cs.pitt.edu
أسوأ	yomonroq
طريقة	holatiga
تحرير:	Tahrir:
``	``
UUNET	uunet
نافذة	Oynasida,
تسمية recyle	Recyle
نقالة	zambilda
وطن؛ &amp; GT؛	Texnikasi&gt;&gt;
وثائقي	hujjatsiz
احترام	hurmat
سلامة،	qo&#39;liga,
الرائدة	boruvchi
راقب	tomosha
ج:	c:
html>	franjion@spot.Colorado.EDU
أسعار	narxlari,
JKN	JKN
أي	BIROR
منطقة	maydoni
جدا	juda
إد	ad
[1]	[1]
الضغط	bosim
الأسعار.	narxlari.
لا	no
وثيقة	hujjatni
ضوء الشمس	nuriga
على &amp; quot؛ همي	&quot;platsebo
تطبيقات	ilovalar
كاديلاك ومثل؛	Cadillac&quot;
المرأة	ayollarning
والغرض من	maqsadi,
انا اختلف.	qo&#39;shilmayman.
من	of
مختبرات	laboratoriyalari
تداخل	nizomiga
مركبات لل	aralashmalari
مسألة	Savolingizga
html>	schuster@panix.com
نيزك	Meteor
علم	bayroq
في: &amp; GT؛ &amp; GT؛	In:&gt;&gt;
مشرق	yorqin
التصاميم	dizaynlar
وحشي	yovvoyi
فضاء)	kosmik)
،	qo&#39;yish,
الفضاء	kosmik,
التصفيات	o`yini
أبيض	oq
أكثر	Ko&#39;proq,
حكيم	dono
بدلا من ذلك،	o&#39;rniga,
Lippard)	Lippard)
كما	etib
مراقب	Observer,
القليل	oz
شهر	oy
وGT.	ham&gt;
ضيف	mehmon,
رأيت.	ko&#39;rdik.
PE	pe
رأينا،	ko&#39;rdik,
مساء	pm
في	ustiga,
تذاكر ل	chiptalar
html>	psyrobtw@ubvmsb.cc.buffalo.edu
الأعضاء	Member
ليس	emasligini
بجانب myselff	myselfe
الجداول	jadvallar
BBS:	BBS:
غلاطية	Galatiyaliklarga
مسؤولية	mas&#39;uliyatni
دوس.	dos;
لوحات	platalar
A &amp; GT؛	Agar&gt;
1500	1500
شركة	kompaniya
لي	me
كما سبق.	Ditto.
يوم الأحد	Yakshanba
مسير	Messier
الكهنة	ruhoniylar
46904	46904
كمية	kvant
حق اللجوء السياسي	boshpana
على &amp; quot؛ عدوانية ومثل؛	&quot;tajovuzkor&quot;
هدوء	tinch
.	chiqaradi.
حكم	hukmronlik
حزام	kamarini
وهلة ومثل؛	qarashda&quot;
ميت	jonsiz
خنجر	xanjar
،	olib,
غ	na
الرجال	Erkaklar
قتل	o&#39;ldirish
الأرثوذكسية	ortodoksal
رأيت.	ko&#39;rdim.
معهد:	instituti:
أريزونا	Arizona
ميت	o&#39;liklar,
خيار	ni
مخازن	do&#39;konlar
.	olib.
ص.	p.
تجربة	boshdan
(إسبانيا)	(Ispaniya)
طاعة	itoat
المدارية	Orbiters
الاتصالات	Kontaktlarni
سكرتير خاص	P.S.
زودت	ta&#39;minot
html>	mock@watt.support.Corp.Sun.COM
تحقق:	tekshirish:
قائمة	ro&#39;yxatda
انحنى	egilib
للأسف،	Afsuski,
XQueryTree	XQueryTree
NOT	EMAS
أخيرا	oxir-oqibatda
AUTOMATIC	AVTOMATIK
اضطهاد	quvg&#39;in
بريسون)	Bressler)
وظائف	vazifalari
حالة	holatini
الطبيب	Tabib
أنا،	emasman,
أنا لا.	emasman.
بدأت.	boshladi;
KU	ku
أوروبا	Evropadan
القيامة	tirilishi
،	boshladi,
أنا لا!	emasman!
.	boshladi.
جي	ing
الله	Xudosiman,
إنشاءات	qurish
Rubenfeld)	Rubenfeld)
أنا لست؛	emasman;
أعمى)	ko&#39;r)
مناخ	iqlim
لا،	Yo&#39;q,
بغض النظر عن	qat&#39;i
دفقة	pog&#39;ona
حزام	kamar
===========	===========
NOT.	EMAS.
المتتبع	Orbiter,
وأود أن.	istayman.
وأود أن،	istayman,
مرحبا	hi
أرض	Yer
لقاء	Meeting,
بديل	o&#39;zgartirish
عام	yil
أنت	Sizga
html>	livesey@solntze.wpd.sgi.com
خسارة	yo&#39;qolganda,
خليل	Xelion
الصليبيين	Salbchilar
جيل	avlod
JPS &amp; GT؛	JPS&gt;
____	____
مايو	mayda
الأقران	tengdoshlari
جمع	to&#39;plash
الأطباء	shifokorlar
تعليم	ilm
كثير،	ko&#39;p,
في	in
خيط	ip
TranslateCoordinates &amp; GT؛	TranslateCoordinates&gt;
مقاومة	impedans
تطلب	so&#39;rab
(&amp; طن،،	(&gt;,
أثر	iz
الصور	suratga
فريد	Fred&#39;S
أكثر!	ko&#39;p!
على افتراض،	faraz,
html>	COEGALON@LARC.NASA.GOV
شارما)	Sharma)
[يسوع]	[Iso]
الخ،	etc,
مشرق.	porloq.
سلسلة	zanjir
YYY	YYY
الإيثان	etan
XT	xt
بقعة	spot
سنوات	yilgacha
المخطط	rejalashtirilgan,
اسم	ismi
اختبار	Test
المخطط لها.	rejalashtirilgan.
ومثل؛، وأنا	emasman&quot;,
اشتباك	to&#39;qnashdi
وصف	tavsiflovchi
أسهم	aktsiyalarning
تحديث	modernizatsiya
يبدأ	boshlanadi
بووربووك	Powerbook
Schaufenbuel	Schaufenbuel
دوخة	aylanishi
جهاز	apparat
نصف الصخور	yarim-rock
دعوة	Calling
وGT.	ortiq&gt;
bading@cs.tu-	bading@cs.tu-
ت ت	vv
يأس	etar
. العلاج ومثل؛	davolash.&quot;
upperleft	upperleft
أن	ekanini
مختار	tanlangan
في حين	paytda
مشرق	yorug
المسافات	masofalarga
سمة &amp; GT؛	xarakterli&gt;
(الأميركيون)	(amerikaliklar)
(جميع	(Barcha
راديو شاك	Radio-Shack-ega
انتس	Lantz
html>	nodrog@hardy.u.washington.edu
سبب	keltirishi
العلامة &amp; lt؛ C4Hyou.1Iz@mentor.cc.purdue.edu&amp;gt.	&lt;C4Hyou.1Iz@mentor.cc.purdue.edu&gt;
حل	yechim
إيلاء	to&#39;lanadi
المشاركات	uz
وGT التحرك؛	ko&#39;chib&gt;
منزل	uy
و	va
(جيمس	(James
ثانية	yana
مقاوم	chidamli
عظيم	Buyuk
بضائع	tovar
حفيف	o&#39;chdi
عيون	ko&#39;zlar,
شارع	etdi
فهو يصف:	ta&#39;riflaydi:
اللوحة الأم	anakart
قالب	matrix
لاحظ:	kuzatiladi:
إدراج]	`joylashtiring]
على &amp; quot؛ أحمر	&quot;qizil
غالبا	ko&#39;pincha
خطوط	chiziqlar
قال	bildirdi
أولئك الذين	keltirganlar
كينسلي	Kinsley
مفهوم &amp; GT؛	tushunchasi&gt;
فوق	up
المشاهدين	tomoshabinlar
على &amp; quot؛	&quot;gi
عملية	jarayoni
نموذج	modelini
حساسية	sezuvchanlik
اختبار	sinov
على &amp; quot؛	&quot;ga
على &amp; quot؛ مينيسوتا	&quot;Minnesota
كان،	etildi,
لوحظ.	kuzatiladi.
ضيق	Zich
اختيار	terimiga
هناك،	kuzatiladi,
.	etildi.
إلى	to
تربة	tuproq
سياسي	Siyosiy
ج.	v.
-235	-235
شخصيا،	Shaxsan,
الطفولة	halihamon
ISA)	ISA)
(ماركوس	(Marcus
الشركة المصرية للاتصالات	te
سيئة،	yomon,
بعد الظهر	kunduzi
افتتاح	ochilishi
مكتشف	kashfiyotchining
الكواكب	sayyoralar
ترحيب	welcome
سماء	Osmon
مساو	Teng
الفرضية،	gipotezasi,
المشاهدات	chiqildi
رقاقة	Yonga
إيرباص	hte
قياس،	o&#39;lchagan,
المسيح،	Masih,
المسدودة-	o&#39;lik-tugasa
محسن	kuchaytirgich
أخلاقيات ومثل؛	axloq&quot;
أمبير	amper
عيون	ko&#39;zlari
تكساس	Texas
وقال:	u,
محكمة	sudga
html>	brenner@ldgo.columbia.edu
ويستند.	asoslanadi.
ربع	chorak
الهوكي،	Xokkey,
مياه	suvlari,
منذ	ilgari
في منطقتك	Hududingizda
على &amp; quot؛ الرصاص ومثل؛	&quot;taslim&quot;
جمعت	to&#39;plangan
جولة	yugurish
ذلك؟	degan?
بذرة	zoting
وطن؛ &amp; GT؛	​​&gt;&gt;
انتشار	yoyish
الآباء LED	ota-LED
(I	(Men
لوحات	plitalari
نمو	rivojlanish
الشرق إلى الغرب	sharqiy-to-g&#39;arbda
الشروط	sharoitlarda
خاص	xos
-221	-221
مع	bilan
عدد	raqam
html>	bressler@iftccu.ca.boeing.com
نقل وGT.	transfer&gt;
المخصص	xok
الخام	xom
الشروط	shartlarda,
&#39;&#39;	&#39;&#39;
كنيسة	cherkovi
معضلة	dilemma
يستخدم.	foydalanadi.
مجتمع	jamiyat
بعض	ba&#39;zilari
الذي تتحدث عنه؟	gapiryapsiz?
مفيد	foydali
اختبار	test
التعبير عن وGT.	izhor&gt;
(ستيفن	(Stiven
280	280
الوافدين	kelganlar
عربي	Arab
من ثم	Yerdan
بروكس)	Brooks)
خان	Xon
فرد:	Individual:
تكنولوجيا	Texnologiya
الكلمات	so&#39;zlarini
28:	28:
جلمود	Boulder
.	etdi.
إذا كنت تعتقد أن،	ishonsangiz,
على &amp; quot؛ بوري &amp; مثل؛	&quot;Bure&quot;
yonqutisi	yonqutisi
وGT؛ &amp; GT؛	ular&gt;&gt;
خيال	tasavvur
html>	engp2008@nusunix.nus.sg
عندما	qachon
في الماضي	o&#39;tmishda
أمس	kecha
html>	winfrvk@dutiws.twi.tudelft.nl
إعادة آخر	qayta-post
على &amp; quot؛ ^^^^ &amp; GT؛	&quot;^^^^&gt;
40-22k	40-22k
كويلو	tejamkorlik
html>	willisw@willisw.ENG.CLEMSON.edu
أنظمة	Systems
معاول	eshkaklar
مهتم؟	g&#39;amxo&#39;rlik?
propter	propter
ضاربا	hitter
أحداث	voqealar
العلاقات	Munosabatlar,
حيازة	Egalon
بين	o&#39;rtasidagi
أثار	tiriltirgan,
شرف	sharafiga,
رواد الفضاء	fazogirlar
من	tortib
حجم	o&#39;lchamli
باختصار &amp; GT؛	qisqa&gt;
حتى	qadar
ظلم	adolatsizlik
حياة	Hayot
الأرض وGT.	Yer&gt;
(I	(men
هم	Ularning
الشعار	logo
مدن	shaharlari
talk.politics.guns	talk.politics.guns
العلامة &amp; lt؛ BADING.93Apr23105229@athene.cs.tu-berlin.de&amp;gt.	&lt;BADING.93Apr23105229@athene.cs.tu-berlin.de&gt;
1971	1971-yillar
ستالين و GT.	Stalin&gt;
فشل.	muvaffaqiyatsiz.
تطوير	rivojlanayotgan
الأمانة و مثل؛	Xavfsizlik&quot;
.	ko&#39;rsatdi.
html>	pubinfo.jpl.nasa.gov
يتم تقريب،	yaxlitlanadi,
على &amp; quot؛	&quot;keyin
html>	caltech.edu
الصور	tasvirlar
240	240
بروكلين	Bruklin
14-19 &amp; GT؛	14-19&gt;
الناس	xalqi
سهول الفيضانات	qayirida
وأود أن	istardim
المدينة)	shahar)
خمسة	Besh
غير متوقع	kutilmagan
مجلة	Journal
مهتم	manfaatdor
مجهزة.	jihozlangan.
243	243
مينغ)	Ming)
دقة	aniqligi
1975	1975-yillar
الغازات	gazlar
إلى الأبد	abadiy
هم	ular,
العلاقات	munosabatlar
جريح	yarador
24-بت	24-bit
زاوية	nazarini
ISA	ISA
(أو	(Yoki
القضية.	masalasidir.
زيادات	oshiradi
أرقام	raqamlar
ليس	qilmagan
العلامات التجارية،	belgilari,
إحصائيات	statistika
قطع	kesib
ساجدا	sajda
مساعدة	yordam
آرغو	Argo
البنك،	sohillarni,
(والتر	(Walter
12.00	12.00
الذائب	eritilgan
أرض	yurtini
LMH	orangecar&#39;ait
250	250
يحدث.	happed.
(Henly،	(Henling,
J23	J23
لا قعر له	tubsiz
اسطوانات	silindir
25.	25.
*****	*****
شر	yomonlik
وGT.	yuqori&gt;
هاتف	Telefon
أبيض	White
انتخابات	saylov
توفي،	o&#39;ldi,
سنة	yr
إلى الاعتقاد	ishonish
شكرا لك.	Rahmat.
واشنطن، DC	Vashingtonda
لا معنى له	ma&#39;nosiz
ممثل	vakili
أو	yo
html>	berlin.de
العلامة &amp; lt؛ 1r0vk6INNaft@cronkite.Central.Sun.COM&amp;gt.	&lt;1r0vk6INNaft@cronkite.Central.Sun.COM&gt;
مؤرخ	tarixchisi
برينر	Brenner
GetGeometry	GetGeometry
مدير	boshqaruvchisi
Iaccoca	Iaccoca
المشي،	yurib,
المتسوق	Shopper
قالب	Matrix
نموذج،	namuna,
متوسط	o&#39;rta
نظام	tizimidan
Theisen ل	theist
هذا	Ushbu
وحيدا	yolg&#39;iz
وضع	qo&#39;yish
الله)	«Alloh)
تم العثور على	topilgan
من ناحية	qo&#39;liga
الغرب	g&#39;arbdan
)	narsa)
لا شيء	narsa,
زمام المبادرة	zimmasiga
ميتسوبيشي	Mitsubishi
رواد الفضاء	Fazogirlar
**************	**************
الهوكي	xokkey
الهواة	amatuer
(فيل	(Phil
مستكشف	Pathfinder
أمور:	narsa:
فلسطين	Falastinda
مرة	vaqtini
لتقديم	qutqarishni
مبسط	soddalashtirilgan
التطبيق	App
من الصعب	Hard
أبريل	Apr
ترنيمة	Zabur
رياضة	Sport
فعل	qila
حرب	urush
فكر	o&#39;ylagan
سيكون من	bo&#39;lardi
vfintd.386:	vfintd.386:
موصى به	tavsiya
حجري	Stony
الألغام)	meniki)
حضارة	sivilizatsiyasida
آخر	So&#39;nggi
واط:	vatt:
منتديات	qamrovli
ناجح	muvaffaqiyatli
نحو	tomonga
تبادل	almashishni,
خدش	shilmoq
التشخيص،	tashxis,
الغيرية، وGT،،	heteroseksüel,&gt;,
في عقول	Ongida
اليهودية،	yahudiy,
الصيد)	baliqchi)
الحوادث	baxtsiz
html>	hall@boi.hp.com
وفقا ل	binoan
91٪	91%
html>	pharvey@quack.kfu.com
غير شرعي	noqonuniy
عقاب	jazo
اقتصادي	iqtisodiy
ارتفاع	balandligi
html>	lippard@skyblu.ccit.arizona.edu
عمالقة	Giants
زبيب)	Zbib)
على افتراض	faraz
ومثل؛	bor&quot;.
(GIF،	(GIF,
بريان	Brian
المخالفات	nosimmetrikliklar
الكتب	kitoblarida
العرض	ta&#39;minlash
ماريا	Mariya
؟	chiqish?
المشاهدات	Ko&#39;rishlar
صقر	Hawk
شروط	shartlariga
سابقا	allaqachon
أقل	kamroq
هزم	mag&#39;lub
مجهزة.	jihozlandi.
عالم	dunyoning
هواء	Havo
على &amp; quot؛ برنامج الأمم المتحدة للأذن ومثل؛	&quot;un-vakolatli&quot;
hile	makr
مفهوم	tushunchasi
الآباء	ota-ichiga
فحصها.	tekshirildi.
علم	fan
»	narsa»
الانتاج	chiqishi
974	974
البطاقة.	karta.
مبادئ	tamoyillariga
سخيف	Kulgili
فهرس	katalogini
(872	(872
خوارزميات	algoritmlarni
مؤخرا	Yaqinda
لدى وصوله	borar
بحث &amp; GT؛	izlayotgan&gt;
مثليون جنسيا	Hays
في العمل،	ishlaydi-da,
على &amp; quot؛	&quot;biz
مخزن	Store
باستخدام	foydalangan,
الغلاف الجوي،	atmosferasida,
banschbach	banschbach
أمريكا	Amerika
ظهر،	ko&#39;rindi,
ماء	Suv
يبدو.	ko&#39;rindi.
أنظمة	tizimlar
التوزيع	taqsimlash
دون تمييز	gelişigüzel
شمس	Sun
رأيت	ko&#39;rgan
(842	(842
بدا؛	ko&#39;rindi;
النظام	tizimida,
مليون	millionli
على &amp; quot؛ ...	&quot;....
العلاقات &amp; GT؛	munosabatda&gt;
نفس	xil
بريد	mail
مدفوع	gijgijlash
شرح	tushuntirishga
قفل ومثل؛	qulfi&quot;.
النتائج	natijalari,
هيرشيل	Herschel
قال.	aytadi.
تورونتو،	Toronto,
نيسان	Nissan
أوروبا	Europa
html>	billq@ms.uky.edu
بما في ذلك)	jumladan,)
المرسلة.	uzatiladi.
المترجم	aylantirish
متوسط	degani
حارس	soqchi
بواسطة	tomonidan
على &amp; quot؛	&quot;bir
اليهود،	yahudiylarning
اثنين،	ikki,
والدوخة،	aylanishi,
آلية	mashinalari
وطن.	Bu&gt;
أمر.	buyurdi.
ظل	Shadow
معلومات	ma&#39;lumotlar
قال	aytib
التسلق	zabt
سيفاس	Kifa
اثنين؟	ikki?
على حد سواء	ikkala
664-6354	664-6354
[المسيحيين]	[nasroniylar]
مبادئ	tamoyillariga,
حالة	shtatining
الأطفال	Bolalar
كم عدد	Qanchadan-qancha
العلامة &amp; lt؛ wnk.734824081@aquifer.geology.uiuc.edu&amp;gt.	&lt;wnk.734824081@aquifer.geology.uiuc.edu&gt;
مبرر	oqlash
.	bo&#39;ladi.
منطقة	mintaqadagi
على &amp; quot؛ &amp; مثل؛	&quot;bajarish&quot;
متبادل	o&#39;zaro
إذا كنت تعتقد أن	ishonsangiz
namelplate &amp; GT؛	namelplate&gt;
باستخدام	yordamida
رقاقة &amp; GT؛	yonga&gt;
اسم	nomini
سوف	bo&#39;ladi,
؟	bo&#39;ladi?
خيال	Fiction
على &amp; quot؛ العودة	&quot;orqa
مجتمع	jamiyatning
وGT.	of&gt;
أسرع	Tezroq
الخلايا	hujayralari
أنه سيكون.	bo&#39;lardi.
ثم	So&#39;ngra
الوفاء	bajardi
سيكون من،	bo&#39;lardi,
؛	bo&#39;ladi;
الوصية ومثل؛	vasiyat&quot;
على ارتفاع	balandlikdagi
سبعة	yetti
دعوة	atashimiz
المستشفى	kasalxonada
البنوك	Banklar
لا	bo&#39;lmagan
تخيل،	tasavvur,
حارس الحياة	xaloskor
مرة	marotaba
عقد	ushlab
#From	#From
ذكاء	aql-idrok
خطر	xavfi
هو،	qilinmoqda,
========	========
هو.	qilinmoqda.
إرسال	jo&#39;natib,
البنادق،	Guns,
على &amp; quot؛ الوردي	&quot;Pushti
إحصائيات	Statistika
ارتفاع	balandlik,
وجود	borligi
نيزك	meteorit
أجزاء	qismlarga
هائج	qo&#39;pol
أسمر	Tan
الاخوة	Brothers
frank@D012S658.uucp	frank@D012S658.uucp
الضرب	vatin
في كل مكان	joyda
Krsek)	Krsek)
رؤية)	turibmiz)
INTERNET:	INTERNET:
هوتشيسون	Hutchison
الحد	kamaytirish
في مجالات	sohalarida
بعد	Hali
سوف	tushadi
جاكرتا	Djakarta
رسم بياني	grafik
يرتدي	kiygan
كآبة	tushkunlik
I &amp; GT؛	olaman&gt;
09:31	9:31
نوريو	Noring
المشروع	loyihasini
العلامة &amp; lt؛ 19613@pitt.UUCP&amp;gt.	&lt;19613@pitt.UUCP&gt;
تروندهايم	Trondxeym
استقلال	Mustaqillik
غاليليو	Galiley
نصف)	yarim)
مكان	joyga
زئبق	Merkuriy
آخرون	boshqalarning
أو دواير)	O&#39;Dwyer)
العلامة &amp; lt؛ الإيمان	&lt;e&#39;tiqod
=========================	=========================
(روك)	(tosh),
الكثبان	tepalari
صيغ	formatlar
لنتذكر	eslash
غريب	begona
هانز	Hans
)	ning)
html>	uu.net
فني	badiiy
قضاء.	sarflaydi.
جميل	go&#39;zal
Sci.med	Sci.med,
تحديث الصفحة	Malumot
على &amp; quot؛ المنهي ومثل،،	&quot;Terminator&quot;,
الفرص	imkoniyatlarni
على &amp; quot؛ QUACK ومثل؛	&quot;QUACK&quot;
94550	94550
في	ustidan
مزيج	aralashma
منحنى	egri
Frmwrks	Frmwrks
هل؟	ko&#39;rganmisiz?
الشوط	Inning
(رومية	(Rimliklarga
خارجي	tashqi
الدول،	xalqlarga
الغنية بالكبريت	oltingugurt-boy
(317)	(317)
غاليليو	Galileo
مفتاح	kalit
نولز ومثل؛	Knowles&quot;
إذهب إلى	borib
الجهاز	mashinadan
التي تم تحديدها.	aniqlandi.
مرض	qoniqarli
WAGNER	WAGNER,
لوحة	plastinka
المسيحيين	nasroniylar
الجو	atmosferaga
دخان	tutun
عرضة	zaif
html>	punjabi@leland.Stanford.EDU
الكواكب،	sayyoralar,
الفرق،	farq,
اختتام	xulosasi
على &amp; quot؛ &amp; ممارسة مثل؛	&quot;shifokorlarining&quot;
الايثان غاز الميثان	etan-metan
الذكرى المئوية الثانية	Bicentennial
من	boshlab
أنت	Siz
09:02:48	09:02:48
ياماكاوا	Yamakawa,
مايو	may,
ولكن بانخفاض	but-pastga
سوف	o&#39;tadi
جذب	jalb
مجموعة	to&#39;plamini
؛	ketdi;
مشرق	Yorqin
الدعم	qo&#39;llab-quvvatlaydi,
الجحيم	jahannam
من الصعب	Qiyin
كلايتون	Clayton
الأوروبيون:	Yevropaliklar:
MOUSE	Sichqonchasi
محافظة عليه.	saqlab.
Superve	SuperVGA
.	ketdi.
حفظ	saqlab,
يشمل	oladi
الذي	qilgan
اثنين من رواد الفضاء	ikki-astronavt
خلاص	qutilish
أقلية	ozchilik
في الواقع	Aslida
رسائل	xabarlar
مالاسبينا	Malaspina
(على ما أظن)	(menimcha)
84 سنوات	84-yil
V الإلكتروني:	V-Mail:
سير	yurish
أن تكون	bo&#39;lishiga
يعقوب	Yoqub
فكر	o&#39;ylagani
DE	ShU
رمز	kodi
أجنحة	qanotlari
قمم	toplar
أن	o&#39;sha
؟	ketdi?
من	From
e_mali:	e_mail:
الفرق	farqi
الامتثال	rioya
. لوحات ومثل؛	plitalari.&quot;
رقائق	chips
الاحتكار،	turmaydi,
عمالقة	gigantlar
ثمانية	sakkiz
سر	Sir
(الهوكي	(xokkey
كولورادو	Kolorado,
لا أستطيع.	olmayman.
الحقيقة	haqiqatni
--------------------	--------------------
لا أستطيع،	olmayman,
الإنجيل	Injilni
نص	matn
هذا	Shu
الركاب	Yo&#39;lovchilarning
BIOS	BIOS
هل	bormi
اكتشاف	kashfiyot
لذلك،	Demak,
،	er,
تغذيات:	olmoq:
الحديث	gaplashayotgan
استطلاعات الرأي	anketalar
(Tvtwm)	(tvtwm)
إبراهيم،	Ibrohimning
قال	aytgan
تشكيل	shakllanishi
(كريس	(Chris
المواطنين	fuqarolarini
القانون و GT.	qonun&gt;
يسوع المسيح	Masihning
جلبت.	keltirildi.
واقع	haqiqatga
ممتلكات	mulkiy
أسعار	Narxlari
محلي	mahalliy
محادثات	muzokaralar
حجرة التجميد	og&#39;diruvchi
مرحلة	bosqichi
ليس	bo&#39;lmasligi
عرض	ko&#39;rsatish
إلى	etish
سائق	drayveri
sci.med	sci.med
نحن نعتمد على،	tayansak,
منهجة	sistemleştirmek
(داريل	(Darryl
عام	Umuman
vfintd.386	vfintd.386
أي شئ	Anything
دوري	Dori
عرضة	Zaif
اقتراحات	takliflarni
تقرير	aniqlash
المعادن،	metall,
مكوورلد	Macworld
البتنت	Bitnet
دينينغ	Denning
واشنطن	Vashington
سمور	somwhere
متهور	eítiyotsizlik
في حينه	vaqtida
جنوبي	janubiy
ديفيد	devide
ماثيو	Matto
موهبة	iste&#39;dod
على متن الطائرة	onboard
أنت	Sen
عهد	Ahd
مهروس	ezilgan
الجو	atmosferasining
هم	ular
باب	bobda
الرب	Rabbimiz
).	uchun).
ليس	Emas
أعمال	ishlari
قشعريرة	chill
على نطاق واسع،	keng,
و	esa
الانضمام إلى	yopishgan
----------------------------------------------	----------------------------------------------
عمل	harakat,
هل من الممكن؟	mumkinmi?
كلية،	kolleji,
بيع	Sotish
sys.ini	sys.ini
(O)	(Ey)
مسيحية	nasroniylik
سؤال	savolga
محطات	stansiyalari
مليار	milliard
صديقي	do&#39;stim
ريتشارد	Richard
TTL	TTL
اللاعبين	futbolchilar
:-)	:-)
بيئة	Muhitini
كنت	odamsiz
مصباح،	Chiroqqa,
الأوروبيون،	evropaliklar,
أنظمة	tizimlari
كارلتون	Karlton
العمل:	harakat:
بغيض	yoqimsiz
رئيس	boshingni
ضريبة	soliq
حرب	urushi
أن تكون	bo&#39;lishini
أولا	Birinchi
غير مناسب	noo&#39;rin
هنا	mana
موجه	again
html>	oak.oakland.edu:pub/msdos/windows3/winjp210.zip
هواء	Air
غير	bormoqda,
الجسم	tanasi
وGT.	dastur&gt;
بدوره،	navbatida,
هو.	bormoqda.
هو؟	bormoqda?
كويستا	Cuesta
زلزالي	seysmik
إمكانية	imkoniyati
الثقة	ishonch
التحول	Kommutatsiya
يمارس	namoyondalarining
C.)	C.)
اليوم	kunda
دودسون)	Dodson)
على &amp; quot؛ gnostein؟	&quot;gnostein?
منطقة	mintaqada
رؤية	ko&#39;rishingiz
مستقر	Barqaror
تطبيق	ariza
الناس	kishi
نظم،	tizimlar,
تم العثور عليها.	topilgan.
لا تعد ولا تحصى	son-sanoqsiz
غيبوبة	koma
رفيق الحجرة	xonadoshim
وجدت،	topilgan,
القيامة	tirilish
على &amp; quot؛ جيدة ومثل؛	&quot;yaxshi&quot;
معظم	eng
هم	Ular
نقطة &amp; GT؛	nuqta&gt;
العلامة &amp; lt؛ 188@ky3b.UUCP&amp;gt.	&lt;188@ky3b.UUCP&gt;
BMP	BMP
TSC	TSC
المبلغ.	tutadi.
BMW	BMW
الشعور	hissini
مرئي	ingl
أصدقاء	do&#39;st
فوهة البركان	krater
فرصة،	imkoniyat,
جيوتو	Giotto
كسر	sinishi
قوية وGT.	strong&gt;
مشكوك فيه	Shubhali
التعدين!	kon!
والده	Otasi
المجتمع ومثل؛	jamiyat&quot;
بارتون)	Barton)
أفكار	fikrlarini
مستوى	daraja
خلف	orqasida
جزء	qism
منجم	konini
&quot;.	&#39;joylashgan.
على &amp; quot؛ العودة	&quot;orqaga
ك	sening
الثانية)	ikkinchi)
التحول	kommutatsiya
مشاريع	loyihalarni
بذرة	nasling
بضائع	mollarni
قدرة &amp; GT؛	qobiliyatini&gt;
DECAY	parchalanish
الجو	atmosferasi
.	ega.
&#39;93)	&#39;93)
مشهد	manzara
،	ega,
مقطع.	tingladi.
ديفيس)	Davis)
تحطم	Crash
المهام	vazifalarni
سائل	suyuq
عمرو	Amr
مسيرة	mart
وصف ل	tavsifi
حالة	vaziyatni
؛	ega;
الجسيمات النيزكية الدقيقة	mikrometeoritleri
C2.	C2.
غويا.	go&#39;yo.
(خاصة	(ayniqsa
يدور	aylanayotgan
مقاومة	empedans
آنا	Ana
تكنولوجيا	texnologiyalari
()	(),
1-301-340-4543	1-301-340-4543
().	().
أن	degan
miyop	miyop,
السيطرة على الموقف	munosabat-nazorat
استثمار	investitsiyalash
(10-105	(10-105
الكيمياء	kimyosi
المبيضات	candida
وطن؛ &amp; GT؛	&gt;&gt;.
الكواكب	Sayyoralar,
كتل	bloklari
وطن؛ &amp; GT؛،	&gt;&gt;,
الأجهزة	vositalar
عيون	ko&#39;zlarimga
عراك	jang
ديلاوير	Delaware
البريد الإلكتروني:	email:
755-8742	755-8742
إنقاذ	qutqarishga
حزن	qayg&#39;u
الكواكب	sayyoralarda
لا يعد ولا يحصى	behisob
جالانت،	Galant,
كما	sifatida,
المادية،	jismoniy,
.	sifatida.
عمدا	qasddan
على النحو التالي:	sifatida:
فلسطين	Falastinga
كثيرا	tez-tez
أساسي	fundamental
html>	jmilhoan@magnus.acs.ohio-state.edu
H	So.
مجموع	jami
أ)	agar)
إذا،	agar,
صلاة	Namoz
مركز	Markaz
html>	gt7469a@prism.gatech.edu
الشاهد	guvoh
1312	1312
Alt.psychology.personality	Alt.psychology.personality
صحيح،	rost,
ما	Nima
حفظ	saqlash
لا.	ettirmaydi.
الجو	atmosfera
منارة	Buy
يمشي	yurishlari
وجود	borligini
(6)	(6)
العلامة &amp; lt؛ رقم	&lt;No.
تحديث	yangilangan
الاقتضاء	tegishli
بندقية و GT.	miltiq&gt;
وGT.	qilinadi&gt;
(59	(59
ADAPTEC	Adaptec
اليورو	evro
وجدت	qildi
فتحة	uyasi
سمك السلمون	salmon
دائم	Doimiy
GIF	gif
لماذا	nega
عربي	arab
تصميم	mo&#39;ljallangan,
أمر.	buyurgan.
لذلك،	sababli
(5)	(5)
حقوق	huquqlar
القانون	Qonun
أومبريا	Umbriel,
ganimedes	ganimedes
الدعم،	qo&#39;llab-quvvatlash,
أشهر	oylar
الكويكبات	Asteroids
الصفحة)	Page)
نفط	neft
حراسة	qo&#39;riqlab
بارتون	Barton
جوهر	yadrosidagi
السماح.	qilsinlar.
(4)	(4)
هذا هو	Bu,
على &amp; quot؛ المدار	&quot;orbitasida
Landmann &amp; GT؛	Landmann&gt;
موصلات	ulagichlar
نظم،	tizimlari,
موجه،	irodasi,
S	Ning
المذنبات	kometalar
ذعر	vahima
على &amp; quot؛	&quot;Evropa
نووي	yadro
طبيعي	normal,
متلازمة) وGT.	sindromi)&gt;
لي	Mening
إذا	Agar
كل شيء؟	barcha?
عقيدة	dogma
سيارات الدفع الرباعي	SUV
يبدو؟	ko&#39;rinadi?
المادية	Jismoniy
(3)	(3)
قيود	Obligatsiyalar
ثابت	etilgan
سيتم عرض.	ko&#39;rinadi.
دعم	qo&#39;llab-quvvatlashi
فارياتي	variaty
جميع)	barcha)
أسر	Capture
[26]	[26]
قال	Aytib
جميع.	barcha.
على سبيل المثال،	masalan,
(27	(27
الأعداء	dushmanlarini
طمي	zambil
يبدو)	ko&#39;rinadi)
(24	(24
البريد الوارد	qutisi
فقط	faqat
التحركات	aylanayotib,
مدارات.	aylanayotib.
مشفرة	kodlangan
ل	Uchun
يوميا	kungi
استراحة	sindirish
اليوم،	kuni,
في عقول	ongida
(2)	(2)
لا	kelmading,
ميراندا،	Miranda,
======================	======================
من ناحية أخرى،	tomondan,
82:	82:
(1)	(1)
عين	ko&#39;zga
مغادرة	qoldirib,
متصلا	ulangan
محفوظ	saqlanib
============================================	============================================
(745	(745
تجديد	yangilash
الكتاب المقدس و GT.	Bibliya&gt;
[23]	[23]
LaStrange)	LaStrange)
روح	Ruh
النادي -يوم	kun-klub
استخدام	ishlatish,
السيارات	avtomobillari
ميناء	yuramanmi
نسبي	qiyosiy
لا تخلط.	aralashtirmang.
شجاعة	jasorat
المواد	moddalar
حارس مرمى	goaltender
استغلال	ekspluatatsiya
هم	ularning
بصري	optik
المؤرخون،	tarixchilar,
[24]	[24]
فريد من نوعه	nodir
[25]	[25]
أمام	oldida,
خواتم	Halqalarni
الآلي	Avtomatlashtirilgan
مغلقة.	yopiladi.
على &amp; quot؛ بافل	&quot;Pavel
ديفي هيلمان	Diffie-Xellman
(يوك	(Yuk
html>	I3150101@dbstu1.rz.tu-bs.de
7 السطح	7-sirt
html>	jh6r@andrew.cmu.edu
(خبز	(Bake
شكلت	shakllantirildi
المناورة	manevra
غاز	gaz
من فضلك	iltimos
MAY	MUMKIN
تطلب	so&#39;rab,
.	qiling.
سام	Sam
استعمال	foydalanishingiz
استيراد	import
أتذكر،	eslayman,
كريمر	Cramer,
بيضاوي الشكل	elliptik
Franjione)	Franjione)
كريمر)	Cramer)
Triantafyllopoulos	Triantafyllopoulos
تركيز	quyilib
(؟)	(?)
&quot;الهدف	«ob&#39;ektiv
عصابة	ring
من فضلك!	qiling!
توقعات	prognozi
plutoneon	plutoneon,
وGT.	boshladi&gt;
ذبح	so&#39;yilgan
لدفع	to&#39;laydi
فاسد	buzilgan
كيف	qanchalik
لا شيء UUCP	UUCP:!
أرقام	raqamlari
على &amp; quot؛ الهدف	&quot;ob&#39;ektiv
استهلاك	Iste&#39;mol
GAY	gay
عام	Umumiy
الملصق	poster
السلف	salafiy
العلامة &amp; lt؛ id.XNFZ.VJ8@nmti.com&amp;gt.	&lt;id.XNFZ.VJ8@nmti.com&gt;
على &amp; quot؛ ف &amp; مثل؛	&quot;q&quot;
جملة	gap
حي	mahalla
عين	ko&#39;zni
=====================================	=====================================
9846	9,846
شارك	posted
خيار	variant
كانت	qilindi
فعلت!	edim!
تحديد،	aniqlash,
hobbiest	hobbiest
له	o&#39;zining
الوديعة	Depozit
نيون	neon
منح	bermoq
نقطة من رأي	kelin-of-ko&#39;rinishida
شرف	sharaf
على &amp; quot؛ الجو	&quot;atmosfera
شاحب	xira
(ريتشارد	(Richard
أكسجين	kislorod
html>	c23st@kocrsv01.delcoelect.com
دائم	doimiy
6X9	6x9
كما	Sifatida
على &amp; quot؛ الإنسان	&quot;Inson
سان	San
كيم	«Kim
ما.	nima.
(سكوت	(Scott
ما	nima,
تريد	kerakli
أداء	ishlash
ابتدائي	boshlang&#39;ich
كنديينز	Canadiens
نسيت كلمة المرور؟)	unutdingizmi?)
خلال	paytida,
كنا.	edik.
خبز محمص	tushdi
محاط	o&#39;rab
جدا	Juda
وGT.	shuningdek&gt;
كينزي	Kinsey
رقائق	chiplari
إكس تيرم	xterm
ماذا؟	nima?
انتقال	uzatish
DES	DES
فنلندا	Finlyandiya,
معيار	standart
753-3245،	753-3245,
أن تكون	bo&#39;lishimiz
2400	2400
الدعم	qo&#39;llab-quvvatlasa,
روزا	Rosa
روكفيل،	Rockville,
بقدر	O&#39;qisak,
ضرب)	urdi)
الدوري	ligasida
سمعت؟	eshitilgan?
كما	qilib
حكم	qoida
(93	(93
مثل،	o&#39;xshash,
التصحيحات	tuzatishlar
مكان	o&#39;rinda
فعلت.	edim.
html>	cj195@cleveland.Freenet.Edu
المذنبات	kuyrukluyıldızların
stylizied	stylizied
وفقا ل	qaraganda,
ذكر	eslatib
شرطة	politsiya
إيمان	imon
الفصل	ayrilish
UUNET.	uunet.
وضعت	joylashtirilgan
(88	(88
نافذة	oynasida
تذكر	yodda
ESPN	ESPN
الجو	atmosferada
درجة الحرارة،	harorati,
تحقق في	betob
تعاون	hamkorlikda
201	​​201
(128.149.6.2)	(128.149.6.2)
قضية	masalaga
رولاند	Rowland,
صغير	Kichik
WEISS	Vayss
شمالي	Shimoliy
العلامة &amp; lt؛ 1r1i7mINN4n4@cronkite.cisco.com&amp;gt.	&lt;1r1i7mINN4n4@cronkite.cisco.com&gt;
لا.	olmang.
باستثناء	eksklyuziv
html>	korenek@nmti.com
اعتقدت.	o&#39;ylardim.
تيار &amp; مثل؛	amaldagi&quot;.
الشروط	sharoitlar
تركيب	o&#39;rnatish
العرب	arablaridan
هادي	Hadi
اليهود،	yahudiylarga
أسمر	jigarrang
هيغنز	Gyuygens
24:46	24:46
أحيانا	ba&#39;zan
رسم الخرائط	xaritalash
أمل	umid
الخمائر	achitqilari
-thirds	uchdan
Harumph.	Harumph.
مستقر	barqaror
قصة	hikoya
الأنشطة	faoliyati
غزل	Spin
السلوك ومثل؛	xulq&quot;
html>	vacsc0qe@VAX.CSUN.EDU:
نيلسون)	Nelson)
الدول	davlatlar
علماء الفلك	Astronomlar
وGT.	kelgan&gt;
A &amp; GT؛	A&gt;
زبيب	Zbib
حياة	yashaydi
دقة	ro&#39;parasiga
،	paydo,
قيمة	qilardi
هي	etilmoqda
(هذا	(Bu
VanHeyningen	VanHeyningen
ربما	Balki
نصب تذكاري	yodgorlik
رقيق	yupqa
غاز الأمونيا	ammiak
كشفت.	nozil.
مغلق	qulflangan
كاميرات	kameralar
اعتقد	o&#39;ylab
SKS	SKS
الوسائل	anglatadi
ممارسة	amaliyot
كل	hammasini
إذا كان	qilsa
html>	leonard@aix3090b.uky.edu
2300	2300
ثقافة	Madaniyat
من أنت	sizlardan
القادة	rahbarlar
عاد	qaytgan
على &amp; quot؛ الأسلحة	&quot;qurol
غرامة،	nozik,
غاز الأمونيا	Ammiak
سائق	haydovchi
العرض	displeyda
00ecgillespi@leo.bsuvc.bsu.edu&amp;gt.	00ecgillespi@leo.bsuvc.bsu.edu&gt;
منهم	ulardan
فجأة	birdan
نهاية	End,
أنا	qilaman,
سحرت.	ketkazdi.
الاضمحلال	parchalanishi
إمكانية	potentsial
التشريع	Qonunchilikni
في المرتبة الثانية	ikkinchi
مواطن	Citizen
بنادق	o&#39;qotar
415-	415-
،	olgan,
أصليا	parented
SRESURRECTION :::	«SRESURRECTION:::
اللوحة الأم	anakartı
قائمة	ro&#39;yxatiga
أفريقيا	Afrika
رئيسي	asosiy
ومثل؛	olib&quot;
مدفع	to&#39;p
نحن	Biz
البرتقالي	to&#39;q
غربا	G&#39;arbga
مشاعر	his-tuyg&#39;ularini
عاش	yashagan
كيرك.	Kirk.
العلامة &amp; lt؛ jh6r+@andrew.cmu.edu&amp;gt.	&lt;jh6r+@andrew.cmu.edu&gt;
الولايات المتحدة الأمريكية	AQSh
الأسلحة:	qurol:
ضخ	infüzyonları
I &amp; GT؛	mening&gt;
الرجال	erkaklar
المحلات التجارية	do&#39;konlari
العاملين	xodimlari
أنا.	qilaman.
أسلحة	qurol,
واحد	Bir
الولايات المتحدة	United
!	beradi!
روبرت	Robert
كيلومتر	kilometr
لكن	Lekin
ضاربا)	hitter)
الأردن	Iordaniya
أصدقاء	do&#39;stlarim
البحث	izlab
SER	SER
SET	SET
مادة	moddiy
رد:	Re:
القرن 20th	20-asrning
الاضطرابات	chetlashish
،	beradi,
البحث	araştırdıktan
إعادة؟	Re?
.	beradi.
جمهور	Public
أحمر	Red
يريد	qilmoqda
ك	Sizning
على ما يلي:	beradi:
أو	yoki
ظروف	holatlar
البحارة	dengizchilar
نشاط	faoliyat,
إذا كان	qilsa,
ملصقات	plakatlar
تغيير	o&#39;zgargan,
الناس	odamlarning
على &amp; quot؛ جوناثان	&quot;Jonathan
أتش تي أم أل&gt;	html>
فلاش	flash
فكر	fikr
SPL	SPL
دور	o&#39;rni
ممولة	moliyalashtirilgan
رقيق	ingichka
فو	foo
سوف	bo&#39;ladigan
فصول	sinflari
نتيجة لذلك.	natijasidir.
COD	COD
---------------------	---------------------
دوامة	girdap
النهج.	yondashuv.
على سطح المكتب،	stoli,
نهج	yondashuv,
أفكار؟	fikr?
صندوق البريد	POBox
وون	kiritdi
أطلقت	Ishga
يتضح	Illustrated
ابنه،	o&#39;g&#39;li
الأشخاص	shaxslar
على الأقل	Kamida
قضية	masalaning
جوهر	mohiyati
البيسبول	beysbol
لي	meni,
اليهود	yahudiylarni
رون	Ron
المعايير.	mezonlari.
لي	menga
نحن مهتمون.	manfaatdormiz.
الرئة)	O&#39;pka)
اليوم	bugun
الآن	Endi
النجوم	yulduzli
البنود	buyumlar
كروفورد	Crawford
يد	qo&#39;lini
أسعار	narxda,
تعريف	belgilab
في إطار	doirasida
الحديث،	munozara,
أفضل)	yaxshiroq)
مجمع.	murakkab.
قائمة	ro&#39;yxatida
Lebannon	Lebannon
فرح	quvonch
بووربووك	PowerBook
IMHO	IMHO,
العالي	OLIY
جون،	Yuhanno,
CE،	Milodiy
ارتفاع	baland
تاريخيا،	Tarixan,
(إعادة:	(qayta:
عام	yilning
أو &amp; GT؛ &amp; GT؛،	bo&#39;lmasa&gt;&gt;,
انتقال	uzatish,
تصدير	eksport
نيويورك،	Nyu-Yorker,
يسوع	Isoning
المنتهية ولايته،	boruvchi,
النضال	kurash
بقعة	Spot
وترد	ko&#39;rsatilgan
تغيير	o&#39;zgardi
اليهودي	Yahudiy
حلقات،	uzuk,
إزعاج	noqulayliklarni
(5.25	(5,25
أثر	asar
في فصل الشتاء	qishda
(J.	(J.
الانحراف	eksantrikliği
&#39;	»,
274-5357	274-5357
.	».
العلامة &amp; lt؛ 1993Apr21.234159.1206@ualr.edu&amp;gt.	&lt;1993Apr21.234159.1206@ualr.edu&gt;
وجه	duch
فقط	yagona
رأيت	ko&#39;rmagan
على &amp; quot؛ دراكولا ومثل؛	&quot;Drakula&quot;
[قياسي	[standart
منطقة	maydon
خشب	yog&#39;och
...]	...]]
كتلة	Ommaviy
نقطة،	nuqtasi,
الصلاة و GT.	ibodat&gt;
(إدوارد	(Edward
أسبوع	hafta
أساسيا	asosan
التحيات،	Regards,
سميك	qalin
كتاب	Kitobda,
مناقشة	muhokama
تقريبا	taxminan
الماسح الضوئي.	skaner.
نبع ماء حار	geyzer
ينطبق)	qo&#39;llaniladi)
جلب	keltirib
(منظمة الصحة العالمية	(kim
ماتسوي	Matsuo,
تطلب	so&#39;rash
الهوكي	Xokkey
الخلافات	farqlar
؟ ومثل؛	oshiriladi?&quot;
عن قرب	yaqin-up
مواطنية	fuqarolik
15-ثعبان	15-ilon
أندونيسيا	Indoneziya
قسم	departamentining
شخص وGT.	kimdir&gt;
كل	Barcha
كولومبيا وGT.	Columbia&gt;
أفراد	Xodimlar
منجل	o&#39;roq
فك تشفير	parolini
بوس	Bos
90٪	90%
طلب	So&#39;rov
فيديو	video,
ثم،	keyin,
مونتريال،	Monreal,
أو	Yoki
تفعل	qilayotgan
بالتناوب	galma
حسن الضيافة	mehmondo&#39;stlik
مواجهة	qaragan
ملفات	fayllari
الناس	Odamlar
مهمة	missiya
شاب	yosh
غير محظوظ	omadsiz
OpenLook	OpenLook
مثل	Bunday
قال.	aytiladi.
Vehical	Vehical
تأثير:	ta&#39;siri:
html>	sharma@tiger.vill.edu
المثقفون	ziyolilar
قرون،	asrlar,
أنشطة	faoliyatida
وGT.	ta&#39;sir&gt;
SPIE	trayektoriya
خطورة	tortish
الحيوانات	hayvonlar
العلامة &amp; lt؛ C5w5CB.Ct4@rahul.net&amp;gt.	&lt;C5w5CB.Ct4@rahul.net&gt;
فيديو	video
(&amp; اللفتنانت؛ س &amp; GT؛	(&lt;o&gt;
السياح	sayyohni
ذيل	quyruq
^^^^^^^^^^^^^^^^^^^^^^^^^^	^^^^^^^^^^^^^^^^^^^^^^^^^^
لا يمكن العثور عليه.	topmadik.
(يوحنا	(John
.	ko&#39;rsatgan.
المجرمين	jinoyatchilar
كافية.	qondiradi.
بالإضافة إلى ذلك،	Bundan
73	73,
انه &amp; GT؛	He&gt;
فريدمان	Friedman
المفتاح	kaliti,
حكم	hukmronligi
أرسلت ل	yuboriladi
و:	bir:
أصغر،	kichikroq,
مجلس	kengash
ل	bir,
اسمه	nomidagi
محطة	Station
27.6	27.6
ثنإكس	Thanx
أخلاق	axloqini
خلاص	Najotga
حدث	voqea
القشرة	qobig&#39;ining
تسجيل الدخول	jurnallar
(ولكن	(lekin
حكومة	hukumatining
خطط	rejalari
أنا لست مثل &amp;؛	emasman&quot;
مهنة	hunar
Lampoon_	Lampoon_
الكويكب	Asteroid
Selannes	Selannes
)	taqdim),
أود.	izlayapman.
شقيقه	ukasi
أوليفيرا	OLIVEIRA
استخدام	foydalanishni
واحدة من	biri
المياه والجليد	suv-muz
وارتمى	sho&#39;ng&#39;idi
410-34-1	410-34-1
البرمجيات	Software
زبادي	yogurt
ديناميكي	dinamik
لدفع	to&#39;lash
ضاربا	Hitter
أثار	ko&#39;tardi
على الأرض	kata
قطب	qutb
سرعة	Tezligi
[بولد	[Bo&#39;ldi
مجلس	kengashi
ترتيب	Buyurtma
على &amp; quot؛ أوران	&quot;Uran
700	700
703	703
قوة	kuchga
الاعتماد على	tayanib
و	Va,
الخادم	serverda
مايكروسوفت	Microsoft
خشب القيقب	Maplewood
بإنشائه.	yaratilgan.
العناصر	elementlarning
كينيدي	Kennedi
حدث	voqea,
DX)	DX)
زيارة	tashrif
من	dan
بقية	dam
صورة	tasvirni
غاز	gazni
على &amp; quot؛ البصرية	&quot;optik
على ما أظن)	o&#39;ylayman),
كوب	Cup
جولة	dumaloq
I &amp; GT؛	I&gt;
لي)	Lee)
المثلية	besoqolbozlik
ABI	ABI,
جزء من	tarkibiga
نانايمو	Nanaimo
.	soni.
واللفتنانت؛ س &amp; GT؛)	&lt;o&gt;)
على &amp; quot؛	&quot;imkonini
منطقة	maydoni,
كينيدي	Kennedy
مؤقت	vaqtinchalik
html>	cl056@cleveland.Freenet.Edu
(سبيروس	(Spiros
المقاعد	o&#39;rinli,
kulupush	kallapo&#39;sh
7.5	7,5
الذي يعتقد	ishongan
.	ko&#39;rgan.
رمية	maydonga
مهنة	kasb
المغاربة	Moroccans
منزل	uyimni
،	ko&#39;rib,
أنا؟	emasmanmi?
html>	&lt;1APR199313404295@skyblu.ccit.arizona.edu
1200	1200
200uf	200uf
عملاق ومثل؛	devi&quot;
فيتامين	vitamin
السائقين	haydovchilar
يعيد رسم	redraws
في الكلام	gapira
(61302	(61302
افي	Ave.
شبه الطبي	Psevdo-tibbiy
الطائرات	samolyot
وفقا لذلك،	ravishda,
الغضب	g&#39;azabini
هنري	Henry
دعا	atalmish
الصلاة.	ibodat.
ويتن	Whitten
شرح	Tushuntirib
عبادة	ibodat,
يتمتم	ming&#39;irlaydi
html>	zbib@bnr.ca
html>	betel@camelot.bradley.edu
العلاجات	muolajalar
توسيع	kengaymoqda
فصل	ayrim
و.	va.
العلامة &amp; lt؛،	&lt;,
حجم	hajmi
و،	va,
(IMHO)	(IMHO)
في الماضي،	o&#39;tmishda,
الكلمات	so&#39;zlar
زيادة.	oshirildi.
ماكورد	McCord,
و!	va!
منهم	ularga
DOSKEY	DOSKEY
(بلادي	(mening
طبقة	qatlam
منزل	home
ميكروسوفت ويندوز	MS-Windows
الصواريخ ومثل؛	raketa&quot;
بنتيوم	Pentium
وقد استخدم	foydalanilgan
_outside_	_outside_
(الرعاية الطبية	(Medicare
(الوطني)	(Milliy)
الإرهاب وGT.	dahshat&gt;
html>	rauser@fraser.sfu.ca
العمليات	jarayonlarini
يريد	istaydi,
التجريبية	empirik
HMMMMMMMMMMMMMMMMMMMMMMMMMMMMMMMMMMMMMMMMMMMMMMMMMMMMMMMMMMM	HMMMMMMMMMMMMMMMMMMMMMMMMMMMMMMMMMMMMMMMMMMMMMMMMMMMMMMMMMMM
ملف	Fayl
في	o&#39;zida,
تصحيح:	Tuzatish:
هم	ularda
أن	Deb
زيادة؟	oshirildi?
قوانين	qonunlari
غاضب	badjahl
(العديد)	(severy)
).	bor).
على ما أعتقد.	o&#39;ylayman.
على ما أظن)	o&#39;ylayman)
_him_	​​_him_
الأخلاق،	axloqiy,
في المرة القادمة؟	keyingi?
أعتقد،	o&#39;ylayman,
حيرام	Xiram
أوبيرون	Oberon
لوطي	homo
.....	.....
عربة	Van
لهب	alanga
العلامة &amp; lt؛ 2958804@QUCDN.QueensU.CA&amp;gt.	&lt;2958804@QUCDN.QueensU.CA&gt;
احتكاك	ishqalanish
المكتب:	Office:
قابلة للطي	yig&#39;ilib
الإقليمية،	viloyat,
واي مينغ	Wai-Ming
العالم	dunyoda
دون كسر	buzmasdan
الرموز.	ifodalaydi.
نرحب.	olqishlaymiz.
المرخصة	litsenziyaga
يلقي	tashlashdi
أعنيه.	tutyapman.
قفل	qulf
ميزة	xususiyati
إيسن	esgan
على &amp; quot؛ ومع ذلك،	&quot;Lekin,
إلتهاب الجيب	sinüzit
الجيران	qo&#39;shnisidan
اعتذار	uzr
أكواب وGT.	Mags&gt;
الإرهاب)	Terrorizmga)
html>	gt7469a@prism.gatech.EDU
فرانك	Frank
تخمين؟	taxmin?
حظر	taqiqlash,
622121	622121
طاقة	energiya
أسعار	narxlari
العلامة &amp; lt؛ I	&lt;Men
الأماكن	joylardan
برنامج	Dastur
ونحن،	biz,
في يناير،	yanvar,
علم	fanining
احترس	hazir
1978	1978,
الخلافات	farqlarni
المشجعين	muxlislari
صورة	manzarani
مقدر	taxmin,
فعال	samarali
وهذا هو،	Ya&#39;ni,
مرح	hazil
Kreiller)	Kreiling)
أرسلت	yuborilishi
من	Dan
الرسم البياني	sxema
وبصرف النظر عن	chetda
رجو	Regio
على &amp; quot؛ العربية &amp; قووت]؛؟	&quot;arab?&quot;
التشغيل الآلي،	uya
قوي	kuchli
التدريس.	o&#39;rgatish.
متهالكة.	cratered.
المدارية	orbiters
أعتقد	hisoblayman
المشجعين	muxlislar
html>	goolsbey@cs.utexas.edu
تخضع ل	tortiladi
معلومات	ma&#39;lumotni
750	750
مخاضة	Ford
إلا	tashqari
سيارة	avtomobil
الفضاء	tipi
Faehl	Faehl
)	oladi)
،	oladi,
.	oladi.
قاعدة	tayanch
احتفال	nishonlash
الهيئات	organlarning
VLB	VLB
32-بت	32-bit
الأرض الحجم	Earth-o&#39;lchamli
آب	Avgust
كرر	bo&#39;lyapti
html>	king@reasoning.com
لا.	emasligini.
طريق	yo&#39;l
عالم	dunyoni
486DX-33	486DX-33
لا	yo&#39;q
4،0-4،3	4.0-4.3
النظامية	tizimli
المعلمات.	parametrlarni.
تدفق	oqimi,
ضجيج	shovqin
إلى الانحراف	uzoqlasha
كليوباترا	Cleopatra
صدر	beriladigan
النفقات.	ketadi.
أنها وGT.	Ular&gt;
الذهاب	ketadi,
وGT.	o&#39;tish&gt;
ترتيب	buyurtma
أخضر	yashil
المريخ	Mars,
ستيف	Steve
VLX	VLX
استراحة	tanaffus
R &amp; GT؛	R&gt;
DLC	DLC
رأي	ko&#39;rish
العمليات	jarayonlarni
html>	blaisec@sr.hp.com
مخطط	diagramma
VMS	VMS
دوغلاس	Duglas
المتهم.	ayblashadi.
كاف	Etarli
أم،	Um,
فهرنهايت)	Farangeyt)
بلوتو	Plutondan
نافذة	darcha
وGT؛ &amp; GT؛	ekan&gt;&gt;
لها	unga
موك)	Mocker)
DMA	DMA
نقد	tanqid
MUTE	o`chirilishi
تهمة	zaryad
عند هذه النقطة،	nuqtada,
خطبة	va&#39;z
خوارزمية	Algoritm
آسف،	uzr,
المشهد	manzarasi
(هال	(Hal
ميتسوبيشي	Mitsubushi
يتحدث،	gapirib,
(حسنا	(Ham
----	----
رقاقة،	yonga,
بعث	tirilgan
إرسال	yozish,
وGT.	to&#39;liq&gt;
بعيدا	uzoq
(أن تكون	(bo&#39;lishi
يسوع وGT.	Iso&gt;
______________________________________________	______________________________________________
حياة	hayot
هناك).	bor.)
يحسن.	yaxshilaydi.
بالإضافة إلى ذلك،	Tashqari,
العلامة &amp; lt؛ May.12.04.27.47.1993.9935@athos.rutgers.edu&amp;gt.	&lt;May.12.04.27.47.1993.9935@athos.rutgers.edu&gt;
لها	Uni
عندما	berganda
فرصة	imkoniyat
هل ترى؟	ko&#39;ryapsizmi?
html>	ron.roth@rose.com
البيئة	atrof-muhit
شكل	shakllantiradi,
محاولة	ko&#39;ring
دقة	to&#39;g&#39;riligi
تيودور	Teodor
من الدرجة الثانية	ikkinchi-tartibi
يستخدم	ishlatiladi
أداء	bajarilgan
هبطت	qo&#39;ndi
المدار:	orbitasi:
على &amp; quot؛ ستيفن	&quot;Stiven
ألم	og&#39;riq
نظرة	nazar
على &amp; quot؛ بورلاند	&quot;Borland
5500	5500
تركيب	tarkibi
كهربائي	Elektr
ظننت	o&#39;yladim
زراعة	xo&#39;jaligi
7.00	7.00
بيئة،	atrof-muhit,
(317)743-1394	(317)743-1394
خامس	beshinchi
عصابة	uzuk
على المريض والطبيب	Kasal-tabib
خليل	xelion
جولييت	juliet
للعيش	yashashni
أيديولوجية	g&#39;oyaviy
140-165	140-165
المعرفة	bilimdon
الناس	Kishi
ورقة	qog&#39;ozga
دولة	davlatni
ترسيخ	kavlash
،	bo&#39;lishini,
(	(qayta
نافذة	derazadan
المفتاح العام	ijtimoiy-kalit
html>	batman@cisco.com
التصحيح،	tuzatish,
(-290	(-290
مثل	kabi
نظام	tizimi,
(آرون	(Aaron
هناك.	bor-ku.
سهل	oson
(-298	(-298
تسجيل الدخول	tizimga
(على سبيل المثال،	(masalan,
حياة	umr
ديبورتيس	Deportes
نظام	tizimda
أشكال	shakllari
(مثال)	(masalan)
المشي	yurgan
الموظفين.	mutaxassis.
الظاهر	zohiriy
ديفي هيلمان	Diffie-Hellman
العالم	dunyolar,
الفلسطينيين	Falastinliklar,
8.6	8,6
الصحاري،	sahrolarda,
موقف	lavozimidan
مليون	million
اكتشاف،	kashf,
استقراء	ekstrapolyatsiya
حياة	hayotdirman
8.1	8.1
لها	uni
خلاف	munozara
رؤساء	rahbarlari
مخترع	ixtirochi
ROSENAU)	Rosenau)
وهذا هو،	Ya&#39;ni
رئيس	Prezident
المثال.	misoldir.
الإجراءات	harakatlar
تصميم	modellashtirish
حدد.	tanlang.
حول	atrofida
ملاحظة	kuzatish
السبب	sababi
أمن	xavfsizlik
فرق	jamoalarini
_____________	_____________
الأنهار	daryolar
ونحن نعتقد ذلك.	ishonamiz.
أبولو	Apollon
في شكل	shaklidagi
(الكتاب المقدس	(Bibliya
.	qolgan.
(NRSV)	(NRSV)
شجيرة	butaning
سيد	janob,
اتصال؟	ulangan?
(إسحاق	(Ishoq
فم	Mouting
8.1	8,1
ORIGINAL	ORIGINAL
HOW	QANDAY
الأب	Otaning
متصلة)	ulangan)
html>	alane@microsoft.com
المثلية	gomoseksualizm
ضرب &amp; GT؛	hit&gt;
afronted	afronted
راديو	radio
آب	avgust,
هجوم	hujumga
إغلاق	yopildi
الكويكبات	asteroids
الحرجة وGT.	keskin&gt;
مدارات	orbitalari
رادار	radar
يستعاض	DEVICEHIGH
تدابير	chora
الينابيع	Springs,
أوروبية	evropalik
العلماء	olimlar
لا شيء UUNET	UUNET:!
على &amp; quot؛ اليهود	&quot;Yahudiy
الشروط	shartlar
كمية	miqdori
سلطة المصادر الطبيعية معتمدة	JPB-sertifikatlangan
نهاية	oxiri
CLR	Clr
حرارة	issiqlik
أرض	Yernikiga
رحلات	reyslar
لوم	ayblashga
قضايا	masalalar
شتاين	Stein
مرحبا!	Howdy!
9.12:	9.128:
الصمامات	sintezlashga
Gretzky	Gretzky
مسدس	to&#39;pponcha
التباطؤ.	pastlab.
ثم	unda
يقول	deydi
لها	Unga
DOS	DOS
نافذة	deraza
الجزر	orollar
(ليونارد	(Leonard
اتهامات	ayblovlarni
تجربة	tajriba
مظلوم	zulm
العلامة &amp; lt؛ 1qvb5aINNmoi@darkstar.UCSC.EDU&amp;gt،،	&lt;1qvb5aINNmoi@darkstar.UCSC.EDU&gt;,
حدث	tadbir
برنامج	dastur
شكر	thanks,
(	(har
الأصول،	mavjudotlar
مسلسل	seriya
مرة	vaqti
&quot;المؤقتة	«vaqtinchalik
دعاية	tashviqot
مايكروسوفت	microsoft
المرسل)	Jo&#39;natuvchiga)
المعمول بها.	belgilangan.
أنت ذاهب؟	ketyapsan?
مصر	Misr
قسم	Deptt.
لك &amp; GT؛	Siz&gt;
محتويات	tarkibini
ديفيد	Dovudni
معاناة	azob-uqubatlarga
تعاني	chekishi
،	belgilangan,
نقطة	nuqta
في	bo&#39;yicha
الأبحاث ومثل؛	tadqiqot&quot;
المسيح &amp; GT؛	Masih&gt;
(مايكل	(Michael
سمعت.	eshitildi.
محدود	cheklangan
الدول	mamlakatlarda
سوف	boradi
رعاية	g&#39;amxo&#39;rlik
الأراضي	hududlar
utzoo!	utzoo!
لا يزال قائما.	qoladi.
لا يزال،	qoladi,
رمي	uchirish
تخمين)؟	taxmin)?
متوقع	kutilmoqda,
ألمانيا	Germaniya
،	ko&#39;rsatib,
مثالي	mukammal
أوهام	illyuziya
أنا	qilamanki,
التعليمات	FAQ
سريري	klinik
وGT.	deb&gt;
.	turadi.
html>	sguerke@brahms.udel.edu
الريش	patlarni
html>	koutd@hiramb.hiram.edu
كوخ	kulba
انطلاقه	lift-off
واضح	CLEAR
الجديد.	yangi.
جديد،	yangi,
إيمان	imoni
شكلت.	shakllantirdi.
V9R	V9R
رفض	inkor
ميت	o&#39;liklar
صالح	manfaati
ساران	tuzoqqa
كما.	kelsak.
العلاقات	aloqalar
مركز	markaziga
الدول	Shtatlarida
الركاب	yo&#39;lovchilarning
ثلاثة	uch
ستالين	Stalin
ذكي	aqlli
البحر	dengizda
. ومثل؛	qanday.&quot;.
حيوان	hayvon
ترتيب	tartib
تيارات	oqimlarni
حملة	ekspeditsiya,
حدث	hodisa
AAS-92-186،	AAS-92-186,
كل من	ikkovlari
الوقت.	vaqt.
جبلي	tog&#39;li
ليس	bo&#39;lmadi,
كان	berdimi
الصور	tasvirlari
أقوى،	Kuchliroq,
(واضح)	(aniq)
23-25).	23-25).
بحث	tadqiqot
الأصوات	tovushlar
يعني؟	degani?
جودة	sifatli
korenek)	korenek)
يرتكب	committ
يبدو.	tovushlar.
منع،	to&#39;sqinlik,
1/1000	1/1000,
عيد ميلاد،	tug&#39;ilgan,
الناس	odamlar,
أيلول	sentyabr
ولد.	tug&#39;ilgan.
منطقة	mintaqani
بيان	bayonot
العلامة &amp; lt؛ Rauser.734062608@sfu.ca&amp;gt.	&lt;Rauser.734062608@sfu.ca&gt;
وقال:	deydi,
أجل،	tartibi,
العودة إلى	qaytish
إسحاق	Ishoqning
في وسط	markazida
الوسائل	degani,
على الطريق	yo&#39;lda
قطع	qirqish
Aili):	ailin):
قال.	deydi.
قواعد	qoidalarini
lmouse	lmouse
دليل على الطابع	dalil-belgilar
قال تعالى:	deydi:
مرة	vaqt,
يعني.	degani.
الوقت)	vaqt)
ستة	Olti
(2147	(2.147
(المستقلة	(Mustaqil
سكن	tirik
،	sabab,
حار	issiq
عار	uyat
بيلين	kamari
صفقة	paketini
لجنة	komissiyasining
6.4	6,4
باستخدام	foydalanib
ديك	ega
المريخ	marsliklarni
أحكام	qoidalariga
كنيسة	cherkov
مسار	yo&#39;lga
99.9	99.9
(29.95)	(29.95)
الوجود.	kelinmoqda.
التباطؤ في	pastlab
على ما يبدو،	tuyuladi,
عقل	aqlga
انه انحنى ايضا الى اسفل	engashib
على ما يبدو.	tuyuladi.
الكلمات	so&#39;zlarning
دعوى	kostyum
في عام 1972، و	1972-yilda,
تذكر،	eslab,
ومع ذلك،	qaramay,
البنوك)	Banklar)
مواز	Parallel
إذا	bo&#39;lsangiz
html>	nelson_p@apollo.hp.com
رؤية	ko&#39;rishni
الناس &amp; GT؛	odamlar&gt;
(932	(932
دوروثي	Dorothy
.indiana.edu	.indiana.edu
مرشح	nomzod
قانون	Qonuniga
بعد	so&#39;ng
استعمال	foydalana
حديث	gapirish
في الأيام الخوالي	ota-
كان	edi
لعبة	o&#39;yin,
جبان	zumga
ينتهي	qutblari
دائما وGT.	doim&gt;
6-7	6-7
أموال	mablag&#39;lar
على &amp; quot؛ كونستانتينوف ومثل؛	&quot;Konstantinov&quot;
المحفوظة.	saqlanadi.
على &amp; quot؛ الأزرق	&quot;ko&#39;k
Pinturicchio	degandi
مجموعة	oralig&#39;ida
حقيقة	haqiqat
راديو	Radio
كنت قد	topganingizni
بشرة	komplekson
عامل	omili
آثار	izlari
مفاجئ	keskin
ولادة	tug&#39;ilganidan
التصفيات	saralash
القانون	Qonunning
أقول ومثل؛	aytaman.&quot;
بحسب	muvofiq
العدو	dushman
THEWITNESS	THEWITNESS
نصاب قانوني	Quorum
والخبر السار	xushxabarni
البعثات	missiyalar
POSTITION	POSTITION
المكالمات	chaqiradi
العلامة &amp; lt؛ _Atheism	&lt;_Atheism
كاذبة.	yolg&#39;on.
نافذة)	oyna)
وGT.	albatta&gt;
التيارات،	oqimlari,
waiiiiiit	waiiiiiit,
الاخوة	birodarlarga
ومع ذلك،	Biroq,
مكرسة &amp; GT؛ &amp; GT؛	bag&#39;ishlangan&gt;&gt;
مقاومة	Empedans
يمكنك!	mumkin!
الغلاف الجوي،	atmosferasi,
الأجسام	ob&#39;ektlar
،	bo&#39;lgani,
)	mumkin)
خاصة	ayniqsa
Shostack	Shostack
لتبرير	oqlashga
العلامة &amp; lt؛ ...	&lt;...
.	mumkin.
يمكنك	mumkin,
نتائج	natijalari
يمكنك:	mumkin:
توجيه	orientatsiya
هيوز	Hughes
باكاييف	Baqoevning
الفضاء	kosmik
(الغربية	(g&#39;arbdan
يمكنك؟	mumkin?
استخداما) وGT.	qo&#39;llaniladi)&gt;
294-8153	294-8153
جونسون	Jonson
حوار	muloqot
يمكنك؛	mumkin;
تطلب	so&#39;ra
مونتيس	Montes,
معلومات	ma&#39;lumotlarni
(900	(900
قياس	o&#39;lchash
في	ravishda
رجل	insonning
ثلاثة	Uch
حزام،	kamar,
الرجال،	erkaklarga
1200-1500	1200-1500
المقدس	Ilohiy
geb@cadre.dsl.pitt.edu&amp;gt.	geb@cadre.dsl.pitt.edu&gt;
المثلية	Gomoseksualizm
لم أكن أرى	ko&#39;rmadim
6:.	6:.
على &amp; quot؛	&quot;qattiq
محشوة &amp; GT؛	tavba&gt;
دودسون	Dodson
المبنى.	barpo.
VDC	VDC
ماكدونيل	McDONNELL
الأوروبيون	evropaliklarga
5X9	5X9
النوافذ،	Windows,
الإعفاء	istisnolar
مقبوض	o&#39;tdi
العواصف	bo&#39;ronlari
(العودة)	(orqaga)
اندرز	Landers
قناع،	niqoblangan,
من الحصى الحجم	shag&#39;al-o&#39;lchamli
حامض	kislota
غاري	Gary
أحواض	tog&#39;orani
الأطفال	bolalar
على &amp; quot؛ &amp; مثل؛	&quot;Foydalanuvchi&quot;
html>	vax839@tid.es
(سانجيف	(Sanjeev
رادار رسم الخرائط	radar-xaritalash
ذرة	atom
قيود	Bonds
،	qabul,
html>	MLINDROOS@FINABO.ABO.FI
)	qabul)
أرض	quruqliklar
VGA	VGA
على &amp; quot؛ لدينا	&quot;Bizning
640	640
خاص	maxsus
تحديد	aniqlanadi
أشهر	oylar,
)	bo&#39;lishi)
نقطة	sirlaridan,
أسطول حربي	armada
الرسومات	Graphics
الوثائق	hujjatlarni
ثورة	inqilob
حمار	eshak
المعمد	Baptist
داخلي	Ichki
إلقاء الضوء.	yoritib.
(JT)	(JT)
وGT.	siz&gt;
جائزة	mukofot
سان خوسيه،	San-Xose,
المنحدرات	uçurumlar
اللهب.	otash.
يبدو	ko&#39;rinadi
عدالة	adolat
الدوائر	doiralar
ليل	tun
الزئبق،	Mercury,
التشفير	shifrlash
خير	yaxshi
يبدو،	tovushlar,
كامل.	to&#39;la.
يسمع.	eshitsa.
خطورة	gravity
تم الاسترجاع	olindi
هو ليس كذلك.	bo&#39;lmaydi.
مارتي	Marty
الفضاء	makon
ليس	bo&#39;lmaydi,
أتكينسون	Atkinson
صوت:	Voice:
(JPL	(JPL
رسم ومثل؛	chizish&quot;
تبريد،	soğutulur
الاجل	muddatli
486DLC 33	486DLC-33
لا:	bo&#39;lmaydi:
أرقام	sonlar
سفن	kemalar
بريان،	Brian,
مستوى	darajasida
تصحيح	tuzatish
أشهر	oylari
أضواء	chiroqlari
VHS	VHS
ما عدا)	mustasno),
النظير	peer
ليكون؛	bo&#39;lishi;
تعلم	oling,
هيوستن	Houston
جولة	Round
غير معروف	noma&#39;lum
البرتقالي	Apelsin
650	650
.	oling.
.	bo&#39;lishi.
مسلح	jihozlangan
مهمة	missiyasining
،	bo&#39;lishi,
FBI	FBI
سجل	o&#39;tishingiz
خيبة أمل	umidsizlik
علم الحيوان	Zoologiya
حمم	lava
حزيران	iyunda
quibble-	quibble-
أكثر من ذلك؟	ko&#39;proq?
لقطة	otib
تقاليد	urf-odatlari
درجة الحرارة الرئيسية	asosiy-haroratga
نحن نعرف ذلك.	bilamiz.
قصف	bombardimon
بداية	boshidan
حبوب	don
خوادم	serverlardan
سوف	bo&#39;ladi
html>	km@ky3b.pgh.pa.us
.	oldi.
إعلام	Axborot
لمست،	tegdi,
سانجيف	Sanjeev
الدول	mamlakatlaridan
دوس	dos
نحن نعرف؟	bilamiz?
تاج	tojni
خارج الأرض	dünyadışı
مرة أخرى،	qaytib,
معد	yuqumli
النيكل	nikel
رمي	tashlaydi
بيلتون	pelting
أحداث	hodisalarni
على &amp; quot؛ الهدف ومثل؛	&quot;ob&#39;ektiv&quot;
متاح	mavjud»
الصخور،	rock,
(-366	(-366
نقطة في البوصة	dpi
html>	Nunnally@acs.Harding.edu
طلاب)	shogirdlari)
التلويح	silkitib
فترة	davr
كيلو	kilogramm
ثالث	uchinchi
أمريكي	American
شاشة	ekranda
نوافذ	windows
ربما	Ehtimol
إحصائي	statistik
الفن)	Bading)
أطفال و GT.	bolalar&gt;
ربما	ehtimol
Siemon)	Siemon)
نبوءات	bashoratlar
وزارة الدفاع	DoD
تطلب	so&#39;raymiz
قاطع	unalterably
حديد	temir
حبر	siyoh
مرض	kasallik,
من قبل.	tomonidan.
400dpi)	400dpi)
بواسطة	tomonidan,
حادث	Aksiga
تاسع	to&#39;qqizinchi
غرامة،	ingichka,
لوجيتك	Logitech
تجد	topish,
northeners	northeners
العثور عليها.	topish.
عقد	shartnoma
محطات	stantsiyalari
الفضاء	fazoda,
FAX.	FAX;
لوقا	Luqo
سلطان	hokimiyatga
من أجل	maqsadida,
ولكن،	LEKIN,
لمعرفة	bilish
قش	somon
مفاتيح.	kalitlari.
القنوات	kanallar
(إدمونتون،	(Edmonton,
منهم	ularni
حلزوني	spiral
تحطم	blokirovku
.	o&#39;tdi.
في	Bo&#39;yicha
مواصفات	xususiyatiga
(ديف	(Dave
ضائع	yo&#39;qolgan
إعلام	Information
تسجيل	yozuvlarni
العقود،	tanitadi,
ياماها	yamaha
الشفق	auroras
أنا لا أريد!	istamayman!
وGT؛ &amp; GT؛	hisoblanadi&gt;&gt;
العلامة التجارية)	Brenn)
الهيليوم	geliy
تيم	Tim
البث	efirga
برين	Brenn,
التحضيرات،	tayyorgarlik,
وتستخدم	ishlatiladigan
مجهول	Anonim
معلومات	ma&#39;lumotga
256K	256k
تشهد على	shohiddir
سابق	avvalgilaridan
فضفاض	qimirlagan
إشارات	signallarining
إعطاء	berib
أن تكون	bo&#39;lishni
optilink	optilink
إذا كان	ketsa,
html>	newsdesk@jplpost.jpl.nasa.gov
الغيوم	bulutlarni
مؤقت	taymerni
توهج	qiziy
نهج	yondashuv
على &amp; quot؛	&quot;ma&#39;lumotlar
العلامة &amp; lt؛ 1993Apr7.221357.12533@lamont.ldgo.columbia.edu&amp;gt.	&lt;1993Apr7.221357.12533@lamont.ldgo.columbia.edu&gt;
الكتاب	yozuvchilar
المتاحة؛	mavjud;
كلمة	So&#39;z
مضحك	qiziq
على &amp; quot؛ &amp; مثل؛	&quot;foydalanuvchi&quot;
عقدت؛	o&#39;tdi;
أحمر	qizil
فأر	sichqon
خطوة خطوة	asta-sekin
على &amp; quot؛ حقيقية ومثل؛	&quot;real&quot;
الوديان،	daralarda,
html>	stephen@orchid.UCSC.EDU
الحارة،	samimiy,
فيما بعد	o&#39;tib
(دوستويفسكي)	(Dostoevskiy)
محدود	cheklangan,
فتح	ochiq
ناعم	yumshoq
نوم	uyqu
وعي	xabardorligini
مساعدة	Yordamingiz
(أي	(ya&#39;ni
1.00)	1.00)
التزلج	kaykay
قزم.	mitti;
بونو،	Bono,
في هذا المجال،	sohasida,
نشط	faol,
واندررز	Wanderers
(سلبي	(salbiy
حصلت	oldim
تلقينا	oldik
وطن؛ &amp; GT؛ &amp; GT؛	&gt;&gt;&gt;
كامل	to&#39;liq
سلبية!	salbiy!
بيان	bayonotida
قبل	oldin
&#39;I	«Men
دليل	isbot
يطرح.	tug&#39;diradi.
جبل	tog
جناح	qanoti
أصلا	dastlab
-----------------	-----------------
الزائفة المذهب	psevdo-ta&#39;limotning
10:34	10:34
تم تحويله إلى	aylanadi
تقارير	hisobotlarni
اكتمال	tugatish
فعل	qilyapsiz,
دفعة	turtki
كاسيني	Cassini
أشعل	charog&#39;on
مخصص ل	bag&#39;ishlanib
ونحن،	Biz,
سقف	tom
الذي	kishisiga
ومنذ ذلك الحين،	beri,
الخصوصية ومثل،،	maxfiylik&quot;,
نوري	nuri
ضيق	tor
الناريدة واحدة من حوريات البحر	nereid
رجل	Erkak
المواطنة،	fuqaroligini
المتاحة.	mavjud.
نقطة	ochko
(النسخة	(Version
وطن.	&gt;
صلة	aloqasi
حسن السمعة	e&#39;tiborli
الأسئلة:	Savollar:
شخص ما	kimgadir
(هنري	(Genri
10 ومثل؛	10&quot;
سطحي	Yuzasining
تذكر	eslang
html>	schauf@iastate.edu
مكافحة الاحتكار	anti-ishonch
أشهر	oylarda
وعود	va&#39;dalar
عالم	Dunyo
فواصل	bo&#39;luvchi
ومع ذلك،	Shunga
غير	bo&#39;lgani
4/26/93	4/26/93
100K	100K
أعتقد	o&#39;ylayman
المستكشف &amp; GT؛	Explorer&gt;
وطن؛ &amp; GT؛ &amp; GT؛ &amp; GT؛	&gt;&gt;&gt;&gt;
الحرم الجامعي)	Campus)
متعلق بكوكب الزهرة	Venusian
سقف	Tom
الوجود.	etilmoqda.
حظ	Omad
وجود	mavjudligini
لى)	Lei)
يسوع المسيح	Masih
كذبة	yolg&#39;on
خطير	xavfli
مقارنات؟	taqqoslashlar?
2	2-ning
شكل	shaklda
100	100,
السكن،	yashaydi,
مشاركة	Oxirgi
وضع.	tushirildi.
1000	1000
الحفظ	Saqlash
للترافع	bahslasha
الكتاب،	kitob,
الناس	qavmiga
أداة	vositasi
دير	der
ألفا	Alpha
أنا لا أحب.	yoqtirmayman.
أنبوب	kolba
منزل	uyda
في رأيي،	Menimcha,
واد بلغة الشعر	dale
)	dan)
من	dan,
وظائف	funksiyalarini
نصيحة	Maslahat
مسروق	bila
html>	&lt;31MAR199321091163@juliet.caltech.edu
أن	deb
)	bo&#39;lgan)
دخل	kirdi
&quot;نادي	»klubi
.	bo&#39;lgan.
زواج	nikoh
العلامة &amp; lt؛ p00261@psilink.com&amp;gt.	&lt;p00261@psilink.com&gt;
وهذا هو،	bo&#39;lgan,
لويس	Luis
لا &#39;	bo&#39;lmaydi»,
أدنى	quyi
حق	huquqini
حطم	çökerttiğini
المنحرفين	Deviants
الشخصية	shaxsiy
XRaiseWindow	XRaiseWindow
7.3	7,3
يبدو.	tuyulardi.
مدارات	orbitalarida
؟	bo&#39;lgan?
إحصائيات	e&#39;lonlar
التفضيلات.	afzal.
اختصارات	yorliq
هذا	ushbu
مثلي الجنس	gomoseksual
الولايات المتحدة الأمريكية	USA
ممثل.	vakili.
أمل	Umid
ممثل،	vakili,
لم أكن	bermadi
15/11	11-15
خلف	ortda
يمني	Yamanda
واحدة من	Biri
فائض	ortiq
نائم	uxlab
الإسراف	isrof
دفع	to&#39;lov
متناقض	ziddiyatli
قرية	qishloq
امتداد	esnetmeyi
النجوم	yulduzlar
تقترب	yaqinlashib,
الشهب	meteoritlar
Gilkes،	gilkey,
المذنبات	Kometalar
الدكتور	Dr.
النيكل والحديد	nikel-temir
بروتيوس	protey
رخيص	arzon
إذا	bo&#39;lsa,
على &amp; quot؛ مزدوج	&quot;dual
العلامة &amp; lt؛ تعريف	&lt;belgilab
موجه	xohishi
LaStrange	LaStrange
إذا)	bo&#39;lsa)
شاب	yigit
////	////
الافتراضي	default
بسرعة	tez
ومشتقاته	sanab
html>	henry@zoo.toronto.edu
غاضب	g&#39;azablangan
وقفت.	turdi.
Lindroos	Lindroos
5 دقائق	5-daqiqa
مجرم	jinoyatchi
لو؟	bo&#39;lsa?
جول وحدة طاقة	joule
جزيئات	molekulalar
وGT.	barcha&gt;
3511	3511,
الشعر ومثل؛	sochli&quot;
DOS؛	DOS;
ناب	Fang
1024	1024
DOS6	DOS6
دين	din
WINDOWS.	WINDOWS;
تقليدي	an&#39;anaviy
بقايا	qoladi
دير	dir
دعم	Support
هاه؟	Huh?
فيني	Finney
إذا:	bo&#39;lsa:
قرأ	withs
باحث نظري ضليع	nazariyotchi
شخص	shaxsni
شكل	shaklga
الأجهزة	asboblar
ومثل؛	qiluvchi&quot;
(عالية	(yuqori
النيازك	Meteoritlarning
بطارية	batareya
هوى)	Hui)
هام	mazmunli
المجال:	domen:
تركيز	Lucifer,
سخرية	masxara
واسع	Keng
لا	olmaydi
دخل	kirib
مسؤولون	mulozimlari
نتائج	natijasi
من يدري؟	biladi?
حقيقي	haqiqiy
دوس	Dos
تشارك	shug&#39;ullangan
استعداد	tayyor
كتلة	massasi
من يدري،	biladi,
كتاب	Kitob
ندب	chandiq
مدفون	dafn
إذا كنت؟	ekansiz?
سنوات	yillar,
سنفعل.	chiqamiz.
لا &amp; GT؛	olmaydi&gt;
الجلد	terisini
وقف &amp; GT؛	to&#39;xtatish&gt;
تبحث.	qidiraman.
البلاستيك	plastik
جون.	Jon.
ثم،	O&#39;shandan
رسائل	xabarlarni
سنوي	yillik
المشكلة	muammoni
فهم	anglashuv
ما	narsaga
اقتصادي	Iqtisodiy
neccities	neccities
نيزك	Meteoroid
الألتميتر	altimeter
العنصر.	topgan;
نفسي	o&#39;zimni
OFF	OFF
على &amp; quot؛ تحميل على &amp; quot؛؟	&quot;Qayta-bildirdi?&quot;
فائدة	Utility
ثالث	Uchinchi
إنشاءات	qurilish
ورقة	qog&#39;oz
وضع	qo&#39;yishdi
،	topgan,
الشهب	göktaşları
ثلاثي	Uch-Way
.	topgan.
تداول	kotirovka
الناس	kishilar,
(بعض	(ba&#39;zi
جاموس	Buffalo
تحقيق	tadqiq
خلال	chog&#39;ida
تريليون	trillion
*************************	*************************
،	doirasida,
(رون	(Ron
مجلة	Magazine
[PED]	[PED]
وGT.	biri,&gt;
اضطهاد	ta&#39;qib
(ستيف	(Steve
ازهر،	Bloom,
المعلمين الزائفة	Psevdo-o&#39;qituvchi
متطور	chiqilgan
فجر	tong
لا	hech
الضوضاء.	shovqin.
(توبياس	(Tobias
المرضى	bemorlar
نظرت.	qaradim.
(كيرك	(Kirk
جديد	Yangi
واضح	aniq,
لذلك،	shuning
تخصيص	ajratilgan,
في كل شيء،	butun,
GOURMET	GOURMET
لا	Yo&#39;q
لي	​​Lee
عيني	rem
ضد	qarshi
TIFF	TIFF,
كتب: &amp; GT؛	yozadi:&gt;
دزينة	o&#39;ndan
-428-0800	-428-0800
فهرس	KATALOG
في وقت واحد.	uzata.
أهداف	maqsadlarini
(KJV)	(O&#39;ZMK)
جون	John
سبنسر)	Spencer)
رواد الفضاء	kosmonavtlar
تصميم]	dizayn]
الدين،	e&#39;tiqod,
ديف	Dave
الموتى	o&#39;limdan
أنت	sizga
الأوروبيون	yevropaliklardan
للعثور على	topa
جنوب	janubida
على قيد الحياة،	tirilmaydi,
المسيحيين	xristianlar
زلزال	zilzila
-486-9975	-486-9975
نسأل.	so&#39;rang.
عروض	takliflar
ثانيا،	Ikkinchidan,
المعتقد.	e&#39;tiqod.
حسنا	OK,
ولم يقل؟	demadi?
العرب	arablarni
قسم	boshqarmasi
القيود	cheklashlar
OK.	OK.
عامل	omili,
الامبير	AMPS
(أركين	(Erkin
الروح،	jon,
على &amp; quot؛ الصعب ومثل؛	&quot;qiyin&quot;
نظام	tizimining
kabi- *	kabi-*
معدات	texnikasi
درجة الحرارة	harorat
كما	bo&#39;lib
(إخوانه	(Bro
حول	atrofidagi
html>	rind@enterprise.bih.harvard.edu
بوري &amp; GT؛	Bure,&gt;
وطن؛ &amp; GT؛ &amp; GT؛	...&gt;&gt;&gt;
متوسط	muhit
طبقات	qatlamlari
آلان	Alan
&#39;	foydalanish»,
دعا.	deyiladi.
مهم	muhim
على العكس من ذلك،	aksincha,
خلافا &amp; GT؛	o&#39;laroq&gt;
قياس.	o&#39;lchanadi.
5X9 &amp; GT؛ &amp; GT؛	5X9&gt;&gt;
ل	axir
يتبع	ergashdilar
لا	Hech
كما الساخنة	as-issiq
نظم &amp; GT؛	Systems&gt;
جديد	New
على &amp; quot؛ ^^^^^^	&quot;^^^^^^»
معقول	oqilona
بطاقات &amp; GT؛	karta,&gt;
ينتهي	tugaydi
أخذ	olmoq
على &amp; quot؛ مثليون جنسيا	&quot;gomoseksual
جلبت	keltirdik
رفض	rad
مصدر	manba
على &amp; quot؛ دورة	&quot;aylanish
تحول	Switch
^^^^^^^^^^^^^^^^^^^^^^^^^^^	^^^^^^^^^^^^^^^^^^^^^^^^^^^
كيف	qanday
:	bo&#39;ldi:
جزئي	qisman
؛	bo&#39;ldi;
Leifson)	Leifson)
مستقبل	kelajakda
تماما	butunlay
الإنسان ويتكون طاقمها	Inson-Mürettebatlı
.	bo&#39;ldi.
اليهودية و GT.	yahudiy&gt;
وافق	tasdiqlangan
،	bo&#39;ldi,
زميل	Yo&#39;ldoshlar
خصائص	xususiyatlarini
ممكن	iloji
الكتاب	Kitobni
كلية	fakulteti
عادة،	Odatda,
التالي	keyingi
مدمج	rom
النجوم	yulduzlardan
إعطاء	berib,
باب	eshik
مهيمن	dominant
ورشة عمل	Dastgoh
شمس	Quyosh
على السطح	yuzasida
التعبير	ifoda
سوف	Will
أرقام وGT.	raqamlari&gt;
دور	rol
المغلفة ومثل؛	qoplangan&quot;
وجود	huzurida
WNCI	WNCI
قاس	qattiqqo&#39;l
عملة	tanga
شمس	​​quyosh
الأطراف	partiyalar
لا تخلط	aralashtirmang
(22،23	(22,238
السطح	yuzasiga
الأعمال	asarlar
دير.	dir.
رأيك؟	demoqchimisiz?
العمليات	jarayonlar
ثانية	Yana
الأوروبيون	Ovropada
SKIING	SKIING
شخص	shaxs
.	taqdim.
العلامة &amp; lt؛ mvanheyn@cs.indiana.edu&amp;gt.	&lt;mvanheyn@cs.indiana.edu&gt;
سواء	Whethe
يزارد)	Wizzard)
أنت	sizlarning
توازن	muvozanatga
يعلم،	o&#39;rgatadi,
التي	Qaysi
UNIX	UNIX
جويل	Joel
سنوات	yillar
على &amp; quot؛ سر ومثل؛	&quot;sirlarini&quot;
html>	nagle@netcom.com
أرض	Ground
أسطوانة	disk
بداية	boshlanish
المستكشف	Explorer
ملتوياتي	spirochetal
لبناء ومثل؛؟	qurishga?&quot;
NiCad	NiCad
إذا	bo&#39;lsa
أوتاوا،	Ottava,
عرض	namoyon
حزم	paketlar
المدينة الفاضلة	Utopia
أقل من	quyida
بمناسبة	munosabati
أنت	sizni
palastenians	palastenians
فينوس	Venera
ulysses.att..com	ulysses.att..com
أوروبا	Europa,
خوارزمية	algoritm
(غير شرعي	(Noqonuniy
على &amp; quot؛ &amp; SO مثل؛	&quot;SO&quot;
فرنسا	Frantsiya
مغطى	qoplangan
الحقول	bolgan
90٪ &amp; مثل؛	90%&quot;
العلامة &amp; lt؛ 1qkoel$5fr@horus.ap.mchp.sni.de&amp;gt.	&lt;1qkoel$5fr@horus.ap.mchp.sni.de&gt;
هو الدليل؟	isbotidir?
كولومبيا،	Columbia,
***************	***************
تحقق	nazorat
دخل	kirib,
جزء)	qismi)
سابق	avvalgi
يكتب &amp; GT؛:	yozadi&gt;:
تحول يوم	yoqilganda
الأسئلة:	savolim:
جزء	qismi,
على &amp; quot؛ والأرض والقمر	&quot;Yer-Moon
سحق	ezib
شاشة	ekran
مرئي	ko&#39;rinadigan
كسب.	qozonmoqda.
على &amp; quot؛	&quot;Yangi
على &amp; quot؛ &amp; GT؛	&quot;oldin&gt;
الزملاء	hamkasblari
،	o&#39;tish,
تثبيت	o&#39;rnatilgan
يرضى	qondiradi
محول	adapter
البقاء على قيد الحياة.	omon.
العلوم	fanlari
1980	1980,
-rigth	-rigth
مشهور	mashhur
Bzzt!	Bzzt!
حق	huquqi
مصير!	taqdir!
تيمونس)	Timmons)
تيمونس	Timmons,
مرئي	Visual
يقولون؛	derlar;
أنا لا أريد.	istamayman.
11/05،	5-11,
أنا لا أريد	istamayman,
التالي	quyidagi
ستيفن	Stiven
ذيول	dumlari
html>	hrubin@pop.stat.purdue.edu
كاف	etarli
كثير	Ko&#39;p
الحواس	hislar
صلاح)	Salah)
مبادئ	tamoyillari
حلبة	arenasi
اليابان	Yaponiya
الكاميرا.	suratga.
(يونغ	(Leong
html>	martyj@mrcnext.cso.uiuc.edu
نظام	sistemasidagi
.	chiqilgan.
الكنيسة	jamoatini
المخاريط.	konusning.
للذهاب	o&#39;tishi
أبناء	o&#39;g&#39;illari
العلامة &amp; lt؛ 1qnb9tINN7ff@rave.larc.nasa.gov&amp;gt.	&lt;1qnb9tINN7ff@rave.larc.nasa.gov&gt;
قضايا	masalalari
accuire	accuire
مريح	ergonomik
يناير	Yanvar
97.9	97,9
GSX-145	GSX-145
آذى	ozor
الآلاف	minglab
الملاحظات	Kuzatuvlar
قانوني	qonuniy
المحيطات،	okeanlar,
COM1	COM1
والدي	Otamning
شرطة	policha
بركاني	vulkanlar
البيانات	bayonotlar
أيلول	sentyabr,
مركز	markazi,
اليوم	Bugungi
وGT.	maqsadida&gt;
حر	ozod
؟ ومثل؛	yordam?&quot;
على &amp; quot؛ |	&quot;|
انفجارات	portlashlari
RESP.	RESP.
Mives	Mives
سيطرة	Control
الأزواج	erlar
تجارة	savdo
html>	cfaehl@vesta.unm.edu
تلميح	ishora
US &amp; مثل؛	AQSh&quot;
حالة	holatda
الملك.	shohi;
أفكار	g&#39;oyalar
بادئة معناها معي	Enteritis
مركزي	markaziy
html>	brian@gab.unt.edu
للبيع	sotuvga
مكان	joyi
الوديان	vodiylari
الازدهار.	gullab-yashnagan.
كنوكس	Canucks
(سام	(Sam
الوثائق	hujjatlarida
مجموعة	birikish
اللوحة الأم	Anakart
المعيشة	yashayotgan
دولي	xalqaro
للتمييز	ajrata
أحب	sevib
ليفرمور،	Livermore,
العلامة &amp; lt؛ الإلحاد	&lt;ateizm
Redelfs)	Redelfs)
html>	nstassen@magnus.acs.ohio-state.edu
لتسليط الضوء على	vitr
للاستماع	eshitishni
ركض	yugurib
الله.	xudosi.
وئام	barkamol
افترض عليهم	buyurish
تلت ذلك.	ergashdilar.
الله؛	xudosi;
على &amp; quot؛	&quot;
إرادة	irodasini
الكثير	uchastkalar
له	undan
وظيفة	funktsiya
sun4nl	sun4nl
بنيت.	qurilgan.
المحيطات	okeanlarning
بنيت،	qurilgan,
القيم	qadriyatlar
سرا	yashirin
شيوخ،	oqsoqollar,
عام &amp; gt؛	umumiy&gt;
ألصق به تهمة ما	imputs
HISTORY:	TARIX:
موافقة	tasdiq
حب	sevgi
الإلكترونيات	Electronics
حرق	yondirib
شحنة	etaklaydigan
فكرة	fikrini
رؤية	ko&#39;rmayapman,
لا أستطيع أن أرى.	ko&#39;rmayapman.
القتل،	o&#39;ldirilishi,
هذا وGT.	Ushbu&gt;
تعمل بالطاقة	Powered
رسمت	bo&#39;yalgan
نشاط	faolligini
الكتاب المقدس	Kitobda
البلد	mamlakatni
(أو	(yoki
وGT.	ta&#39;minlash&gt;
علم الفلك	Astronomiya
للبيع	sotuvda
رقاقة	chip
الخطايا،	gunohlari
دمل	qaynaydi,
krater	kraterlardan
العمل السريع	tez-harakat
أولئك الذين	keltirganlar,
ثعبان،	ilon,
==========	==========
(كارل	(Carl
(DES	(DES
على &amp; quot؛	&quot;edi
القانون،	qonuni,
كهرضوئي كهربائي ضوئي	fotoelektr
قبل	OLDIN
واغنر،	Wagner,
تدرس	o&#39;rgatgan
السهول ومثل؛)	Plains&quot;)
الراكون)	Coons)
غير مبال	befarq
مقالة	maqolada
في القرن ال17،	17-asrda,
أن	ekan
كارس &amp; GT؛	-Karl&gt;
سلاسل،	zanjirlar,
ك	sizning
أعماق	qa&#39;riga
(Ncsc8!	(ncsc8!
بصري	Optik
وجوه،	ob&#39;ekt,
html>	fang@en.ecn.purdue.edu
العذرية،	bokiralik,
على &amp; quot؛ لدينا	&quot;bizning
شارما	Sharma
(اليابان	(Yaponiya
الارتفاع.	tiriladi.
وون	yutib
ينتظر	kutadi
هل هناك أي؟	mavjudmi?
يبدو	paydo
قيمة	arziydi
زخرفة	bezatish
شقة.	doira.
المستخدم	foydalanuvchi
الجيران	qo&#39;shnilar
عمل طاحونة &amp; GT؛	ish-of--tegirmon&gt;
على &amp; quot؛ مفتاح	&quot;Klaviatura
المؤامرة]	fitna]
الوثائق	hujjatlar
بحث	tadqiqotlar
الدائرة،	pallasida
حجر	tosh
شرح.	izohlash.
إله	Xudosi
spec&#39;d	spec&#39;d
دبوس	pimi
تلبية &amp; GT؛	kutib&gt;
كل شىء	narsani
سكن	yashashi
انتشرت	yoyib
كاميرا	kamera
المخنثين	biseksual
comp.sys.ibm.pc.hardware:	comp.sys.ibm.pc.hardware:
خط	line
وGT؛ &amp; GT؛	o&#39;yin,&gt;&gt;
يريد	istaganini
خلاقة،	ijodimiz,
مكانة	turgan
اتصال	aloqada
لنا	Bizning
حفظ	najot
عام	yil,
والسبب وGT.	negadir&gt;
الموالية للبندقية	pro-kun
(بريان	(Bryan
HAWK	HAWK
دواء	tibbiyot
(كيفن	(Kevin
الآباء	ota-deb
شكر	minnatdorchilik
SCSI	SCSI
الطلاب،	talabalar,
كان	bo&#39;ldi
تصميم	dizayni
هل ترغب في ذلك؟	xohlaysizmi?
المخلص	Xaloskorimiz
داريل	Darryl
إفشاء	oshkor
نيابة عن وGT.	nomidan&gt;
الأطباء	shifokorlarga
قام من	tirildi
قذيفة	qobig&#39;i
الجهاز	qurilmaning
كارلوس	Karlos
الأطباء	shifokorlari,
المناطق	viloyatlariga
عام	yili
السيانيد،	siyanür
يعلم ومثل؛	o&#39;rgatadi.&quot;
قليلا	biroz
العلامة &amp; lt؛ العلامة &amp; lt؛	&lt;&lt;
===	===
اصطدام	to&#39;qnashuvning
شخص ما	birov
توماس	Thomas
لايم	lyme
والعقل مثل؛	parvo&quot;
عرقي	etnik
عاد.	qaytdi.
ل	biror
RS-6903	RS-6903
هتاف	Cheers
GENIE:	GENIE:
الطرق	yo&#39;llar
ترجمة	tarjima
مكان	joy,
82٪	82%,
Potvin	Potvin,
Gosh..I	Gosh..I
html>	J.David.W.Reeves@dartmouth.edu
تلسكوب	teleskop
فاسد	buzuq
رائد	Pioneer
html>	aep@world.std.com
AIR	HAVO
وصفه.	buyuriladi.
درس	o&#39;rganib
(1430	(1430
الجوال	Ranger,
حادث	hodisadan
مقعد	zaxiradan
كندا	Kanadaliklar
على &amp; quot؛	&quot;eng
الملحدون	agnostik
&#39;A&#39;	«a»
بنتز	Bentz
رجل	odam
السهول	tekisliklarni
نشرت	chop
التفسير	tafsir
العلامة &amp; lt؛	&lt;
لوحظ.	kuzatildi.
جزء	bo&#39;lak
حلف شمال الاطلسي	natonal
نظيف	toza
سوزوكي	Suzuki
حكم	qoidani
سبنسر	Spencer
أراد	bo&#39;lar
عروض	Takliflar
جلب.	keltirur.
أيد	qo&#39;llab-quvvatlanadigan,
بلانيتيا	Planitia
أيد)	qo&#39;llab-quvvatlanadigan)
تنفيذي	ijro
حدود	chegaralarini
عندما،	yetganida,
!! على &amp; quot؛	!!&quot;
ولا	Nor
أشياء	narsalar
ومثل؛ &amp; GT؛	oshiradi&quot;&gt;
سؤال	savol
وينسلو	Winslow,
يغلي،	qaynatiladi,
16804	16804
خير	Yaxshi
الجسم	tanasini
مثالي	Perfect
مهجور	xilvat
الامبير	AMPS,
وصفه.	tasvirlangan.
متعلق بكوكب الزهرة	​​Venusian
في المئة	foizini
(JPS)	(JPS)
كيف،	qanday,
تتكون من	topgan
نجاح باهر!	QOYIL!
تصور	g&#39;oya
محاولة	sinash
مراقبة	monitoring
الكثير!	uchastkalar!
مغطاة.	qoplangan.
الجمهور	jamoatchilik
_in	_in
نفاية	chiqindilarini
الإدارة:	boshqaruvidan:
صعوبة	qiyinchilik
من	Of,
تقسيم	bo&#39;linish
الجوانب	jihatlari
أنت	siz
(______________________________________)	(______________________________________)
التعدين والفتيات	Tog&#39;-qizlar
تراث	meros
في فصل الصيف،	yozda,
الذي	bo&#39;lganlarga,
نساء	ayollar
PIN	PIN
خلال	ustida
10/82	10/82
هضبة	platosining
وGT،،	qilish&gt;,
الغبار،	tuproqdan
وقال انه يتطلع في	qaradi
تميز	ajratadigan
اليورانيوم،	Uran,
أظهر	ko&#39;rsatdi
وGT.	narsa&gt;
حقائق	Dalillar
html>	ekdfc@ttacs1.ttu.edu
هذا	shu
عشاق الكتب	Kitob-sevishganlar
(10،000	(10000
سر	sir
أحواض	havzalari
الدول	mamlakatlari
ثقافة	madaniyat
4RUNNER &amp; GT؛	4Runner&gt;
أوه،	Oh,
لحل	yechishga
آلة	mashina
الليلة:	kechishlari-uni:
قادر	qodir
هل وGT.	undamayaptimikin&gt;
عميق	chuqur
أقمار	yo&#39;ldoshlari
الآن،	Endi,
الشقوق	yoriqlar
خسر.	yo&#39;qotgan.
إنجلترا	Angliya
الهاتف:	Telefon:
كاليستو	Callisto
عصبة	ligada
رفت	payini
في اشارة الى	tutayotgan
الفضاء	Space
6/91	6/91
مجموعة	guruh
كندا	Canada,
يمني	Yaman
على	ustiga
(اليهود)	(yahudiylar)
المسيحية،	nasroniylik,
الأرض مون سون	yer-oy-quyosh
00ECGILLESPIE	00ECGILLESPIE
المتعصبون	aqidaparastlar
أوراق	yaproqlar
أعرف.	bilurlar.
-14	-14
العالم	dunyodagi
الأشرطة ومثل؛	keltirgani&quot;.
اهتمام	diqqat
اختبار	sinov,
Scharfy)	Scharfy)
رياح	shamoli
جنس	sex
كل	barcha
نسمع.	eshitamiz.
مثليه	lezbiyen
وطن.	Barcha&gt;
2230	2230
تقليد	taqlid
PMS	PMS
أظهرت	ko&#39;rsatildi
الصخور	qoyalar
على &amp; quot؛ المرخصة	&quot;litsenziyaga
الخدمات	Services
دمل	qaynatiladi
لم أكن أرى.	ko&#39;rmadim.
(الحق	(o&#39;ng
وGT.	buyon&gt;
(الكمبيوتر	(Computer
التشفير	kripto
لم أكن أرى،	ko&#39;rmadim,
ورمى به في الطويلة	uzoq-uloqtirdi
Franjione	Franjione
HOMOSEXUAL-	HOMOSEXUAL-
&#39;حقائق&#39;	«dalillar»
كوفمان)	Kaufman)
Telecope	Telecope
معا	birga
على &amp; quot؛ &amp; مثل؛	&quot;qabul&quot;
من حيث المبدأ،	me&#39;yor
قليل،	necha,
عزو	surilsa,
إدوين	Edwin
ما وGT.	nima&gt;
أنت	sen
فيضان	sel
ككل	butun
الألوان	rangdagi
خط	chiziq
اصطدم.	to&#39;qnashib.
ميلا في الساعة)	milya),
أن	ekanligini,
على الأقل	bo&#39;lmaganda
إذا	agar
الأشخاص	shaxslarni
ضمنية،	shama,
AMI	àmì
أجنبي	chet
منتفخة،	shishgan,
السجن	qamoqda
Ludwick ومثل؛	Ludwick&quot;
جذور	ildizi
مجوهرات و GT.	jamoa&gt;
شيء	nimadir
ومثل؛	qiling&quot;
كنتاكي	Kentukki
المسيحيين	masihiylar
معرفة	bilimga
(أندرو	(Andrew
ضمنية.	shama;
(3010	(3,010
مزدوج	Dual
(-184	(-184
ضوئية	fotosel
الأمينية	amino
حصاد	hosil
أين)	qaerda)
نظرة	sol
وطن.	Deb&gt;
دليل	dalil,
مكان	joyida
المستحقة	to&#39;lanadigan
مرتب زمنيا	xronologik
طائرة	tekisligiga
ترخيص	litsenziya
كلارك	Klark
---	---
نقي	sof
استعمال	foydalaning
قول	aytish
ريان	Ryan
الناس	kishilar
حيث	qaerda,
(على &amp; quot؛ الذهب	(&quot;Oltin
هوفمان	Hoffman
موضوع	themon
أعتقد	menimcha
الجنس)	sex)
كوري	korean,
.	qilgan.
،	qilgan,
وGT.	bo&#39;yicha&gt;
اثنان	Ikki
الأساسية وGT.	majbur&gt;
التسوق	Xarid
مئوية	Selsiy
؛	qilgan;
سانتا	Santa
الحجم:	Hajmi:
لفهم	tushunishga
كتيبات	qo&#39;llanmalar
غروب	botganidan
على &amp; quot؛ لايم	&quot;Lyme
مقطع شعري	Stanza
مجرم	jinoiy
سلوك	axloq
شرعية	êonuniyligi
تجاري	tijorat
الدراسة،	o&#39;rganish,
و&amp; GT؛	a&gt;
مستوى	Daraja
الملون.	ligini.
المرضى	bemorlarning
تنتج	chiqaradi
الشائعات	mish-mishlarni
Multiprobe	Multiprobe
--clh]	--clh]
اليسار	chap
العلامة &amp; lt؛ C5r60r	&lt;C5r60r
COM &amp; GT؛	MAQOMOTI&gt;
___	___
الشائعات	mish-mishlarga
تطبيقات	dasturlar
نفسك	o&#39;zingizni
حركة	harakatini
لم يحدث ذلك.	qilmaydi.
لم يحدث ذلك،	qilmaydi,
بدلا من ذلك،	muqobil,
دولي	Xalqaro
1993	1993,
فضلا عن	qatorda
القرص المرن	floppi
سابق لأوانه	bevaqt
الدوري،	Ligasi-da,
نجوم ومثل؛	Stars&quot;
ألتيما	Altimas
الأعمال	hujjatlariga
على النحو التالي.	bering.
المبيضات	Candida
شكر	Thanks
قرأ	bering,
ثيوس	Theos
كل	hammangiz
الشحن	zaryadlash
على &amp; quot؛ &amp; مثل؛	&quot;Ular&quot;
cryptoanalysis	cryptoanalysis
على &amp; quot؛ جيجر	&quot;Geiger
نظام	tizimidagi
إشارة	ko&#39;rsatilib
شركة	Corp.
تمشيط	supurib,
الحزب الديمقراطي الياباني	ligalari
قراءة!	bering!
html>	adam@das.harvard.edu
ويندي	radioed
وليام	William
الغريب.	qiziquvchan.
اضطرب	pishirib
اللوحة الأم	Motherboard
كوكب المشتري	Yupiterning
قضايا	muammolar
لوريا)	Lauria)
حقيقي	real
واحدة-	bir-biriga
التحديق	qotib
المبررات:	dalil:
راقب	kuzatib
حيازة	egalik
عناوين مختارة	articals
الموقع	ayting
html>	daviss@sweetpea.jsc.nasa.gov
و	qilinib,
عرض	ko&#39;rsatib
استخدام	foydalanish
من	kelgan
كشف	nozil
19947	19947
حساس	nozik
FORSALE	forsale
ألتيما	Altima,
رغم أن	Biroq
معمودية &amp; GT؛	cho&#39;mish&gt;
^^^^^	^^^^^
جورج تاون،	Jorjtaun,
-scale	ko&#39;lamli
وحدات التحكم	Kontrollerlar
حزم ومثل؛	paketlar&quot;
Gen3:	Gen3:
&#39;S	&#39;s
PCX	PCX
الأطباء	shifokorlar,
أسماء	nomlari
(الهواء)	(havo)
فرق	jamoalar,
Floppy..BURN	Floppy..BURN
فاجأ.	hayron.
قداس	xotirlash
ضمان	kafolat
خط الاستواء	ekvator
الوصايا	xohlagan
المعزل ومثل؛	isolator&quot;
خارج	Out
أفضل	yaxshiroqdir
وGT؛ &amp; GT؛	oshiriladi&gt;&gt;
هناك	There
الانتهاء.	yakunlandi.
الجلوس	o&#39;tirib
قش	strawman
27611@athos.rutgers.edu	27611@athos.rutgers.edu,
قتل	halok
العالم	Dunyodagi
96.5	96,5
html>	folta@zen.holonet.net
كولورادو	Kolorado
قضية	masala»
سكيلتون	Skelton
ساق	oyoq
المفصل	hamkorlikdagi
تلقي	olishingiz
فرق	jamoalari
-oOOO	-oOOO
html>	astein@nysernet.org
صفقة	shug&#39;ullanish
مستحق	loyiq,
عدم وجود	etishmasligi
POWDER	KUKUNI
،	qildi,
.	qildi.
الله	xudo
^^^^^^^^^^^^^^^^^^^^^^^^^^^^^^^^^^^^^^^^^^^^^	^^^^^^^^^^^^^^^^^^^^^^^^^^^^^^^^^^^^^^^^^^^^^
القيامة	tirilishiga
ابن	O&#39;g&#39;li
جانب	tomoniga
أشياء	narsalardan
html>	sharma@monet.vill.edu
فوضى	dağınıklığı
Kolodny	Kolodny
(ديك	(Dick
عصابة	halqa
الجليل	jalilalik
BMP،	BMP,
html>	sguerke@ravel.udel.edu
الافتراضي	ko&#39;rsatuv
مرآة	oyna
تصحيح	tuzatilgan
OTOH،	OTOH,
أوليفيرا	Oliveira
نيابة عن	nomidan
المجوفة	chuqurliklarda
تحول	aylantirilayotgan
GMT	GMT,
html>	kfrank@magnus.acs.ohio-state.edu
فريق	terma
البعثات	ekspeditsiyalar
بين	orasida
منذ	buyon
9600	9600
حياة	hayotda
الحرارية	termo
السؤال،	savol,
الآلي	avtomatlashtirilgan
تفتيش	tekshirish
رسالة	xabarni
نفقة	hisobiga,
html>	hans@xelion.nl
صفة مميزة	xarakterli
دعم	qo&#39;llab-quvvatlash
البعض	boshqa,
تداعيات	Fallout
المستخدم	Foydalanuvchi
حواف	hoshiyali
لدي	qildim
الشرط،	holatini,
حجرة النوم	yotoqxona
الذي	kimsadan
تاريخ	tarixini
SMARTDRV	SMARTDRV
وليامز،	Williams,
لينة الكلام	yumshoq-og&#39;zaki
ابن	O&#39;g&#39;il
بحر	dengiz
جانب	tomonida
الفئات	kategoriyalari
تقليد	odati
الوسائل	ma&#39;noni
في المرتبة الثانية	soniya
المشكلة:	masala:
Jinnimisiz_؟	Jinnimisiz_?
على &amp; quot؛ الهدف	&quot;maqsad
عسكري	harbiy
على &amp; quot؛ إثبات الرسائل النصية ومثل؛	&quot;dalil-manifatura&quot;
محكمة	sud
الدوري	ligasi
بين	orasiga
خطة	reja
فرانك)	Frank)
مسرع	Accelerator
ماء	suv
الماضي	o&#39;tgan
تستخدم	Ishlatilgan
نوع من	turdagi
اتفاق	Accord
أول	dastlabki
قوة	kuch
منطقي	mantiqiy
من أجل	maqsadida
html>	holsend@mhd.moorhead.msus.edu
تعريف	belgilang
مصنوع	yasalgan
السماء.	osmon.
فوز	g&#39;alabaga
كيبهيرس	cyphers
(روبرت	(Robert
ومثل؛، الشاهد	shahodat&quot;,
dookie	dookie
مشاركة	almashish
خداع	ketkazguvchi
،	oshirmoq,
الذي	kimning
FORSALE	FORSALE
الخ،	hokazo,
كاليستو	Callisto,
KALDILDI	Kaldis,
مغادرة	ketmaslik
قسم	bo&#39;limida
الصحافة الديمقراطي	Press-demokrat,
إجابة	Javob
ضرب	urdi
الخ)	hokazo)
جدول	grafigini
مقالة	maqolada,
عظيم	buyuk
الأقمار الصناعية،	yo&#39;ldosh,
فتحة	Slot
تغيير	o&#39;zgarishi
===========================================	===========================================
WP51	WP51
هل؟	bordingizlar?
رياح	shamol
netters	fırlatıcısı
القيامة	tirilishini
القمر	oyga
العلامة &amp; lt؛ 1993Apr22.153959.12328@ucsu.Colorado.EDU&amp;gt.	&lt;1993Apr22.153959.12328@ucsu.Colorado.EDU&gt;
اليك	sendan
10000	10000
تم العثور عليها.	topilmadi.
تغيير	o&#39;zgartirilgan
(125	(125
معنى	ma&#39;nosi
الفأس	bolta
المعترف بها	tan
على سبيل المثال).	aytaylik).
)	qadar)
(JPL)	(JPL)
الرتق	Darn
لذلك،	qadar,
ظلام	Dark
(1500	(1500
خيالي	soxta
ضوء	engil
تنظيف	tozalash
على سبيل المثال،	Masalan
سلوك	xulq
خلق	yaratgan
السابق	Avvalgilar
السماوات	osmonlaru
أيضا	shuningdek
أم	Ona
لورانس	Lawrence
وGT.	faqat&gt;
واحد	One
حر	bepul
أنا لا أعرف،	bilmayman,
لا أعرف.	bilmayman.
الوفاض	uzatdi
عائلة	oila
لمعرفة	bilmoqchi
ديمقراطي	demokratik
ظهر السفينة	kemaning
megatest.com &amp; GT؛	megatest.com&gt;
رؤية	qarang
هجوم	hujum
التأمين.	sug&#39;urta.
متزايد	o&#39;sayotgan
العلامة &amp; lt؛ C5DxBs.5ov@panix.com&amp;gt.	&lt;C5DxBs.5ov@panix.com&gt;
****	****
(12V	(12v
أخيرا	oxir-oqibat
شخص ما	Kimdir
liscenced	liscenced
العلامة &amp; lt؛ 1r9j33$4g8@hsdndev.harvard.edu&amp;gt.	&lt;1r9j33$4g8@hsdndev.harvard.edu&gt;
PS:	PS:
أجرة	berish
الممارسين	amaliyotchilar
لجنة التحقيق	prob,
دولة	shtati
عالم	dunyo
الترانزستور؟	tranzistor?
ليس	olmaydi,
نظرة	qarash
فجأة	to&#39;satdan
زائف	Psevdo
التشفير	kriptografiya
(175	(175
html>	NUNNALLY@acs.harding.edu
[...	[...
صلب	qattiq
استخدام.	foydalanib.
وفي الوقت نفسه،	Hozircha,
الزوايا.	yuritadigan.
شخص ما	kimdir
html>	psyrobtw@ubvms.cc.buffalo.edu
باستخدام	foydalanib,
مظهر	ko&#39;rinishini
وقال،	aytib,
(RvKampen)	(RvKampen)
!!!!	!!!!
لا.	olmaydi.
لم أسمع	eshitmadim
نافذة	window
دايتون،	shtatining,
فيل	Phil
الناس	insonlar
اشتعال	chaqnash
ونتيجة ل	natijasida
جنبا إلى جنب	kombinatsiyalangan
الغرض من	maqsadini
... وطن؛ &amp; GT؛ &amp; GT؛ &amp; GT؛	....&gt;&gt;&gt;&gt;
نادر	kamdan-kam
أسطوانة	diskda
يشار إلى	nomlanadi
U &amp; GT؛	U&gt;
دانا	Dana
html>	banschbach@vms.ocom.okstate.edu
ويليس)	Willis)
سائق	drayverini
أيام	kundan
الأميركيون:	Amerikaliklar:
أكتوبر	oktyabr,
PTO	PTO
المنطقة	sohada,
التناقض	nomuvofiqlik
كبير	yirik
منطقيا	mantiqan
كما ذكر،	aytilganidek,
(تيم	(Tim
(بلوتو	(Plutondan
مركز	markazi
بالتآمر	hiylalari
^^^^^^^^^^^^^^^^^^ وطن.	^^^^^^^^^^^^^^^^^^&gt;
في التاريخ	tarixida
حجم	hajmini
اهتمام	qiziqish
anhumâ	anhuma
الآن،	Keling,
هذا،	yotipti,
خوادم	serverlarida
كريستيان &amp; GT؛	masihiylar&gt;
نتروجين	azot
الفوسفور)	fosfor)
الحذر	ehtiyotkor
التثبيت،	o&#39;rnatish,
هذا كل شيء!	yotipti!
14-19؟	14-19?
رادار	radar,
رأي	View,
أنا لا أرى	ko&#39;rmayapman
عذاب	azob
على &amp; quot؛ سطح	&quot;yuzasida
هذا هو)	yotipti)
علامات	oyat
نقطة	Point
هنا،	Mana,
اهتمام	foiz
الخطايا	gunohlarimiz
html>	toml@boulder.parcplace.com
kenyee	kenyee
شرقي	sharqqa
نحن	biz
قطعة	bit
الفئران	sichqonchani
20-39	20-39
واحد	bir
المؤشر	markerni
الاستثمارات	qo&#39;yilmaydigan
(Gregh@niagara.dcrt.nih.gov)	(gregh@niagara.dcrt.nih.gov)
الحماية.	himoya.
حماية	himoya,
9.25	9.256
....	....
تعريف	ta&#39;riflarni
أليس كذلك؟	qiladimi?
عينات	namunalari
وGT.	qilingan&gt;
اكسيبشن	exeption
مدار	orbitasida
...:	...:
مقابلة	intervyusida
مونار)	Munns)
(39.95)	(39.95)
يستعد.	tayyorlaydi.
...؟	...?
التلفزيون والراديو	Teleradiokompaniyasi
وGT.	uning&gt;
،	qoldi,
فيما بعد	keyinchalik
وGT.	ostida&gt;
.	qoldi.
الجسيمات	zarralar
(توم	(Tom
(س س)	(Assalamu)
إيطاليا	Italiya
آخرون	boshqalarga
قابل للتعديل	sozlanishi
قلق	Xavotir
اذهب	ketishiga
الشاهد:	shohiddir:
التصورات	hislarni
أسلوب	uslubi
تعليقات؟	Fikr?
أخلاقي	axloqiy
أفضل &amp; GT؛	yaxshiroq&gt;
بارمان)	Bormon)
سعر الصرف	kurs
دوفر	urib
ألين	Allen
Goolsbey)	Goolsbey)
تامبا،	Tampa,
درجة	gradus
باب	bob
الشخصية	Shaxsiy
(486-33DX	(486-33DX
تدفقات	oqimlari
-Arlo	-Arlo
فلوريدا	Florida
المبتدئين	yangilar
سيارة	Avtomobil
مهتم في	qiziqtiradigan
مبررة &amp; GT؛	oqlanadi&gt;
الدهشة	Ajablanarli
(لا يوجد	(no
رسميا	rasman
دراجة	velosiped
(1100	(1100
المعروفة.	tanilgan.
ربما	balki
الصحة	sog&#39;lig&#39;ini
الجسيمات	zarrachalar
كلاسيكي	klassik
أعدت	tayyorlangan
مخبأ	kesh
QUACK	QUACK
...)	...)
تقني	texnik
جوزيف	Jozef
الخلفي الباب	orqa-eshik
الهندسة	muhandislik
الأرض	Yerdagi
متوالي	izchil
الضرر)	zarar)
ثقيل	og&#39;ir
حرق	yoqib,
في المرتبة الثانية	Ikkinchi
كويستا)	Cuesta)
كيمياء	kimyo
(فرانك	(Frank
العلامة &amp; lt؛ C4vG3F.Kx3@apollo.hp.com&amp;gt.	&lt;C4vG3F.Kx3@apollo.hp.com&gt;
الشيء.	narsadir.
في وقت سابق،	Avvalroq
الجهد	kuchlanish
محب	mehribon
ديموس	Deimos
أن	qiladigan
كارثة	qamchilash
سايفر	Cypher
العرض	ta&#39;minoti
على &amp; quot؛ غير مختلفة ومثل؛	&quot;non-turli&quot;
العلامة &amp; lt؛ 93095@hydra.gatech.EDU&amp;gt.	&lt;93095@hydra.gatech.EDU&gt;
هيروكي	Xiroki
وعلى الرغم من	bo&#39;lsa-da,
صاعقة	chaqmoq
بالرغم من ذلك.	bo&#39;lsa-da.
اتفاقيات	bitimlar
أستطيع.	olaman.
الغيرية،	heteroseksüel,
جذب	Jalb
html>	caldwell8102@mtroyal.ab.ca:
يوجد	bor
html>	whitsebd@nextwork.rose-hulman.edu
هايت	HITEN
غني	boy
html>	Rauser@sfu.ca
talip	talip
برغي	murvat
منعطف	yoqing
المسافة	masofada
شوكولاتة	shokolad
زاوية	burchakda
4RUNNER	4Runner
الآن	hozirda
سرعة	suratini
رقاقة مجموعة	chip-majmui
إحساس	ma&#39;noda
محولات	transformatorlar
(هذا	(bu
معطى	bergan
واسع	keng
ديلاوير	Delaver
كوكب	Sayyora
العلامة &amp; lt؛ 1993Apr21.032427.22464@leland.Stanford.EDU&amp;gt.	&lt;1993Apr21.032427.22464@leland.Stanford.EDU&gt;
الاحتلال	ishg&#39;ol
المسيحيين	masihiylarni
كتابة	yozishni
مساء	kechqurun
computergenerated	computergenerated
اليوم)	kun)
الكوكب	Sayyoramiz
تأجير	Ijaraga
_your_	_your_
على &amp; quot؛ روبرت	&quot;Robert
مثل.	o&#39;xshaydi.
برئ	begunoh
هو	Bunga
القطع	bo&#39;laklari
شفاء	Davolash
قلق	tashvish
قمم.	toplar.
جيولوجيا	geologiya
أضواء	chiroqlar
.	foydalanish.
معنى	ma&#39;noga
(Bentz.e.puryear)	(bentz.e.puryear)
نحن نؤمن	iymon
على &amp; quot؛ &amp; مثل الوفاء بها؛	&quot;bajo&quot;
أن يطير.	uchadi.
(المحمولة):	(Portable):
وتر	Pay
كمية	miqdorda
تكلفة،	qimmat,
تكلفة.	qimmat.
أجنبي	xorijiy
ستيريو	Stereo
استخدام:	foydalanish:
أعمال	ishlaydi
إذا كان وGT.	qilsa&gt;
الآبار	Wells
السعر	narx
رحالة	Voyager
سوء الفهم	miscommunication
الرسالة إلى العبرانيين	Ibroniylarga
رسمي	rasmiy
حياة	hayoti,
***	***
html>	gchin@Eng.Sun.Com
على الرغم من أنه يبدو،	tuyulardi-da,
الحق ومثل؛	o&#39;ng&quot;
شخصيا،	Shaxsan
قوية وGT.	puxta&gt;
عملية تحليق	flybys
مثل .....	yoqdi.....
ريك.	Rick.
APPRECITATED	APPRECITATED
الدوائر،	davrlari
:	qiladi:
منزل	House
(كلاوديو	(Klaudio
المذنب	kometa
وGT.	harakat&gt;
؟	qiladi?
يوتا	yutadi,
الجيران	qo&#39;shnilarining
مهمة	missiyaning
المسافة	masofaga
تيار	hozirgi
سيد	janob
يبصقون،	tupurib,
نعتقد.	iymon.
وGT.	tomonidan&gt;
،	qiladi,
.	qiladi.
الآن	hozirga
المشعة	Radioaktiv
HIMEM.SYS	HIMEM.SYS
اسمه	ismli
علم	ilmi
كل	hammamiz
وGT.	kabi&gt;
حياة	hayotga
مقالة	maqolasida
للقضاء	yorilish
متهور	orêasida
أقراص	disklar
على &amp; quot؛ الأقمار الصناعية	&quot;yo&#39;ldoshlarini
سيتم عرض.	ko&#39;rsatiladi.
الجماهير	Massalari
متغطرس	mutakabbirlik
فجر	tonggi
نووي	yadroviy
الآن &amp; GT؛	endi&gt;
أحفاد	avlodlari
كرايسلر	Chryse
كريستيان	Masihiyning
سفينة	kema
النظائر المشعة	radyoizotopların
وأود أن.	istardim.
هاتف	telefon
الطلب	talab
يجي	Legge
يوم	kuni
80111	80111
فترة	muddati
التحويلات	davrlarini
حرفيا	Verbatim
على &amp; quot؛ صحية ومثل؛	&quot;salomatlik&quot;
كلام	aytganda
لقاء	uchrashuv
اجتماعي	ijtimoiy
علمي	ilmiy
بول	Pavlus
منذ	beri
في المقام الأول،	navbatda,
قواعد،	qoidalari,
صعوبة).	qiyin).
يمكنك	bera
كتب	yozadi
فرقعة	pop
______________________________________	______________________________________
بدت	yangradi
على &amp; quot؛ مسيحي &quot;	&quot;Christian»,
الله،	Allohning
مدار	orbitaga
جبلي	tog&#39;li,
موقع	saytidan
غطرسة	takabburlik
على أساس	asosida,
موبايل	Uyali
اللوائح	qoidalarga
المشهد	landshaft
المحاكمات	sinovlarni
بسيطة وGT.	oddiy&gt;
بني	qurilgan
كلاوديو	Klaudio
سوف	qiladi
RAM	RAM
كمبيوتر	Computer
العهد،	Ahdda,
تعريف	ta&#39;rifi
ممارسة	amaliyotini
سر	siri
الفضاء	kosmosda
الغاز،	gaz,
هو	buni
أو &amp; GT؛	yoki&gt;
61153	61153
سطح	sirt
قادمة	kelib
(الأسرة	(Oila
يوم القيامة	qiyomat
شابيرو	Shapiro
إله	iloh
وGT.	uchun&gt;
المكسيك،	Meksika,
بالضبط	aynan
وتستخدم	ishlatilgan
موارد	resurslarni
الأسباب	sabablar
الإلحاد	Ateizm
أي	biron-bir
الفضاء	kosmosga
آثم	gunohkor
:	keladi:
.	chiqildi.
نبض	urish
وظيفة.	vazifasi.
رقائق	Chips
Nunnally	Nunnally
بدون	turib,
.	keladi.
خمسة	besh
أنت	sizlar
،	keladi,
افتقد	miss,
أسعار	narxlar
وكذلك،	shuningdek,
(ولكن	(balki
استثمار	sarmoya
583 &amp; GT؛	583.&gt;
أطقم	ekipajlari
غادر.	qoldirganmiz.
على &amp; quot؛ ضوء	&quot;charog&#39;on
كل	hamma
الضجيج	hype
الجسيمات،	zarralar,
الشركة؟	kompaniya?
800M	800mA
باختصار،	aytganda,
سبب	sabab
الملحد	agnostitsizm
و2	2-va
قال.	dedi.
62.4	62,4
ملاحظ	kuzatildi
فترات	davrlarida
(	(eng
السقوط	tushadi,
وقال:	dedi,
وصل	keldi
المحيطات	okeanlar
على &amp; quot؛ الإنسان ومثل؛	&quot;gumanitar&quot;
أمثلة	misollar
قال؟	dedi?
مغطاة.	qoplandi.
الميثان	metan
مسرحيات	tutadi
الاخلاقيات و GT.	axloq&gt;
على &amp; quot؛ D &amp; مثل؛	&quot;ilmiy&quot;
الست	six-
التيار	mainstream
مثال	misol
يخطأ	yoppasiga
القيادة؟	haydash?
الله	Alloh
آخرون	boshqalar
نوافذ	Derazali
لوحة المفاتيح	klaviatura
مقارنة؟	solishtiring?
جانيميد	Ganymede
عكس	zid,
البتنت	bitnet
رن.	yangradi.
سرب	to&#39;dasi
7،329	7,329
السيوف	Sabres
html>	dans@uxa.cso.uiuc.edu
(وهم	(ular
وGT.	hech&gt;
الناس	kishilarning
-------------------	-------------------
تقرير	xabar
،	ruxsat,
دراسة ومثل؛	Study&quot;
.	ruxsat.
استيقظ	Uyg&#39;onish
عدم ثقة	ishonchsizlik
(الشحن	(yuk
النافذة الرئيسية	Ota-window
سيجارة	sigareta
________)	________)
نحن وGT.	Biz&gt;
العلاج	davolashda
*******************	*******************
ضيق	zich
نموذج	modelga
مستودع	QXI
الميكانيكي	mexanika
شركة	Company
إلى أسفل.	pastga.
وضع.	qo&#39;yildi.
أدخل	kiriting
ل	bir-bir
في عملية	jarayonida
الأيونوسفير	İyonosfer,
(مايكروسوفت	(Microsoft
أنت	siz,
هالي	dumli
أجنحة	Wings
لعب	o&#39;yin
نتروجين	Azot
الفائق الدقة	ultrahigh-qaror
يتم تعيين	eşleştirilir
X3153	X3153
الصداع	og&#39;riqlari
WINDOWS	WINDOWS
الحمقى	goon
السطح	Sirt
العلامة &amp; lt؛ ekdfc.14.0@ttacs1.ttu.edu&amp;gt.	&lt;ekdfc.14.0@ttacs1.ttu.edu&gt;
إلكترونيات	electronics
سميك	qalin,
على &amp; quot؛ &amp; مثل؛	&quot;bosh&quot;
(المزدوج	(dual
تطوير	chiqilishi
العلامة &amp; lt؛ Fenton@Kaleida.Com&amp;gt.	&lt;Fenton@Kaleida.Com&gt;
الذقن)	Chin)
الأخاديد،	kanyonlar,
بوس)	Bos)
تشفع	shafoat
خطأ)	xato)
يا الهي	gosh
،	berilgan,
.	berilgan.
ومثل؛	oshiradi&quot;
كراهية	Xotami,
فنلندا	Finlyandiya
نسخة	versiyasini
مماثل	O&#39;xshash
شارع	Avenue
ثلاثة،	uch,
العلاقات	munosabatlarni
حساب.	hisobga.
نقود	Pul
ثلاثة.	uch.
هذا	bu,
العربية	Arabic
(SF	(SF
(إعادة	(Re
عشتار	Ishtar
معاهدة	shartnomasi
متماثل	nosimmetrik
معتاد	odatiy
قول	ayta
(لا يوجد	(No
ليس	Emas,
تغيرت.	o&#39;zgardi.
نقود	pul
إطلاق نار	tortishish
(P.	(P.
وGT.	so&#39;nggi&gt;
سبيروس	Spiros
دخول	kiritish
أساس	Foundation
B2: &amp; GT؛	B2:&gt;
مخصصة.	bag&#39;ishlangan.
التأريض	Topraklama
رومانسي	romantik
نيبتون	Neptun
1Meg	1Meg
منخفض &amp; GT؛	past&gt;
التي	boshlangan
الأسئلة	savollar
الفضاء	makon,
أن تكون	atalishga
علامة	belgisi
العار.	sharmandalik.
حافلة	avtobus
قريب	yaqin,
GAP)	gap)
تيتانيا	Titania
سمعي	Audio
386DX 40	386DX-40
الأجسام	moslamalarni
أصحاب	egalari
على &amp; quot؛ &amp; مثل؛،	&quot;ular&quot;,
RAUS)	Rauser)
الآراء	fikrlar
آخرون	boshqalarni
الشبكات	tarmoqlari
الدفع.	to&#39;lash.
عشرة	O&#39;n
حقائق	dalillar
عادة	odatda
أشباه الموصلات	Semiconductor
الدفع)	to&#39;lash)
جافا	Java
الجيولوجية	geologik
تطبيق	tatbiq
مدار	orbitasi
تنسق	koordinatalar
لدفع؟	to&#39;lash?
طبي	Medical
)	oshiriladi)
الأسهم.)	xolislik.)
قل لي.	ayt.
مقبوض	o&#39;tkaziladi
.	oshiriladi.
إضافي	Qo&#39;shimcha
خاص	O&#39;z
العلامة &amp; lt؛ 1993Apr20.102756.1709@mala.bc.ca&amp;gt.	&lt;1993Apr20.102756.1709@mala.bc.ca&gt;
على &amp; quot؛ كسر	&quot;break
html>	bc744@cleveland.Freenet.Edu
الجسيمات	zarralari
؟	oshiriladi?
Cirella)	Cirelli)
البرتو	Albertan,
الشركات المتعددة الجنسيات	millatli
الكتب	kitoblar
الهجرة!	hijrat!
أباريق وGT.	ko&#39;zalar&gt;
للوهلة الأولى،	qarashda,
خلق	tuzish
فئة	sinf
(و	(Va
شهادة	tasdiqlash
الموتى	o&#39;liklarning
الإنجيل،	Injil,
أمر	buyurgan
&quot;التفسير&quot;	«talqin»
جلسة	sessiyasi
طاقة	energetika
الكتاب المقدس	Bible
دعوة	da&#39;vat
التكنولوجيا،	Texnologiya,
على &amp; quot؛	&quot;Siz
تمكين	yoqilgan
ارتفع.	ko&#39;tarildi.
ذيول	dumlar
الآن	​​hozir
(ايمي	(Emi
كلمة	so&#39;zni
المستخدمين	foydalanuvchilar
جالانت	Galant
يقول	deyilgan
سعيد	baxtli
(جديد)	(yangi)
مبيعات &amp; GT؛	sotish&gt;
كمية	miqdor
ويلز	Welles
ملاءمة	qulaylik
تيسير	engillashtirish
title-	title-
تعليق	izoh
html>	jhardono@nickel.ucs.indiana.edu
مفرط	ortiqcha
من ناحية أخرى	tomondan
بين	qatorida
امرأة	ayol
على نطاق الكوكب	sayyora-keng
التشفير ومثل؛ &amp; GT؛	shifrlash&quot;&gt;
ليس	emas
html>	gchin@ssf.Eng.Sun.COM
مينداناو ومثل؛	ARMM&quot;
مسيحي	nasroniy
(المثليون	(gomoseksual
مثلي الجنس	Gomoseksual
ROM	ROM
الموقع.	ayting.
شقيق	aka
(6118	(6.118
ياماها	Yamaha
الموقع)	ayting)
موقع،	ayting,
آية	Verse
لا.	qilmang.
شريط	tarmoqli
بالعكس	Versa
دخل	daromad
وGT؛ &amp; GT؛	bo&#39;lsangiz&gt;&gt;
oyat-	oyat-
وليام	Uilyam
الجمهور	ommaga
(و،	(va,
واقعية	pragmatik
AUTOEXEC.BAT	AUTOEXEC.BAT
التلسكوبات	teleskoplar
الله	Xudoga
بسيط	oddiy
شيكاغو	Chikagodagi
البريد الإلكتروني	Email
فوري	bevosita
فيني)	Finney)
متغير	o&#39;zgaruvchilar
*****************	*****************
وسيتم عرض ومثل؛	ko&#39;rinadi.&quot;
أفكار	fikrim
الفضاء	Kosmik
ومثل؛	aloqa&quot;
العلاج.	muomala.
الحدود	chegarani
تغيرت.	o&#39;zgartirilgan.
التي	boshlangan,
8300	8300
الوزن،	og&#39;irlik
حزب	tomon
أو-	-or-
في	mo&#39;ljallangan-yilda
وذلك بفضل وGT.	rahmat&gt;
العرض	yetkaza
لتعليم	o&#39;rgatish
في الماضي،	O&#39;tmishda
أوروبا	Evropa,
html>	engp2008@nusunix1.nus.sg
في التأرجح	belanchak
يبرالي	erkin
يعقوب	Yoqubning
الثقوب	teshiklari
كوكب	sayyoraga
تشرين الثاني	noyabr,
علمي	Ilmiy
على &amp; quot؛ فعلت &amp; مثل؛	&quot;bajarildi&quot;
2000	2000
مقدما	Oldindan
صدئ الحمراء	zanglagan-qizil
إصدارات	versiyalari
12-14)	12-14)
المزدوجات الحرارية	termokupl
بحث	tadqiqotlar,
\ &amp; طن.	\&gt;
فوهة الجيب	krater-pocked
طبيعي	normal
أن	O&#39;sha
مستوى	darajasi
تحقق.	tekshiring.
ألاباما	Alabama
ظلام	quyuq
على أساس	asoslangan
دفن،	ko&#39;mildi
القانون	Qonundan
شهر	Oyning
الخلفي)	qaytish)
مئات	yuzlab
^^^^^^^^^^^^^^^^^^^^^^^^^^^^^^	^^^^^^^^^^^^^^^^^^^^^^^^^^^^^^
لايم	Lyme
جامعة	Universiteti
فولت	sarma
هنا	yerda
أخدود	groove
باستخدام	foydalangan
الدروس	saboq
مزور	to&#39;qib
مثل	ana
سفر	sayohat
إخلاص	jonbozlik
المهنية وGT.	professional&gt;
المزدوج الرياضة	Dual-Sport
ضاربا	Hitter,
بضائع	mol,
عودة	Return
الريبو	Repo
فيلانوفا	Villanova
أورسون	Orson
عقوبات	sanktsiya
الأنبياء	payg&#39;ambarlar
أمبير	amp
عمرو	amr
السماح	qilaylik,
هو؛	hisoblanadi;
أجهزة الكمبيوتر	Kompyuterlar
هو:	hisoblanadi:
خطورة	gravitatsiya
سطح المكتب	stoli
الاختيار	tekshirib
أحيانا	Ba&#39;zan
---------------------------------	---------------------------------
كم	qancha
مالي	moliyaviy
قناع،	fosh,
تجويف	tug&#39;ib
الله،	Xudo,
سكر	shakar
انقر هنا	Yerni
القارب	qayiqda
(DOS	(DOS
P7625)	P7625)
أصفر	sariq
أو؟	yoki?
الله:	Xudo:
دقة	to&#39;g&#39;riligiga
روحي	ma&#39;naviy
واحد وGT.	yolg&#39;iz&gt;
فكرة	fikrni
هو:	bormi:
ولاء	sadoqati
هو؟	bormi?
الشروط	sharoitlari
توضع	joylashtiriladi
المخطط	rejalangan
ببطء	«sekin
العالم	olamlarning
؛-)	;-)
+31	+31
تعرف	biladimi
غير	hisoblanadi,
S.)	S.)
هم	Ular,
هو.	hisoblanadi.
انعكاس	aks
على &amp; quot؛ سكوتر ومثل؛	&quot;Scooter,&quot;
عشوائي	tasodifiy
دولة	davlat
متحد	birlashgan
بلوتو	Pluto
(أخرى	(boshqa
كربون	uglerod
بعيدا	uzoqda
حول	atrofga
وGT.	bilan&gt;
؛	hosil;
نشاط	faolligi
=============================	=============================
،	nazar,
لتنتفخ	kuchaya
تضحية	qurbonlik
علامات	oyatlarni
حكم عليه بالسجن ل	mahrum
سطح	sirtini
وظيفي	funktsional
417-4101	417-4101
خلق	yaratish
راندال	Randall
كراهية	nafrat
مثل.	yoqadi.
السماح.	bo&#39;lsin.
html>	willisw@coe-nw.clemson.edu
المجموعات	guruhlar,
كوكب	sayyoramizdagi
MICRONICS	Micronics
الصوت	tovushi
طابعة	printerni
السماح!	bo&#39;lsin!
تقع	tushib
شوستر)	Schuster)
عنوان	murojaat
في جميع أنحاء العالم،	bo&#39;ylab,
ويليامز	Uilyams
بلورات	kristallari
العلامة &amp; lt؛ 1993Apr21.182606.6798@ra.royalroads.ca&amp;gt.	&lt;1993Apr21.182606.6798@ra.royalroads.ca&gt;
حجم،	hajmi,
عموما،	yirik,
DR350S	DR350S
العمل.	ishlaydi.
الجيران	Qo&#39;shnilari
على &amp; quot؛	&quot;U
المعين	ichiladi
أي شخص	kimga
**********	**********
أشياء	qilinishi
العمل؟	ishlaydi?
كومة قش	g&#39;aram
جزء.	qismidir.
آلة	Mashina
RIP	RIP
كاف	yetarli
على سبيل المثال.	aytaylik.
نصف الجليد،	yarim-muz,
على &amp; quot؛؟	&quot;?
وGT.	ko&#39;p&gt;
ذكر	erkak
تبريد	sovutiladi
النساء،	ayol,
(عبرانيين	(Ibroniylarga
الآلهة	Gods
في الواقع	aslida
على &amp; quot؛،	&quot;,
الشمس	Quyoshning
على &amp; quot؛.	&quot;.
وفي الوقت نفسه،	orada
ركوب	haydash
html>	m-it2691@cs.nyu.edu
حاوية	idish
الوقوف.	turibsizlar.
سولانا.	solaman;
زرعت	ekilgan
يلقي	tashlashdi,
html>	dlb@hudson.wash.inmet.com
المستخدمة،	ishlatiladi,
يستخدم.	ishlatiladi.
فرق	jamoalar
وسوف	solaman,
إرادة	irodasiga
هنري	Genri
الأرجون،	argon,
سعيد	xursand
تلمع.	porlaydi.
Superve	SUPERVGA
على &amp; quot؛ لوحة ومثل؛	&quot;Plastinka&quot;
الأيونات	ionlar
عكس ذلك.	teskarisini.
مجتمع	jamoa
rethorical	rethorical
منحرف	Askew
ذكر	zikr
مماثل	o&#39;xshash
معصم	bilagini
.	chiqarish.
الإنتاج	chiqarish,
^^^^ وطن.	^^^^&gt;
نيسان	aprel,
الجاذبية	gravitatsion
الجماهير	ommasi
الدجالين	quacks
الأرصاد الجوية	meteorologiya
ألماني	nemis
كوكب	sayyorada
مستوى	darajali
نواة	yadrosining
.	o&#39;sha.
Whitsell	Whitsell
شمالي	shimoliy
الأسيتيلين،	asetilen,
شريط الأدوات	paneli
؟	etmoqda?
الأرض	Yerga
ارتفاع	Yuqori
كانت	qilingan
داخلي	ichki
زيادة	oshirish
ليس	qilmasliklaridandir
منطقة	mintaqasini,
613)	613)
.	etmoqda.
،	etmoqda,
واللفتنانت؛ 1537	&lt;15378
تحقيقات	zondlar
كوستنر	Costner
.	mos.
شبه عاصفة	Near-bo&#39;ron
عباءة	mantiya
طرق	uslublarini
html>	hambidge@bms.com
العالم	dunyodan
نساء	ayollarga
18:33	18:33
مقارنة،	solishtirganda,
دم	qon
html>	DBD@ICF.HRB.COM
(كلايتون	(Clayton
تكنولوجيا	texnologiyasi,
الخروج من الملة)	theists)
إطلاق	reliz
Guerke	Guerke,
الدفاعات	İticiler
Guerke)	Guerke)
فقط	Faqat
أجيال	avlodlar
البرد.	Chill.
ضخم	ulkan
الخروج من الملة،	theists,
إرسال	yuborish
مشروع	Project
B433EI2	B433EI2
ل؟	chunki?
الحادي ومثل؛	ateist&quot;
مستوى	darajaga
كيب	Cape
الأميركيون).	amerikaliklar).
(ربما	(ehtimol
الحقيقة.	haq.
11:26)	11:26),
كارل	Karl
لأنه،	chunki,
أفكار	g&#39;oyalarni
حذف	o&#39;chirildi
3-8)	3-8),
اثنان	ikki
مساح أراضي	Surveyor
هنا	Yerda
(هيرمان	(Herman
html>	ai843@yfn.ysu.edu
html>	thomasp@ifi.uio.no
أربعة	To&#39;rt
anekdot	anekdot
تسعة	to&#39;qqiz
العالم	dunyoda,
آخرون	Boshqalar
LATONIA)	LATONIA)
أكد	tasdiqlagan,
بيئة	muhitini
نيويورك	Nyu-York
كيبيك &amp; GT؛	Quebec,&gt;
لا)	yo&#39;q)
لا،	yo&#39;q,
أنفسنا	o&#39;zimizni
لا.	yo&#39;q.
الله	Allohga
حرف	harf
مدير	Managerda
من الصعب	hard
(بيتر	(Peter
مختلط	aralash
(21648	(21,648
الحجر)	Stone)
القابض	ogohlik
الحكمة)	dono)
عمل	Harakat
الإقلاع عن التدخين.	chiqinglar.
تحت	ostida,
السيطرة -cut	kesib-nazorat
تغذية مرتدة	burchakli
ديلكو	DELCO
23-26،	23-26,
حول	haqida,
مسيحي	masihiy
هافاس،	xavas,
هالة	halo
طول	uzunligi
تلعب خارج	pley-off
تلك محظوظا	egasidirģ
بعد	hali
أنفسهم،	o&#39;zlarini,
مسيحي	Christian
بعيدا	Uzoq
html>	alung@megatest.com
الكواكب	Sayyoralar
أشعل	yoritilgan
قادرة على.	qodir.
بطارية	batareyani
،	ham,
الرسل،	havoriylariga,
FJ1200	FJ1200
.	ham.
القمر	Oyga
دبلوماسية	diplomatiya
(هات،	(shapka,
سيكون	oshiriladi
؟	haqida?
ديترويت	Detroyt
صغيرة،	kichik,
)	ham)
أخذ	olishi
وكالة	agentligi
صغيرة)	kichik)
كثير	ko&#39;plab
لقب	Sarlavha
.	haqida.
طريق	yo&#39;li
(دان	(Dan
Thorson	Thorson
التقييم:	Reyting:
خاطئ	noto&#39;g&#39;ri,
استطلاع	so&#39;rovnoma
لزم الأمر.	zarur.
Pharasees	Pharasees
،	yo&#39;l,
شهر	Oyda
تحسن	takomillashtirish
محادثة	suhbatlashdi
إشارة	signal
خاطئ	noto&#39;g&#39;ri
صاروخ	Raketa
متأخر	kech
--------------------------	--------------------------
تويج	Corolla
إدمان.	qo&#39;shadi.
الأرضيات،	Taxta,
رمل	qum
حزام،	kamarning
إدمان	qo&#39;shadi,
القراء	kitobxonlar
تقدم	taraqqiyot
Nagle	Nagle
الأجسام	ob&#39;ektlarni
وأولياء الأمور	ota-va
هلال	Moon
الآيات	oyatlarda
==========================================	==========================================
أفكار	g&#39;oyalarini
فهم	tushunib
مقالة	maqola
RAUS	Rauser
معرض	adolatli
المتداعية	çökmekte
مستوى	darajada
(2544	(2.544
وGT.	olgan&gt;
ذات الصلة	bog&#39;liq
.	ekan.
تجد	topish
لذلك،	ekan,
صور	foto
نقدر	qadriga
روسيا،	Rossiya,
HAMZA	HAMZA
)	yo&#39;l)
التفسير.	talqini.
مسخن	qizg&#39;in
COORD.	Coord.
# &amp; طن.	#&gt;
دراما	drama
فيليب)	Filip)
كنت أعرف	bilgan
الوسائل	vositalarini
أوليسيس	Ulysses
كاليفورنيا	Kaliforniya
فكرة	g&#39;oyasini
يتراكونازول	itrakonazol
خطة	reja,
415-688-8231	415-688-8231
وطن.	Turli&gt;
كيو	Que
إزالة	tashlangan
نوبواكي	Nobuaki
20Meg	20Meg
Nowadys	Nowadys
فيما بعد	Keyinchalik
بروكس	Brooks
موعد	Rendezvous
الحصول على	topsangiz,
مصطلح	muddat
في وقت لاحق،	o&#39;tib,
الرواد	Pioneers
حواء	Momo
أصلي	asl
يتعرض	fosh
الطلاب،	shogirdidan,
--------	--------
دونات	donut
احتياطي	ehtiyot
فصول	darslari
JESUSCHRIST	JESUSCHRIST
احتيال	firibgarlik
تحول	o&#39;zgartirishda
APRIORI	Apriori
المشاهدات:	olish:
على الدفع.	buyuradi.
المؤمنين وGT.	mo&#39;minlarga&gt;
آخرون	boshqalar,
نتيجة	natija
غطاء	qopqog&#39;ini
ليس	emasmiz,
سرطان	saraton
ماكسويل	Maksvell
كوكومو	Kokomo,
شئون	ishlar
نساء	ayollarni
النار،	do&#39;zaxdan
،	olish,
تقطر	tomchi
منطقة	Maydoni
مدار	orbitasini
إنساني	gumanitar
الإحالات	refering
عبادة	ibodat
مخصص ل	bag&#39;ishlangan
الوسطى و GT.	markaziy&gt;
استخبارات	aql
الإنتاج	ishlab
الصور	tasvirlarni
اكتشفت.	aniqlashdi.
الموصلات:	shgichlar:
تديم	abadiylashtirish
مدرسة	Maktab,
(دير	(der
كاري	Cary
لم أكن.	bermadi.
استيقظ	uyg&#39;onish
القمر	Oyni
سمعت	eshitildi
مستوى	bosqichga
شفاء	davolash
الرجال	erkaklar,
التصعيد	avj
منحرف	Askew,
ندوة	Seminar
الأسباب	reasonning
إكراه	majburlash
مناسب	Proper
خلع الملابس	qobiq
قرأ	o&#39;qish,
unclumped	unclumped
(1170	(1,170
القراءة)	o&#39;qish)
التكرار.	Freq.
العرب	Arablar
إلخ	hokazo
أمراض	kasalliklar
مسعف	Palmer
(بالمناسبة،	(Darvoqe,
لثني	qaytarmoqchi
Nunnally)	Nunnally)
العلامة &amp; lt؛ فارغة	&lt;bo&#39;sh
قرن	asr
تنبأ	bashorat
أشعة	nurlarini
من	nazarda
قضية	masala
على &amp; quot؛	&quot;haqida
مرحلة	bosqichda
احتلال	mashg&#39;ulotlari
Alyosha	Alyosha
الاجتماعات &amp; GT؛	majlislarida&gt;
تذكر	eslab
سجل	yozib
معطى	ato
(و	(va
هواء	havo
VL حافلة	VL-avtobus
هو	Buning
زائد	Plus
منحرف)	Askew)
سمعت	eshitib
Lankford	Lankford
بداية	tushirish
إعادة شراء	buy-orqa
RSEVERY	RSEVERY
(فقط	(faqat
يذهب بعيدا	yo&#39;qol
تعلم.	o&#39;rganamiz.
كارل	Carl
جامعة	universiteti
اضطراب	parokandalik
بطاقة	Card
تذكر	eslay
الأمانة و مثل؛	xavfsizligi&quot;
تخضع ل،	tortiladi,
جدي	jiddiy
حكم	Qoida
سرعة	tezligi
ضمن	Ichida
Justification_	Justification_,
وGT؛ &amp; GT؛،	yana&gt;&gt;,
طبيعة	tabiatda
جلسة	sessiya
html>	pgf@srl03.cacs.usl.edu
المطبوخ في البيت	Uy-pishirmoq
وثيقة	hujjat
الاكتشافات	kashfiyotlar
دور	roli
بطيء	sekin
هو؟	emasmi?
والله مثل؛،	Xudosi&quot;,
قبل	oldin,
الكويكب	asteroit
قبل.	oldin.
homosexal	homosexal
[386Enh]	[386Enh]
أرسلت	yuborilgan
المتحولون	o&#39;zgartiradi
هل تصدق ذلك؟	ishonasizmi?
يسوع	Iso
وGT.	kim&gt;
مواطن	native
،	etadi,
انتظار	kutaman
إعلان	e&#39;lon
إذهب إلى	o&#39;tish
.	etadi.
نفسي.	o&#39;zimni.
I.	oldim.
.	bog&#39;liq.
AT)	AT)
(غير الميت)	(non-Duo)
سمعت؟	eshitmagan?
العقد.	shartnoma.
_____	_____
سبحانه وتعالى.	Qodir.
للحصول على	olish
اشتباه	gumon
حكم	hukmron
المصممين	dizaynerlari
منع	oldini
كتابي	yozilgan,
حق	huquqdan
الكويكب	asteroid
حظ	omad
مؤامرة	fitna
يسوع	Isoni
[العبرانيين	[Ibroniylarga
عكس	teskari
الآن &amp; GT؛	Hozir&gt;
الإتصالات	Communications
نصف كرة	yarimsharda
تطبيقات	dasturlarda
(&amp; طن.	(va&gt;
.	bo&#39;lmagan.
040	040
النساء فضلا عن الرجال.	yog&#39;dirilgan.
20X-60X60mm	20X-60X60mm,
لصوص،	qaroqchi,
مغاير	hetero
الجامعة:	universiteti:
تركيز	o&#39;ylash
الملحدين	ateistlar
أن.	qilayotganini.
AIAA	AIAA
نافذة	derazasiga
ديناميات،	dinamikasi,
غليان	qaynoq
هل	emasmi
_______________________	_______________________
حذف	o&#39;chirilishi
النيتروجين،	azot,
فوبوس	Phobos
محدث.	yangilanadi.
المصانع	fabrikalar
العلامة &amp; lt؛ C5xxq0.18M@cs.columbia.edu&amp;gt.	&lt;C5xxq0.18M@cs.columbia.edu&gt;
الجانب الآخر	narigi
كما DH	DH-kabi
المذنب	Comet
الإصدار.	versiyasi.
===============	===============
أدب	adabiyotlarda
أثار	ko&#39;tarib,
غاليليو،	Galiley,
البرد،	sovuq,
N-8-1	N-8-1
الهرم}	piramida}
شخص ما	kimdir,
طريقة إدارة آلة التصوير	Panoramic
المغول	mo&#39;g&#39;ullar
الجسم	tananing
الهيئات	organlari
نهر	daryo
البيسبول	Baseball
يمكنك	mumkin
ومدين	Madyanga
.	boshlaydi.
الإجابة: &amp; GT؛	javob:&gt;
في الأفق	ufqda
WinJPEG	WinJPEG
ماجلان	Magellan,
حسنا،	Okay,
مستعمرة	koloniya
مظهر	ko&#39;rinishi,
رسوم هزلية	komikslar
على &amp; quot؛ &amp; GT؛	&quot;&gt;
000	000
[المسيحيين]	[masihiylar]
نظام	tizimi
أعمدة	qutblar
صحيفة	gazetasi
(UNT-CAS	(UNT-CAS
رخصة -يوم	kun-litsenziya
الجو	atmosferasida
S5R3.2	S5R3.2
صدر.	chiqardi.
مجمد	muzlatilgan
همفريز	Humphreys
المفهوم.	tushunchasi.
منجم	meniki
3.1	3.1,
الملحدين	xudosizlar
كتلة	omma
حرية	erkinligi
ترقية	yükseltilebilir
يتعرض	duchor
الرجل،	Odam,
سبب ومثل؛	sababi&quot;
اللون	rang
على &amp; quot؛ المنشطات	&quot;velopoygachi»
وهذا هو،	ya&#39;ni
القدس	Quddus
تعلم	oling
(نيك	(Nik
سببياتي	etyolojik
عروض	ko&#39;rsatadi,
غير عدوانية،	​​non-tajovuzkor,
132،252	132,252
ضد	Qarshi
نشط	Active
الضغط	bosimini
html>	toml@boulder.ParcPlace.COM
هيرمان،	Herman,
كريغ	Kreyg
السيارات:	kabellar:
.	ko&#39;rsatadi.
المريخ،	mars,
ارتفاع	balandlik
رئيسي	Asosiy
سابق	oldingi
^^^^^^	^^^^^^
التجربة.	tajriba.
أنا لست	emasman
تعليقات	fikr-mulohazalaringizni
قدما	oldinga
البعثات	missiyalari
الزئبق،	Merkuriy,
لقب	nomga
gapirdingizmi!	gapirdingizmi!
موارد	resurslari
تلسكوب	Teleskop
إبليس	shayton
وسوف أكون	olaman
المعالجين	tabiblarga
المريخ	​​Mars
Maftunkorliliga	Maftunkorliliga
هل أنت &amp; GT؛	olasizmi,&gt;
أحلام)	tushlar)
فيليكس	Felix
حصة	ulushi
متباين الجنس	Heterosexuel
READ	o&#39;qi
مشتر	qiluvchi
خلال	paytida
غامضة	tevaragida
شرائح	chipset
Symbolisme &amp; GT؛	symbolisms&gt;
فوز	g&#39;alaba
خبز	Bake
وGT؛، مطالبة	da&#39;vo&gt;,
نيوتن	Newton
(بيل	(Bill
كولينز &amp; GT؛ &amp; GT؛	aslida&gt;&gt;
أقول	aytaman
الأسباب:	sabablari:
نافذة	oynaning
ولكن،	lekin,
تأثير	zarba
عالم	jahon
جهود	urinishlariga
الماوس؛	Sichqonchasi;
ضرر	zarar
| &amp; طن؛ &amp; GT؛	|&gt;&gt;
الأراضي خارج العمل	yer-out-of-biznes
موقف	mashinalar
التشفير	kriptografik
مسمد بالمرل	marly
أحزمة	belbog&#39;larini
القانون	qonun
TIFF	TIFF
كتب	yozgan
كارثة	musibat
يعيش في	istiqomat
تيمونس	Timmons
محاولات	urinishlar
الجغرافية	geografik
وGT.	ikki&gt;
بلد	mamlakat
الصياد	Fisher
بدلا من &amp; GT؛	o&#39;rniga&gt;
اسم	nomi
إدارة	ma&#39;muriyatining
6/92	6/92,
لاذع	olishda
تجد	topishingiz
منطقة	tuman
أشكال،	shakllari,
تطبيقات	dasturlarga
و&amp; GT؛	katta&gt;
ألمانيا،	Germaniya,
html>	mlee@post.RoyalRoads.ca
قبر	qabr
حق	o&#39;ng
15 &amp; GT؛	15-siz&gt;
html>	v124p7kk@ubvmsc.cc.buffalo.edu
عمل	ishlarni
neccacery	neccacery
(يوسف	(Yusuf
منح	berishi
دواء وهمي	Placebo
هو.	emasmi.
أحمر	Qizil
____________________________________________	____________________________________________
1992-1993	1992/93
.	chiqdi.
في	bo&#39;yicha,
لم	qilmadi
كثافة	zichlikka
بدون	bo&#39;lmasdan
صلوا اليها	KELDI
AAS	AAS
طائرة نفاثة	Jet
مؤمن،	qulflangan,
شركة	Inc.
تعليم	tarbiyasida
مؤمن.	qulflangan.
على &amp; quot؛ jargonese ومثل؛)	&quot;jargonese&quot;)
يي)	Yee)
لا يمكنك.	olmaysiz.
المؤتمر الوطني العراقي	Inc,
لوحظ.	kuzatganman.
أربعة	to&#39;rttaga
الدعوة	qo&#39;ng&#39;iroqning
Triantafyllopoulos)	Triantafyllopoulos)
بعيدا،	uzoqlashib,
مع	BO&#39;LGAN
(ميسليف	(myslef
بديع	yo&#39;qdan
سلاح ناري	qurolga
الصحة،	salomatligini
شارك في	qatnashdi
سلامة	Safety
Mitchum)	Mitchum)
لمس	teginish
وفقا لذلك،	nazardan,
،	berdi,
.	berdi.
جزيئات	molekulalari
التي تم تحديدها.	aniqlangan.
أرقام	raqamlarini
حول	Atrofida
إعلان	reklama
والحزام الرئيسي	asosiy-kamar
طقس	ob-havo
إنجلوود،	Englewood,
المريض	bemor
متخم	to&#39;lgan
على &amp; quot؛ دينامية ومثل؛	&quot;dinamik&quot;.
اثنان	ikkita
غير العضوية	noorganik
ANTI-TRUST	ANTI-Trust
KES	KES
حريق	olov
على &amp; quot؛	&quot;uzoq
صغيرة ومثل؛	mitti&quot;
عاد	qaytganida,
اختيار	tanlagan
وبطبيعة الحال،	Albatta,
(الحرف)	(CRAF)
نفسه	o&#39;zi
اللاعبين؟	futbolchilar?
توافق	rozi
التفسيرات	talqinlar
(مايك	(Mayk
سكاكين	knifes
محظوظ	omadli
(هانز	(Hans
html>	jaskew@spam.maths.adelaide.edu.au
الخيام	chodirlarda
هوائيات	antennalar
باسادينا،	Pasadena,
أصبح	aylanib
المناطق	hududlari
جاي	Jay
فانكوفر	Vancouver
مغناطيس	magnit
العلوم	fanlar
Faehl)	Faehl)
الفاكهة،	meva,
على حد سواء	ikkisi
شعاع	nur
لي	mening
رجل	Odam
المعتقدات	e&#39;tiqodlari
استهلاك	iste&#39;mol
تتفوق	sig&#39;maydigan
إطالة	cho&#39;zilgan
مشتر	xaridorning
نقد	tanqidga
منبثقة	oynani
لعبة	o&#39;yinni
(مارك	(Mark
(مات.	(Mat.
متوسط	vositachi
اليهود،	Yahudiylar,
باستخدام	yordamida,
على &amp; quot؛ electroglow على &amp; quot؛	&quot;electroglow.&quot;
عقلي	ruhiy
آدامز	Adams
معماري	tektonik
(السيانيد	(sianid
عدم التجانس	heterojenlik
الماجستير	Masters,
تقاليد	Lore
في النهاية،	Oxir-oqibat,
لذلك،	Shuning
(تفضيلات	(afzal
^)	^),
النجم	yulduzning
ADC	ADC
ثم	so&#39;ngra
(303)488-6120	(303)488-6120
451-0815،	451-0815,
(_______________________)	(_______________________)
اليسار؟	chap?
اليورو بالس)	Evro-urish)
وGT.	chunki&gt;
الحق!	to&#39;g&#39;ri!
(إيثان	(Ethan
يسوع المسيح	Masihga
(مات	(Matt
تريد	qilmoqchi
شكرا لك	rahmat
تخمين	taxmin
على حدة	alohida-alohida
الفطرية	fungal
دخل.	kirdi.
الإسكندينافي	Viking
العصابات.	kengliklarida.
Nagle)	Nagle)
كبير	katta
على &amp; quot؛ اسم	&quot;ism
تفاحة	olma
لوحظ.	kuzatilmoqda.
Atractii	atraction
تركيب	sintez
سيتم احياء	tiriladi
laetril	laetril
تفحص	scan
معلومات	Info
إشعاع	radiatsiya
غبار	chang
جاء	keladi
ماكراي)	MacRae)
نظرة	Look
العلامة &amp; lt؛ 1993Apr17.125545.22457@rose.com&amp;gt.	&lt;1993Apr17.125545.22457@rose.com&gt;
معهد &amp; GT؛	instituti&gt;
(كيث	(Keyt
قتل	qotillik
AIR	AIR
^^^^^^^^^^^^^^^^^^^^^^^	^^^^^^^^^^^^^^^^^^^^^^^
يتحدث	gapirganda
نحن وGT.	biz&gt;
عقد الإيجار	beraman
حورس	Horus
ظهر	ko&#39;rindi
قاس	shafqatsiz
مشاركة في	ishtirok
بائس	bechora
يوسف	Joseph
html>	xx155@yfn.ysu.edu
لقب	nom
خبز	non
حالة	ahvoli
على &amp; quot؛	&quot;savdo
جنسي	jinsiy
مايكروسيستمز	Microsystems
مشكلة	muammo
كم	Qancha
.	ko&#39;ring.
(ريك	(Rick
(437	(437
،	ko&#39;ring,
على &amp; quot؛ &amp; مثل؛	&quot;biz&quot;
اللون	rangi
اعتراف	tanish
بلومبرغ،	Bloomberg,
لا،	hech,
مؤكد	​​muayyan
الفاكس:	Faks:
إدارة	Management
مباراة	o&#39;yinda
باروديا	parodiya
نافذة	oynada
على &amp; quot؛ خاتم	&quot;uzuk,
جزء	qismini
******************	******************
[العظمى	[ajoyib
أخلاق	axloqi
وقود	yoqilg&#39;i
على الطريق	yo&#39;lida,
100 &amp; GT؛	100&gt;
.	chiqadi.
كورينثيانز	Korinfliklarga
الأخلاق]	axloq]
(بريان	(Brian
على &amp; quot؛ الله &amp; مثل؛	&quot;Xudo&quot;
ألف	ming
ولكن،	ammo,
من فضلك	Iltimos
الأرض	Erning
803-654-8817	803-654-8817
قضايا	masalalarni
شعر	sochlari
البريطانيون	British
مراقب	kuzatuvchi
طاقم -man،	inson-Mürettebatlı
آخر	so&#39;nggi
صفحات	sahifalar
رجل &amp; GT؛	erkaklar&gt;
فترات	davrlar
القرار:	qaror:
الاضطرابات	karışıklığından
ملفات	fayllar
معركة	jangda
»	»bilan
اذهب إلى	borish
حقيبة سفر	chamadonni
بعد	qilgach,
مفاتيح	kalitlari
على &amp; quot؛ النسبية على &amp; quot؛	&quot;nisbiy.&quot;
بائع	Sotuvchining
الدول	Shtatlari
لإضافة	kiritishingiz
في التربية	tarbiyalashda
34،839	34,839
جليدي	muzli
sci.crypt	sci.crypt
المبلغ،	miqdorda,
وقد أكد.	tasdiqladi.
ستة	olti
عدد السكان	aholi
تقريبا	Qariyb
عنوان	manziliga
على &amp; quot؛	&quot;yuz
صعب	​​murakkab
جون	Jon
(447	(447
الشرق	sharqdan
غير فعال	samarasiz
جو	Joe
-club	-club
عدوانية	Agressive
الحالات	hollarda,
لا	qilmang
ثاني أكسيد	dioksid
وشاح	tasma
[LDS]	[LDS]
40Meg	40Meg
عينات	namunalarini
تعليم	ta&#39;lim
موزع	distributorga
جرائم الاعتداء	molesters
منافس	Emulator
الأنقاض.	qoldiqlari.
أنباء	Yangiliklar
أطلال،	qoldiqlari,
أصبح	aylandi
الإنفاق	o&#39;tkazgandan
السماح.	chiqaylik.
(أنت	(siz
إلى	qilishingiz
جو)	Ju)
يعني.	anglatadi.
السويد	Shvetsiya
15:	15:
الإنجليزية	ingliz
أوجه القصور	kamchiliklarni
كرامة	qadr-qimmatini
هارفي)	Harvey)
التشفير &amp; GT؛	shifrlash&gt;
باريستا	tinchlikda
150	150
15	15,
يعني؟	anglatadi?
ستانلي	Stanley
الأجهزة	qurilmalar
الجنس البشري	insoniyat
النضالات	kurashsagina
النرويج	Norvegiya
الجهاز،	qurilma,
مسيحي	xristian
وضع	joylashtirish
تفاحة	Apple
أرسلت	yuborgan
بدائي	ibtidoiy
يزارد	Wizzard
أوم	ohm
162	162
صوت	ovozli
(215)645-6463	(215)645-6463
عام	umuman
بكسل	piksel
عذراء	bokira
جدول	Jadvalga
قال: ومثل؛	dedi:&quot;
المباعة.	sotilgan.
أعمال الرسل	Havoriylar
لها	kegani
اعتقد	o&#39;ylaysiz
معلومات)	ma&#39;lumot)
176	176
طيب،	ok,
بحث &amp; GT؛	qidiruv&gt;
دعوة	chaqirib,
170	170
أن	ekanligini
_hard_	_hard_
المسيحيين،	masihiylar,
قدم	tuzildi
أرسلت.	yuboriladi.
التعتيم	örtülmemesidir
الآلهة،	xudolarsiz,
جدا	nihoyatda
بعض	Ba&#39;zi
أنا أكره).	nafratlanaman.)
الكرة	to&#39;pi
مبرر	oqlanishni
الصمت	Sukunatga
لي	Menga
تاريخ	sana
ضروري	zarur
محاط	o&#39;rab,
X-النافذة	X-Window
(Brian@gab.unt.edu)	(Brian@gab.unt.edu)
حياة	hayoti
السطح،	yuzasiga,
الأنهار الجليدية	muzliklarning
[&amp; قووت]؛ يسوع	[&quot;Isoning
على &amp; quot؛ أو	&quot;yoki
رائع	ajoyib
المسيحيين؟	masihiylar?
على &amp; quot؛	&quot;Bir
الأقمار الصناعية	yo&#39;ldoshlarini
حرف	xarakterdagi
وعظ	va&#39;zgo&#39;ylik
(ديفيد	(David
21-22	21-22
عشرة	o&#39;n
المواد وGT؛ &amp; GT؛	moddiy&gt;&gt;
(المشاركة	(post
على &amp; quot؛ نحن	&quot;Biz
مستحيل	imkonsiz
تسرب	oqish
خاص	o&#39;z
لف	wrap,
كارامازوف	Karamazovlar
قطب	pole
اسمك	ismingiz
المرضى	bemorlarga
نوري)	Noring)
20850	20850
خطر	xavf
أمراض	kasalliklarni
html>	cramer@optilink.COM
النجم	Yulduzning
122	122
كوخ	Shack
.	kabi.
أكواب	Mags
اليهودي	yahudiy
تأثير ومثل؛	ta&#39;siri&quot;
فمن المهم.	muhimdir.
الحياة.	hayot.
تخزين	saqlanayotgan
العلامة &amp; lt؛ 1993Apr16.173252.7393@asd.com&amp;gt.	&lt;1993Apr16.173252.7393@asd.com&gt;
مجموعة	guruhi
مثل،	kabi,
العربية،	arab,
بديل &amp; GT؛	muqobil&gt;
120	120
)	kabi)
زحل،	Saturn,
صلاح)	namozda)
كوين)	Quinn)
بيتر &amp; GT؛	Butrus&gt;
خلاط	mikser
المتبقية	qolgan
الأنبياء	Payg&#39;ambarlarni
حساب	Hisoblash
شرح	tushuntirib
فريدمان	Fridman
(408)	(408)
ثم،	Keyinchalik,
المتتبع	Orbiter
كامارينا	Camary
إلى	imkoniyatiga
13	13,
تقع	joylashgan
منها	bo&#39;lganlar
البريد الإلكتروني	Mail
الرحلات	safarlarimiz
إصلاح	isloh
عدم وجود	yo&#39;qligi
إسرائيل	Isroil
------------------------------	------------------------------
العلامة &amp; lt؛ timmbake@mcl.ucsb.edu&amp;gt؛ &amp; GT؛ &amp; GT؛	&lt;timmbake@mcl.ucsb.edu&gt;&gt;&gt;
نظر	ko&#39;rib
خطأ	xato
تقريبا	Taxminan
149	149
14:	14:
********	********
على &amp; quot؛ يسوع	&quot;Isoni
92.8	92.8
خطوط	liniyalari
برنامج	dasturi
اتجاهات	yotoqlari
مدار	orbitasida,
بعيدا	off
مجموعة،	guruh,
140	140
مرض	xastaligidan
ونتيجة ل	oqibatida
عقد	turing
يفتح	ochiladi
فرنسا،	Frantsiya,
جونسون آند جي تي؛	Jonson,&gt;
فرامل	tormoz
توري	Torre
أوروبا	Yevropa
لا أعتقد.	o&#39;ylamayman.
تأمين	xavfsiz
مسيحي	Masihiy
وGT.	qaysi&gt;
أبناء،	o&#39;g&#39;illari,
مرض	Kasallik
سواء	yo&#39;qligini
فخور	faxrlanib,
الجهاز	qurilma
الدراجات النارية	Mototsikllar
ضمن	nazardan
فشل.	olmadi.
ملخص	Xulosa
تعويض	ofset
القديمة	Qadimgi
html>	wagner@mala.bc.ca
على &amp; quot؛ حسابك	&quot;Sizning
برنامج.	dastur.
كبريت	Oltingugurt
إغلاق	yopilishi
(نوريو	(Noring
يتحدث	gapirayotganim
تبدأ	boshlaydi
إذا كان	etsa,
على &amp; quot؛ التشفير	&quot;Shifrlash
هكذا	shunday
ميت	o&#39;lgan
نافذة	oynasi
وGT.	edi&gt;
إنديكا &amp; GT؛	indicting&gt;
نقاط	nuqtalari
معطى	berilgan
دولار	dollar
(	(shunday
النوايا	niyatlarini
LA	LA,
حرفة	CRAF
readiing	readiing
التغيير،	o&#39;zgaradi,
تدفق	oqimi
التطبيق	ilovasidan
OBO	obo
سيطرة	nazorati
أنا سعيد.	xursandman.
في كتاب	kitobida
(تقريبا)	(deyarli)
أسود	qora
الأوعية الدموية،	tomir,
نقرات	tıklatırsa
الإنجازات	yutuqlari
19	19,
قطيع	poda
html>	mouse@thunder.mcrcim.mcgill.edu
Fraering	Fraering
مكاتب تمثيلية	vakolatxonalari
(أوه،	(Oh,
VESA	VESA
دقيقة	daqiqa
أعضاء	a&#39;zolari
RA &amp; GT؛	RA&gt;
بكتيريا	bakterial
نصب	pitching
يسوع المسيح	Masihni
ولكن!	balki!
الدعم	qo&#39;llab-quvvatlaydi
عتيق الزي	Qadimiy
كوكب المشتري،	Yupiter,
الهرمية	ierarxik
19:	19:
الوديان	vodiylarda
يشاء.	berur.
أغلبية	Aksariyat
نفسه	o&#39;zini
ولكن،	balki,
انتهى	tugadi
احتياطي	zahirasini
تحقيق	tergov
هالي	Halley
المعالجين	Tabiblar
أن	Deb,
مجانا،	bemalol,
محترف	professional
أدوات	vositalari
نبي	payg&#39;ambar
العلامة &amp; lt؛ C51nLs.7As@boi.hp.com&amp;gt.	&lt;C51nLs.7As@boi.hp.com&gt;
تريليون	trillionth
27.2.	27.2.
على &amp; quot؛ ماجيك ومثل؛ &amp; GT؛ &amp; GT؛	&quot;Magic&quot;&gt;&gt;
الجراحية،	jarrohlik,
في الجزء العلوي	yuqorisida
مزايد	talabgor
(CAL).	(Tinglash).
قرأ	o&#39;qildi
اترك	chiqishidan
زئبق	Mercury
بويد	Boyd
إيجابي	ijobiy
هو ليس كذلك.	emas.
ليس	emas,
VE7GDA	VE7GDA
التحليق	rishiz
---------------	---------------
على &amp; quot؛ معاول	&quot;eshkaklar
ألغيت	bekor
الكويكبات	asteroitler
ليس)	emas)
LDS	LDS
NOT	BO&#39;LMAGAN
الجحيم &amp; GT؛	Jahannam&gt;
التي	boshlagan
إطلاق	tushirilishi
توقفت.	to&#39;xtadi.
الصمام	LED
منطق	mulohaza
مصطنع	sun&#39;iy
الشرقية	qismida
أليس كذلك؟	emas?
ليل	tunda
إقامة	turish
لحظة	oniy
لا؛	emas;
مناطق ومثل؛	viloyatlariga&quot;
على &amp; quot؛ &amp; ذاتية مثل؛	&quot;sub&#39;ektiv&quot;
html>	Lvc@cbnews.cb.att.com
~~~	~~~
الناس	xalq
عرقي	Millatiga
استخدام	ishlatish
الإنفاق	sarf
الخليط.	aralashmasidir.
مباشرة	to&#39;g&#39;ridan-to&#39;g&#39;ri
حماية	himoya
وGT.	olish&gt;
كين	Ken
سلسلة	qator
يزيد.	oshiradi.
أرسلت.	yuborilgan.
أدخل:	kiriting:
فينوس،	Venera,
مات	Matt
ل	chunki
المخفية.	yashiringan.
عالم الفلك	astronomi
القليل	oz,
مدرب	murabbiyi
الفرق	farqni
مظهر	ko&#39;rinishi
gravitacional	gravitacional
العلامة &amp; lt؛ 1993Apr4.221228.17577@bsu-ucs&amp;gt.	&lt;1993Apr4.221228.17577@bsu-ucs&gt;
يمكن عزوها	kuzatilishi
وGT.	ovoz&gt;
كامل	to&#39;laqonli
بهدوء	ohista
جملة	gapning
الشعب	odamlarga
(Liscened	(liscened
الآن	endi
فحص	ko&#39;rikdan
اللعب.	o&#39;ynaymiz.
خاصة	Ayniqsa
حظا سعيدا!	tilaymiz!
شهر	oy,
سرعة	tezlikda
DA &amp; GT؛	ULARNING&gt;
عدد	raqamini
تنمية	rivojlanishi
الهيكلية وGT.	tizimli&gt;
عاصفة	Bo&#39;ron
(جوردون	(Gordon
(510)	(510)
صالون &amp; GT؛	o&#39;tib&gt;
سأل.	so&#39;radi.
على &amp; quot؛ المرض	&quot;kasallik
القابلة لإعادة الشحن	Rechargeable
الدول الاسكندنافية	Scandinavians
الفلكي،	astronom,
جزء	qismi
وتجدر الإشارة إلى أنه،	kerakki,
يرعى	cho&#39;ponlik
طيران	uchib
صحيح،	rost»,
خلافا ل	farqli
على &amp; quot؛ التحفيز ومثل؛	&quot;rag&#39;batlantirish&quot;
البقاء!	qolish!
html>	astein@israel.nysernet.org
المادية	jismoniy
كيف	Qanday
غالية	qimmat
طبيب	shifokorga
تكنيك &amp; GT؛	Texnikaning&gt;
الامتثال	muvofiqligini
واحدة من	biridan
المدار	orbita
ضيف	mehmon
100،000	100,000
سابق	sobiq
تطلب	so&#39;rashi
قلب	xafa
عندما	Qachon
عين	ko&#39;z
غير مصرح بها	ruxsatsiz
التعبير	Express
نفسه	o&#39;ziga
لا ننسى.	unutmang.
مثل	singari
إنفينيتي	Infiniti
يسوع المسيح	​​Masih
أوربت	aylanishlar
آخر	o&#39;zga
عرعر.	izlaydi.
روسيا	Rossiya
المذنب	kuyruklu
تقنيات	metodlarni
الذي	Kim
الذئاب	bo&#39;rilar
ثابت	sobit
فعل.	qilmadi.
html>	scott@asd.com
(الفلكي	(astronomik
لم أكن	qilmadi,
تأمين	sug&#39;urta
مقالة	Maqolada
مقالة	Maqola
أداء	ishlashi
جديد	yangi
(يوحنا	(Yuhanno
فوق	tepasida
26/01	1-26
كيبلينغ	Kipling
مجنون	aqldan
على &amp; quot؛ &amp; الرياضة مثل؛	&quot;sport&quot;
مسيرة	mart,
كان	etildi
حيث	Qaerda
أزرق	ko&#39;k
البقاء على قيد الحياة	omon
html>	starowl@rahul.net
BAND	tasmasi
كثير	ko&#39;p
المعاني	ma&#39;nolari
قبل	avval
المفارقة	paradoks
مزمن	surunkali
مطالبات)	so&#39;rash)
الحاجة إلى	zarurligini
باختصار	qisqa
أنا نفسي	o&#39;zim
التي	bo&#39;lgan
Q4،	4-savol,
سوق	bozor
واحد	​​bir
مقبول	ma&#39;qul
قطرة	qatra
وتد	qozig&#39;ini
بالنسبة	nisbiy
تسجيل	yozuvlar
الناس	odamlarni
..:.:	..:.:
(آلان	(Alan
تدفق	oqib,
جوردون	Gordon
نظرا ل	tufayli
عادة،	hodisaga
قمري	qamariy
ميكروفون	Mayk
في	o&#39;zida
متغير	o&#39;zgaruvchan
reparented	reparented
موثوق	ishonchli
كان،	qilindi,
.	qilindi.
بنديكت السادس عشر	Benedikt
لوحات	plitalarning
بعد	Keyin
PB170	PB170
الناس	xalqining
مرات	marta
مرافقة	hamrohlik
(أبريل	(aprel
لانهاية	Infinity
M.)	M.)
القوارض	kemiruvchilar
خارج	out
الرجل،	Man,
(	(tez
&#39;الله	«Xudo
حزيران	iyun
إرسال.	yuboring.
الغرور،	betayin
تصادم	to&#39;qnashuv
اضطراب	Jo&#39;sh
أفضل	yaxshiroq
نصف	bir-yarim
فولتس	Folta
كلمة	so&#39;z
(A	(bir
عالية.	yuqori.
حقيبة	xalta
أبيض	oq,
عظيم	katta,
تجربة	tajribasiga
تمشيط	supurib
مريض	kasalman
عظيم.	katta.
عالية،	yuqori,
تم العثور عليها.	topdik.
درقي	qalqonsimon
(نحن	(biz
html>	bep1@cbnewsg.cb.att.com
السليكات	silikat
غريب	g&#39;alati
الثقة	ishonchni
على الرغم من	qaramasdan
ملك	Shoh
خطوة	ko&#39;chib
العلامة &amp; lt؛ lsj4ruINNl7o@saltillo.cs.utexas.edu&amp;gt.	&lt;lsj4ruINNl7o@saltillo.cs.utexas.edu&gt;
له	uning
وثني	majusiy
ريفز)	Reeves)
&quot;.	&#39;edi.
ل	oldiga
1-2	1-2
10	10,
كور	Kor
ملامح	xususiyatlari
من فوق	yuqoridan
الإعدادات	sozlash
روث)	Erog&#39;lu)
(مالكولم	(Malcolm
intollerent	intollerent
جونسون)	Jonson)
الرسول	Havoriy
جونسون،	Jonson,
كو	Kou
قديس	saing
جلب	keltira
بواسطة	oldida
البحث.	tadqiqot.
الملكية.	egalik.
100	100
الأماكن	joylarini
يتحدث	gapirib
أبناء &amp; GT؛	o&#39;g&#39;illari&gt;
وضع	qo&#39;ymaguncha
طيران	uchayotganda
ادمونتون	Edmonton
الحجر،	tosh,
فاكس	faks
فيكا	Vica
نجل ومثل؛	O&#39;g&#39;li&quot;
مروحة.	fan.
02/01	1/2
حديث	munozarasi
طبيب	tabib
إلكتروني	Elektron
التوزيع	tarqatish
الجبهة	old
نفقات	xarajatlarni
الناس	odamlarda
وصلنا.	oldik.
المعيشة	yashash
على &amp; quot؛ &amp; مثل المصطلحات.	&quot;jargonu&quot;
على الخط	on-line
جاهل	clueless
سكين	Pichoq
معنى.	ma&#39;nosidir.
(غاري	(Gary
إرسال.	yuboraman.
حساس	sezgir
يخاف من	qo&#39;rqdilar
وقال: &amp; GT؛ &amp; GT؛	deydi:&gt;&gt;
آدامز)	Adams)
ارتفاع	ko&#39;tarilgan
أقرب	yaqinmiz
دائرة كهربائية	tutashuv
درجة الحرارة	harorati
شجار	Tiff
برنار)	Bernard)
عالمي	global
_National	_National
بعد	keyin
MIniVas	MIniVas
أربعة	to&#39;rt
مقبولة	muhosaba
وجه	yuziga
الأم	Onadan
قتل	o&#39;ldiradilar
أم	ona
بوريش	Bures
حزيران	Iyun
ركود	tushish
على &amp; quot؛ T &amp; مثل؛	&quot;T&quot;
Assouline	assult
وأنا أفهم	tushundim
شراء	sotib
مسيرة	Mart
المريخ	Mars
كولينز &amp; GT؛	aslida&gt;
اتجاه	yo&#39;nalish
ركوب الخيل	minib
ثلاثة	uchta
الحرف	hunarmandchilik
بلومبرغ	Blomberg
1.1	1,1
مخول	vakolatli
علامة	Mark
.	eng.
مؤشر	indeksi
ليس	kelmagan,
البنى التحتية	infrastrukturaning
أرض	yuzida
1.3	1,3
منتصف عام 1993	o&#39;rta-1993
نشط	faol
tvtwm	tvtwm
أساسيات	asoslarini
رفض.	rad.
كتب ما يلي:	yozadi:
حفظ	saqlab
درجة الحرارة،	harorat,
تمزق	sug&#39;urib
ترويج	rag&#39;batlantirish
نجاح	muvaffaqiyat
GIF،	GIF,
حتى	gacha
زحل	Saturnning
.	ko&#39;ra.
RED)	rad)
وفقا ل	ko&#39;ra,
صارم	qat&#39;iy
يكتب.	yozadi.
إلى	uchun
حاد	o&#39;tkir
مراقبوا النجوم	stargazers
ExposureMask	ExposureMask
هل تعلم؟	bilasizmi?
تشكيل	shakllantirish
الغلاف الجوي،	atmosfera,
المالك	egasining
بشري	inson
لأن	Chunki
الأعراض.	alomatlar.
عداء	adovat
الثيموثية عشب	Timo&#39;tiyga
حجم	hajmining
له	Uning
(الحالات	(hollar
(38.8	(38,8
الألوان	ranglar
موضوع	ob&#39;ekt
نيل	Neal
ربيع	bahor
أقول.	aytish.
إدارة	boshqarish
أقول،	aytish,
الكنديين:	Kanadaliklar:
سوريا	Suriya
كبرياء	faxr
vshield	vshield
وGT.	ular&gt;
الأماكن	joylarda
iconified	iconified
...	...
ثم،	So&#39;ngra,
فانغ)	Fang)
نبتون	Neptunning
وهذا هو،	Ana,
يوروسبورت	Eurosport
..:	..:
ومثل؛	sotib&quot;
الغرب الأوسط	Midwest
تشبرياني)	Cipriani)
الأماكن	joylarga
انتقال	o&#39;tkazish
مريض	kasal
بين	o&#39;rtasida
أشار.	ta&#39;kidlanadi.
رطانة	jargon
الرب	Rabbiyning
وكالة الطاقة النووية.	Nea.
إبط	qo&#39;ltiq
كلمة	Word
قول	aytishi
* &amp; طن.	*&gt;
LGBT	jinsdoshlarini
على &amp; quot؛ أنت ومثل؛	&quot;Siz&quot;
إضافة.	qo&#39;shing.
السماء	osmonni
مقرف	jirkanch
موحل	loyqa
القانون	Qonunda
من ناحية،	jihatidan,
جثث	organlarining
من يدري	biladi
لاري	Larri
بعد	so&#39;ng,
جانبا	surib
نفى.	inkor.
لا	bermaydi
أووزيد	oozed
م.	yashayman.
أولئك الذين	qilganlar
الهوكي،	xokkey,
ثم.	so&#39;ng.
أفضل الممارسات البيئية)	sudlanuvchi)
أكثر من	ortiq,
كمبيوتر	kompyuter
كان	qilinganidan
إسهام	hissa
اذهب الى الأسفل	tushing
تقرير	belgilash
خارج	tashqariga
بما في ذلك،	jumladan,
لي.	menga.
محطة	terminal
المغرب	Marokash,
رقاقة	yonga
لحم	tana
مرض	kasallik
الشجب	kınanması
كاف	yetarlicha
وGT.	bo&#39;lish&gt;
الجلوس	o&#39;tirgan
سماء	osmon
على مشارف	etagida
سحابة	Cloud
علامات	belgilari
إنفاق	sarflayapsiz,
لماذا	Nega
كم عدد	qanchadan-qancha
شامل	batafsil
ارتفاعات	balandliklardan
الدول	States
أولئك الذين	bo&#39;lganlarga
فهم.	tushunmadilar.
كارس	-Karl
على غرار	o&#39;xshaydi
وأنا أعلم)	Bilaman)
السطوح	qirish
(جميع	(hammasi
قوة	kuchi
(ما لا يقل عن	(kamida
الشك	Skeptitsizm
ونتيجة لذلك،	Natijada,
بريندان	Brendan
.	qilamiz.
أكثر كثافة	zichroq
أمي	o&#39;qimagan
سنوات من العمر	yoshgacha
الاستشارات	Consulting,
العلامة &amp; lt؛ 15464@optilink.COM&amp;gt.	&lt;15464@optilink.COM&gt;
فرق	farq
ولكن وGT.	lekin&gt;
وقال: &amp; GT؛	deydi:&gt;
تسعون	to&#39;qson
يوم	Kun
سمع	eshitish
HELP:	HELP:
خلافات،	ixtiloflar,
KALDILDI	Kaldis
بحار	Mariner
صورة	tasvir
خارج	tashqarida
مساعدة!	yordam!
SAP،	dastani
بحث	tadqiqotlarning
غني بالألوان	rangli
المرضى وGT.	bemorlarni&gt;
الجنس ومثل؛	sex&quot;.
أمراض	«kasalliklar
أعتقد.	o&#39;ylaydi.
سوف	Qiladi
مساعدة	yordam,
علم	xabardor
وجه	yuzi
اكتشف	kashf
أجزاء	qismlar,
ميراندا	Miranda
ترك	tark
جمهور	jamoat
أنا &amp; GT؛	emasman&gt;
وسوف.	beraman.
تقع	kuz
مشاهدة &amp; GT؛	tomosha&gt;
يوم	kun
التشخيص	tashxis
نقد	yonilg&#39;i
يجري	oshirilmoqda
BC	miloddan
تحليل الشفرات،	kriptoanaliz,
html>	mls@panix.com
حالة	holda
الساقين،	bukilib-bukilib,
،	ketgan,
لي	Lee
انحلال	tarqatib,
الناس	odamlar
خط	chizig&#39;i
وGT.	joy&gt;
تطبيقي	qo&#39;llanilishi
و&amp; GT؛	bir&gt;
الصحة	sog&#39;liqni
وGT.	qilib&gt;
خطر	tavakkal
واقعي	virtual
حول	haqda
: &amp; GT؛ &amp; GT؛	bo&#39;lishi:&gt;&gt;
إنجلترا	England
Thorson)	Thorson)
شابيرو)	Shapiro)
أزرار	tugmalaridan
(الحقيقة)	(Haqiqat)
مستحق	loyiq
وثب	Bounce
الأعراض	alomatlar
مثليون جنسيا،	gomoseksualistlar,
Dr.Banzai	Dr.Banzai
نغمة	ohangini
(0،0)	(0,0)
........	........
مؤسسة	muassasada
الدعم)	Support)
الإفراج)	relizlar),
إعادة تشغيل	restart
حركة الديمقراطيين الاشتراكيين	MDs
.	kerak.
الحرف	hunarmandlikni
،	kerak,
أجزاء	qismlari
0.45	.45
هيدروجين	Vodorod
html>	dbd@icf.hrb.com
اختصارات	klavishlar
بالأحرى	afzal
طيران	Aviatsiya
رمز	kodini
وحيد	yakka
الميثان،	metan,
تحتاج؟	kerak?
1-800-344-4539.	1-800-344-4539.
الأسواق	bozorlarida
؛	kerak;
معدن	metall
400 &amp; GT؛	400&gt;
MC)	MC)
الماجستير	ustalari
تشاور	maslahatlashing
استخدام	Foydalanish
ثانيا،	sekundiga
روبين)	Rubin)
ترقيات	yuksaltirish
القانون	Qonunga
FJ1200 &amp; GT؛	FJ1200&gt;
حالة	holat
أخلاقيات ومثل؛	axloq&quot;.
حجة	argument
لم يكن لدينا	demadi-ku
X11R5	X11R5
X11R4	X11R4
أقترح.	fikrdamiz.
تيار &amp; مثل؛	amaldagi&quot;
.	qilinishi.
الألومنيوم،	alüminyumdan
عندما	olganda,
كهربائي	elektr
زميل	yo&#39;ldoshlar
مرشح	filtri
نقيب	miqyosda
html>	kmac@cisco.com
مختبر	laboratoriya
في المقابل،	o&#39;laroq,
(&amp; طن.	(ning&gt;
html>	hal@cco.caltech.edu
الأميركيون	amerikaliklar
الإجراء ل	tartibi
من السهل.	osondir.
المجالات	sohalari
قسم.	dept.
الاسترخاء.	topdingiz.
(على سبيل المثال،	(aytaylik,
مشكوك فيه	shubhali
التقدير.	minnatdor.
تلقي	olgandan
تقدير	minnatdor,
8000	8000
المذنب	Kometa
لا	kelmaymiz,
html>	joshuaf@yang.earlham.edu
الرواد	Kashshoflar
ملف	fayl
SETVER.EXE	SETVER.EXE
على &amp; quot؛	&quot;o&#39;sha
html>	munns@cae.wisc.edu
وأود أن	istayman
نموذج	Model
البريد الإلكتروني	e-mail
IMHO	IMHO
مربع	maydonida
الهروب،	qochish,
المريخ	Marsda
ملامح؛	xususiyatlari;
تحقيق	ro&#39;yobga
html>	Steve.Shapiro@f440.n101.z1.fidonet.org
برينر)	Brenner)
فرنسا	Fransiya
سنوات	yillarning
ستباع	sotiladi
Siemon	Siemon
الميزات.	xususiyatlari.
ملامح	xususiyatlari,
أجزاء	qismlar
البوب ​​ومثل؛	pop&quot;.
انهيار	parchalanib
معدات	uskunalar
على &amp; quot؛	&quot;qismiga
يسوع)	Isoning)
XR250L	XR250L
أندرياس	Andreas
الكويكبات	Asteroitler
سبب	kelishi
يأتي،	kelsa,
لو!	Lo!
(خوان	(Xuan
تيرا	Terra
قائمة	ro&#39;yxat
المورمونية	Mormonizm
ساكن	statik
لويس &amp; GT؛	Luis&gt;
طين	loy
وبطبيعة الحال،	albatta,
بندقية	miltiq
بالطبع.	albatta.
باتريشيا	Patricia
على &amp; quot؛ النظامية ومثل؛	&quot;tizimli&quot;
خردة	arzimas
إرهاب	Terrorizmga
حدث	ro&#39;y
لاعب.	futbolchi.
وGT؛ &amp; GT؛	yilda&gt;&gt;
هل أنت الغريب.	berasiz.
سكرتير خاص	p.s.
العلماء	Olimlar
خميرة	xamirturush
التي	boshladi
(عذرا،	(Uzr,
صيغة	formuladan
العلامة &amp; lt؛ Apr.9.01.09.22.1993.16580@athos.rutgers.edu&amp;gt.	&lt;Apr.9.01.09.22.1993.16580@athos.rutgers.edu&gt;
مجنون	ahmoq
حصة	baham
كيس الهواء	havo-paket
وطن.	Ulardan&gt;
قتل	o&#39;ldirilgan
اليابانية	Yapon
الأسيتيلين،	atsetilen,
تمهيد	reboot
المسائل	holatlardan
أصلي	original
توري	torre
سيئة	yomon
نيسان	nissan
هو.	bo&#39;lishidir.
حقا؟	albatta?
التشابه	o&#39;xshashliklar
إلى	qilishi
خفي	ko&#39;rinmaydi
مهمة	Missiya,
سيسكو	Cisco
معلومات	axborot
]	qilish]
لين	Lin
فتح	qulfni
مرحبا،	Salom,
أن تكون	bo&#39;lishi
المتصفح	brauzer
الحقل وGT.	Voizlik&gt;
Korenek	Korenek
(ريان	(Ryan
مربع	maydoniga
southeners	southeners
_ARE_	_ARE_
هامشي	chekka
البراكين	vulqonlardan
٪: &amp; GT؛ &amp; GT؛	foizi:&gt;&gt;
ربما	ehtimol,
الإنسان،	inson,
أسلحة	qurollar
مدار	orbitasining
زينت.	bezatilgan.
html>	192.100.81.100
المريخ	Marsga
.	qilish.
3 ومثل،،	3&quot;,
إلى	qilish,
نوافذ	derazalar
html>	lmh@juliet.caltech.edu
سحر	sehr
.	bo&#39;lish.
الآن،	endi,
نقطة	nuqtasi
مكبر للصوت	yükseltici
تلسكوبي	teleskopik
ليست	emaslikda
الاتحادية	federal
ديفيس	Davis
الإنترنت:	Internet:
كوكب	sayyoramizga
واضح	Aniq
تم التوصل إليها.	yetib.
إعادة تعمير	repopulation
بعد كل شيء،	Axir,
اللاعبين	futbolchi
البريد الإلكتروني:	Mail:
تحت تأثير	ta&#39;sirida
،	bo&#39;lish,
ومن المقرر	lsa
حزم	o&#39;rash
ديفيد	David
إمكانية	ehtimoli
كانون الاول	Dekabr
(Starowl@a2i.rahul.net)	(starowl@a2i.rahul.net)
(الرجاء	(iltimos
زيادة	oshirish,
بين	orangizda
الوزن،	og&#39;irligi,
وGT.	kabi,&gt;
تفسير	tushuntirish
النظام الكواكب	Planetoloji
PCX،	PCX,
صلة	aloqa
الظهر ومثل؛	Orqaga&quot;
؟؟؟	???
الطبيب ومثل؛	tabib&quot;
(مساعدة!)	(Yordam!)
الفطرية	zamburug&#39;li
5-7)	5-7)
سخي	saxiy
تأثير	ta&#39;sirini
عقد	turing,
العلامة &amp; lt؛ May.7.01.08.16.1993.14381@athos.rutgers.edu&amp;gt.	&lt;May.7.01.08.16.1993.14381@athos.rutgers.edu&gt;
الرسل،	havoriylar,
الموثوقية	ishonchliligi
الفيضانات،	sel,
جون	Yuhanno
عبء	yuki
بيتسبرغ	Pitsburg
موشور	Prism
تقدير	baho
على &amp; quot؛ شراء	&quot;Buy
الأنهار الجليدية:	muzliklarning:
(225	(225
أشياء	Things
السماء	osmonda
ن	qarsillamoq
أنت	sizlarga
قطعا	Albatta
بعدها،	Beyond,
خلق	yaratilgan
رجل	kishining
الآن.	endi.
NatLamp	NatLamp
بوكي	Bucky
جنس	jinsi
،	holda,
شفاعة	shafoatga
المعلمات	parametrlarini
حجم الأسرة	uy-o&#39;lchamli
5-6.	5-6.
بالكاد	zo&#39;rg&#39;a
N81	N81
)	holda)
كانافيرال	Canaveral
ميناء	port
لا	qilmasa,
نحن فخورون	faxrlanamiz
... وطن.	...&gt;
أمير	shahzoda
الورم.	shish.
الحديث	gaplashib
لزج	yopishqoq
مداري	orbital
مرة	safar
التداول	muomalasi
المرضى	bemorlarni
الركاب	Yo&#39;lovchilardan
الوفاء	bajo
غازي	gazsimon
).	deb).
بعد	post
(الحياة	(Life
مؤخرا	yaqinda
زجاج	shisha
(الغربية	(g&#39;arbiy
html>	m-it2691@DOC.CS.NYU.EDU
إذا كنت	ekansiz
المماس	chiziqlarga
سوق	bozorida
نرى.	qarang.
أنت	seni
وكالة ناسا	NASA,
الصور	fotosuratlarni
(إن الشمس	(quyosh
زوج	er-xotin
ماذا؟	Nima?
جمعية خيرية.	xayriya.
أسرار	sirlarini
سنتا	sent
رواية	Roman
ما	Nima,
--------------------------- وطن.	---------------------------&gt;
وأنا أعلم.	bilaman.
html>	folta@well.sf.ca.us
على &amp; quot؛ من المرجح	&quot;munosib
ميت	O&#39;liklar
دواسة،	pedalına,
قاحل	bepusht
Landmann)	Landmann)
مع	bilan,
.	bilan.
وأنا أعلم،	bilaman,
فلسطين	Falastinda,
الكتابة،	yozishni,
Symbolisme	symbolisms
(بليز	(Blez
)	bilan)
Tidser	TIDSA
عاج	dentin
تريتون نصف إله عند الإغريق	Triton
كورف	kuchining
رأيك؟	o&#39;ylaysiz?
الإحداثيات	koordinatalarini
لعموم أوروبا	Pan-Evropa
1742	1742a
على &amp; quot؛ ستاندرد اند مثل؛	&quot;standart&quot;
محطم	soluvchi
حاجة	muhtoj
انضباط	intizom
اثنين،	ikkala,
حساسية	jilo
المسيحيين	Masihiylar
لوك	Loc
رود ايلاند	Aylend
؛ &amp; GT؛	bo&#39;ladi;&gt;
===================================	===================================
(800)	(800)
غير مستقر	beqaror
المعيار،	standart,
عام	umumiy
ماجلان	Magellan
مضحك.	kulgili.
لعب	o&#39;ynashga
كارون	CHARON
بطاقة	karta
مصادر	manbalarini
ملايين	millionlab
welshed	welshed
متموج	dalgalıdır
من	boshlab,
Schaufenbuel)	Schaufenbuel)
الأعداء	dushmanlari
إساءة	suiiste&#39;mol
يتجمد،	qaytmoqda,
LM350T	LM350T
دعا	nomlangan
نفقة	hisobidan
الطريق	yo&#39;lini
العشوائية،	randomize
أعتقد،	ishonaman,
مصدر	manbaidir
أن تكون	bo&#39;lish
نظام	tizim
صاحب العمل	beruvchi
أعتقد ذلك.	ishonaman.
معارضة	qarshilik
ظننت	o&#39;ylardim
أنواع)	turdagi)
تعقيد	murakkabligi
اقتراح	taklif
خطب	Va&#39;zi
فعل	qilyapsan,
به.	qilyapsan.
فولت	voltgacha
الغنية بالحديد	temir-boy
18EB	18EB
(النرويج)	(Norvegiya)
وطن،،	&gt;,
مونتي،	o&#39;rnatilgan,
نقطة	nuqtaga
تواضع	kamtarlik
القيام &#39;	qilyapsiz»,
بالتأكيد	amin
Postbus	Postbus
شخصية	shaxsi
يمين	qasam
كتلة	ommaviy
على &amp; quot؛	&quot;hal
تهمة.	tariflanadi.
{UUNET	{uunet,
مريح	qulay
خروج	Chiqish
بخار	bug&#39;ining
الإلحاد	ateizm
قلعة	fortay
وأوضح	bayon
حياة	hayotimda
-km	-km
///	///
سلوك	Boshlovchi
موسى	Musoning
MC05A	MC05A
.signature	.signature
(التالي	(keyingi
ظروف	vaziyat
المجموعة الاستشارية للألغام	mag
قشرة	Rind
تناوب	aylanish
لقاء	kutib
تعرف	bilingki
نهر	River
رجل	man
الساقين	oyoqlari
عودة	qaytishingiz
المريض	bemorning
(بيلي	(Billy
ومن	etiladi
إنتاج	chiqarilishi
الحواسيب الشخصية	shaxsiy-kompyuter
عجلة	g&#39;ildirak
العرض.	etamiz.
Bosham	izsiz
طالما	modomiki
المخالفات و GT.	nosimmetrikliklar&gt;
سرعة	tezligini
مات &amp; GT؛	Matt&gt;
عمال النظام)	hizmatkorlari)
10--	10--
هوندا	Xonda
html>	gt4417a@prism.gatech.edu
بنطلون الجينز	gravitatsiyaviy
MWM	MWm
وجود	mavjudligining
الموتى	o&#39;likdan
زحل	Saturn
أقول،	aytaman,
نقطة	nuqtada
سمعت.	eshitdim.
النقصان.	tushiradi.
بورلاند	Borland
مرة واحدة،	marta,
المعرض	Expo
تحليل	tahlil
مرات.	marta.
المولدات الكهربائية،	generatorlari,
اللاجئين	qochqinlar
بالإضافة إلى ذلك،	tashqari,
)	tashqari)
محطة	Terminal
الدوافع	niyatlarda
نيابة	nomimdan
على &amp; quot؛ فاز ومثل؛	&quot;kaltaklashdi&quot;
لكن	ammo
الشهر.	oylik.
الحديث و GT.	gapiryapsiz&gt;
(تحديث):	(yangilash):
سنوات	yoshda
الكهروميكانيكية	elektromexanik
**************************************************	**************************************************
وأنا أعلم	bilaman
EISA	EISA
خطأ	Xato
(كيف	(Qanday
كشف	vahiy
الهيئات	organlari,
الانتقال السريع ل	harakatlanish
غريغوري	Gregory
-------------------------------------------------	-------------------------------------------------
الظلام،	qorong&#39;u,
(إلين	(Elaine
كهرضوئي كهربائي ضوئي	fotoelektrik
احتيال	hünirini
الموت	o&#39;limi
النظر في	inobatga
أجهزة الاستشعار	datchiklari
أنا	men
مضيف	mezbon
لا يمكنك العثور على	topmasangiz
مرات)	marta)
مواز	parallel
الأسئلة	savollarga
آخر	oxirgi
صخرة	qoyaga
رحيل	ketish
إشارات	signallari
علماني	dunyoviy
مرة أخرى))	yana))
المذنبات،	kometalar,
ممارسة &amp; GT؛	amaliyot&gt;
___________________	___________________
مسح	so&#39;rovda
تحقيق	erishish
ولكن وGT.	ammo&gt;
الموت.	o&#39;lim.
html>	lmh@shakes.caltech.edu
رقائق،	chips,
وعود	va&#39;dalari
جوشوا	Joshuaf
قميص	ko&#39;ylak,
الهدف	maqsad
صفقة	bitimi
الزوج	xotin
لوحظ.	kuzatilgan.
أسود	qora,
أنا	Men
23:17:25	23:17:25
كما	go&#39;yo
html>	Cl056@cleveland.Freenet.Edu
العلامة &amp; lt؛ pgf.735012282@srl03.cacs.usl.edu&amp;gt.	&lt;pgf.735012282@srl03.cacs.usl.edu&gt;
عظيم	Great
التجزئة	dileriga
رفيق	sahobaning
هل؟	Sizchi?
ميج	Meg
يعيش.	yashamadi.
إضافي	qo&#39;shimcha
تصرف بطريقة صحيحة	pokiza
كوكب	sayyoramizni
الصور	suratlarni
رياح	Shamol
NHL	NHL
وGT.	bu&gt;
sattellite	sattellite
كوبونات	kuponlar
إضافة	qo&#39;shish
تورونتو	Toronto
&#39;جميع	«barcha
ينبغي	lozim
المعلم،	o&#39;qituvchi,
المدخلات وGT.	kirishlar&gt;
البحارة	Mariners
تقاليد	an&#39;analarini
القنوات	kanallari
مستقبل	Future
هراء	saçmalýklarý
EUROPA	EUROPA
قسيس بروتستانتي	Parsli
الكوكب،	sayyora,
الدولة.	davlat.
الكوكب.	sayyora.
غوثري	Guthrie
ليس	bo&#39;lmasa
الملحد	ateist
حول	haqida
خواتم	halqalarni
نوافذ	Windows
المخطط	rejalashtirilgan
نقل	tashish
المدخلات	kirishlar
علاج	davolash,
(السلع	(tovarlar
بيولوجي	biologik
الأجسام	ob&#39;ektlarini
قسم	bo&#39;limi
العلاج)	davolash)
تطلب	so&#39;raysizlar
أزرار	tugmalari
مفلس	bankrot
لا يزال قائما.	qolmoqda.
المنحدرات	cliffs
ويليامز	Williams
فرد	individual
قطعا	albatta
SMARTDRV.EXE	SMARTDRV.EXE
قراءة المزيد.	o&#39;qing.
النوى	yadrolari
جريج،	Greg,
^^^^^^^^^^^^^^^^^^^^^^^^^^^^^	^^^^^^^^^^^^^^^^^^^^^^^^^^^^^
العروض	etadi
العلاجات	yordamni
خارج	olib
html>	km@cs.pitt.edu
كيفن	Kevin
عروض	ko&#39;rsatadi
سرعة	tezlik
البعثات	missiyalari,
رجل	Man
أمريكي	amerikalik
بحار	Mariner,
مثال	Misol
NCI	NCI
)	etiladi)
تشكيل	shakllantirish,
ماك	Mac
تجارب	tajribalar
هو،	etiladi,
رأي	versiya
الملصق	plakat
.	etiladi.
كلمات &amp; GT؛	va&#39;dalari&gt;
الماضي	o&#39;tmish
ينقل	uzatadi
مسيحية	Xristianlikni
عناصر	elementlar
أقل من	Pastda
html>	rls@uihepa.hep.uiuc.edu
الحق،	to&#39;g&#39;ri,
لوحة المفاتيح،	Klaviaturadan,
السماح.	qoldirardi.
قريبا	o&#39;tmay
معاداة أيام	anti-kun
مايو	May
مستقبل	kelajak
على افتراض &amp; GT؛	faraz&gt;
استهلال	boshlash
أنا لا أفهم.	tushunmadim.
html>	ethan@cs.columbia.edu
عالم	olim
NET	NET
الناس	kishilarga
تخزين	saqlanishi
بعيد	olis
الرياح	shamollarni
البرتقالي	apelsin
(بنديكت السادس عشر	(Benedikt
مؤكد	muayyan
[الإنسان]	[insoniyat]
سامي	oliy
الارتياح.	qondirish.
آخر	so&#39;nggi,
الموتى	o&#39;liklarni
إقامة	qolish
مدرس	tarbiyachimiz
سلطات	hokimiyat
،	ushlab,
--------------------------------------------------	--------------------------------------------------
و &amp; GT؛	va&gt;
مدينة	shahrida
فرق	jamoalarning
كوخ	shack
وطن؛ &amp; GT؛ &amp; GT؛ &amp; GT؛ &amp; GT؛	&gt;&gt;&gt;&gt;&gt;
إغلاق	yopish
نشاط	faoliyat
الموت	o&#39;lim
ميت	o&#39;lik
على طول	bo&#39;ylab
1970	1970
مساهمة	Kirish
ويسعدني	xursandman
في:	ichida:
1971	1971
وفقا لذلك،	doirada
قرار	qaror
1972	1972
1973	1973
1974	1974
1975	1975
(إعادة:	(Re:
1976	1976
شخص ما	birovga
1977	1977
1978	1978
1979	1979
)	ichida)
سرا	yashirincha
أدوات	Instruments
الدفع عندالتسليم	C.O.D.
حفرة	chuqurga
_____________________________________________________________________	_____________________________________________________________________
تعلمت.	o&#39;rgandim.
- وطن؛ &amp; GT؛	-&gt;&gt;
المركبات	aralashmalar
1990	1990
alyoung@kiwi.ucs	alyoung@kiwi.ucs
رأي	ko&#39;rinish
بضائع	mol
الدول	mamlakatlarida
1983	1983
1980	1980
1981	1981
طبيب	shifokor
1986	1986
ذو رأس	boshchiligidagi,
مناسب	mos
1984	1984
1985	1985
486/33	486/33
1989	1989
يشفق	achingan
هيروشي	Xiroshi
غير ناجح	muvaffaqiyatsiz
نيسان	Aprel
أيضا	judayam
ذكر	qayd
(الأحمر	(Red
لكن	Ammo
(HAWK	(HAWK
الأمثال	masallar
علاج	davosi
برد	sovuq
&quot;المحايدة&quot;	«xolis»
1995	1995
تغيير	o&#39;zgarish
مدير)	boshqaruvchiName)
1991	1991
في قطر	diametri
عضال	bedavo
1992	1992
1993	1993
LM350K:	LM350K:
رخصة القيادة	haydovchilar-litsenziya
1994	1994
لم أكن أعرف.	bilmasdim.
جيش	armiya
1999	1999
| &amp; طن.	|&gt;
شقيق	birodarim
بعيد	uzoqdan
مساعدة:	Yordam:
مثلي الجنس	xunasa
الأمانة و مثل؛	xavfsizlik&quot;
قبلت	Qabul
ZENON	ZENON
هاتف	telefonni
مذكرة	Note
؟	kerakmi?
إجابات.	Javoblar.
استمرار	davom
Alicelik	Alicea,
يموت	o&#39;lib
03:31	3:31
مدينة	shahridagi
العلامة &amp; lt؛ 1993Apr22.153000.1@vms.ocom.okstate.edu&amp;gt؛ &amp; GT؛	&lt;1993Apr22.153000.1@vms.ocom.okstate.edu&gt;&gt;
جبل	Mount
دش وGT.	dushman&gt;
معهد	instituti
الأحماض	kislotalar
------------------------------------------	------------------------------------------
(360	(360
تزامن	hamohang
الخلايا	hujayralar
ماكراي	MacRae
موجه،	irodasi
التشيكية)	bordik)
منطقة	viloyatida
وGT.	emas&gt;
الدول	mamlakatlariga
حسب المنطقة	hududga
الغازات	Gazlar
إذا.	bo&#39;lsangiz.
العلامة &amp; lt؛ thomasp@ifi.uio.no&amp;gt.	&lt;thomasp@ifi.uio.no&gt;
إذا	bo&#39;lsangiz,
اختفاء	yo&#39;qolib
الطابعات،	ulamolar
html>	carl_f_hoffman@cup.portal.com
المنزل	uyiga
الشمس	Quyoshdan
قواعد	qoidalari
html>	jodfishe@silver.ucs.indiana.edu
html>	shapiro@sofbas.enet.dec.com
على &amp; quot؛ &amp; مثل؛	&quot;biznes&quot;
العناصر	unsurlar
Fotokimya	Fotokimya
ومعادية مثل؛	dushmanlik&quot;
تنفيذ	bajarilishi
طلاب	o&#39;quvchilar
جرائم	jinoyatlar
قراءة	O&#39;qish
فترة	davri
مضر	zararli
تخطيط	rejalashtirish
مراقب	Observer
عائدات	qaytadi
لجنة	komissiya
هيدروجين	vodorod
مسألة	masalasidir
زيارة	ziyorat
يستحق.	arziydi.
الوزيرة،	Kawaguchi,
جرس الشمالية	Bell-Shimoliy
الكنيسة	Jamoatning
... وطن.	....&gt;
بعد،	masofalarga,
نظرية	nazariyasi
حزقيال)	Hizqiyo)
-----------------------------	-----------------------------
(لاري	(Larry
غطرسة	kibr
ستيف.	Steve.
النجوم	yulduzlar,
،	bo&#39;lib,
بما فيه	jumladan
بعيد	uzoqdagi
ديفي هيلمان	Diffie-Hellman,
html>	slegge@kean.ucs.mun.ca
تفسير	talqin
الصور	suratlar
وكالة ناسا	NASA
التدريب وGT.	tayyorlash,&gt;
شرف	sharafini
لهم،	ularni,
جليد	muz
تطور	Evolution
الأماكن	joylari
ملخص	xulosa
عتيق الزي	qadimiy
مصير	taqdir
أمي)	ota-)
مبيعات،	sotish,
تابع	amal
هذا	yotipti
أورانيا	Uranian
السيطرة، البديل، ديل	Ctrl-Alt-Del
الأجهزة	asboblari
شكل	shakl
حرية	erkinlik
المقدمة	taqdim
مختلفة،	turli,
رجعي	retrograd
عبثا،	behuda,
. ومثل؛	va.&quot;
(323	(323
نتاج	mahsulot
حتى	Hatto
مشترك	tarqalgan
الأماكن	joylarni
تأثير	ta&#39;siri
مجتمع	jamiyatda
كو)	Kou)
ارييل،	Ariel,
المواد.	materiallar.
====================================	====================================
على الأقل،	bo&#39;lmasa,
تاريخ	tarix
(الأرض	(Earth
بدائي	sodda
يموت	o&#39;lsa
عداء	yuguruvchi
شيبس	CHIPS
صعوبة.	qiyin.
ستيفن	Steven
أنا لا أفهم.	tushunmayman.
ترك.	tark.
الخروج من الملة	theists
صداع	og&#39;rig&#39;i
5.25	5,25
مختلفة؟	turli?
Nicji	Nicji,
من الصعب،	qiyin,
-dk	-dk
فيلم	kino
الضمنية	shama
وصول	kelishidan
غير أخلاقي	axloqsiz
الله	Xudoning
لي	My,
الجمال	go&#39;zallik
(لا يوجد	»(yo&#39;q
تؤثر	ta&#39;sir,
دون مساعدة	yordamisiz
يوم الأحد	yakshanba
البركاني	Vulkanizm
النصوص	matnlari
معطى	berildi,
أقصى	yakuniy
مغزل	mil
عمودي	vertikal
استبدل	almashtirish
كمبيوتر محمول	cho&#39;kkan
تاريخ	tarixga
أدب	adabiyotni
عبثا.	behuda.
مصباح،	chiroq,
ارتفاع	yuqori
(818)	(818)
بقدر	O&#39;qisak
التاريخ.	tarixi.
اليهود،	yahudiylar
قوالب	andozalari
المسيحيون:	masihiylarga:
بيان	iboralar
... &amp; قووت]؛	...&quot;
في الطريق	yo&#39;lida
علاج	qutulmoqchi
كثافة	zichlikdagi
التاريخ،	tarixi,
فوهة البركان	Crater
1938	1938
مسيرة &amp; GT؛	Mart&gt;
من؟	kim?
MLS	mls
وGT؛ &amp; GT؛	chunki&gt;&gt;
المعلومات	ma&#39;lumotlari
في عام 1930	1930
إلى الأمام	orziqib
واحدة من	birining
ملتزم	sodir
مسيحية	Masihiylikda
مارتن	martin
حول	haqingizda
وGT.	bunday&gt;
سوف	qo&#39;yadi
،	keldi,
.	keldi.
يسوع	Isoga
الجاذبية	Gravitational
1947	1947
1949	1949
1948	1948
غرامة	Fine
عشرات	o&#39;nlab
من التكهنات	spekülasyon
محطات	stantsiyalarda
مشروع	Enterprise,
المرض	kasallikning
عشاق)	sevganlar)
على &amp; quot؛ المرضى	&quot;bemorlarning
نسخة	nusxa
سيد	Mr.
وقال،	aytilmoqda,
الكواكب	sayyoralarning
صغير	kichik
لا يحصى	sanoqsiz
تكنولوجيا	Technology
1959	1959
1958	1958
مرمم	tiklanadi
)	bilan),
دراجة نارية	mototsikl
قطع	zaiflashishi
(الخميرة)	(xamirturush)
فلكي	astronomik
الموقع	saytida
تبعا ل	qarab
مهندس	muhandis
فاحص	tekshiruvi
من السماء	osmondan
أبدا	qachon,
أبدا.	qachon.
إذن	quloq
مرة	vaqtning
على الأقل	kamida
وGT.	hisoblanadi&gt;
باري	Barry
في كل مكان	bo&#39;lishidan
جئت	keldim
INFJ	INFJ
أخطاء	xatolar
===========================	===========================
1967	1967
1969	1969
1968	1968
أنا لا،	chiqmaysiz,
1962	1962
أنا لا.	chiqmaysiz.
1965	1965
شخص ما	birovni
1964	1964
الذين،	kim,
:	keldi:
ملحقات	kengaytmalari,
ضد	qarshi,
عضو في	a&#39;zosi
(راي	(Ray
INF)	INF)
أود أن.	qilmoqchiman.
وعلى الرغم من	qaramay
(310	(310
وانا ذاهب الى	ketyapman,
----------------- وطن؛ &amp; مثل؛	-----------------&gt;&quot;
المتقدمة.	rivojlangan.
القديمة	qadimgi
(على &amp; quot؛ اضحة	(&quot;zohiriy
