XR650L	XR650L
(Erik	(Erik
one?!?	daya?!?
top.	saman.
535	535
found,	samu,
Surface	Surface
found.	samu.
jet	jet
#	#
&amp; Quot; proof-Format	&quot;hujja-Tsara
Criminal	laifuffuka
level.	matakin.
James	James
$	$
%	%
*	*
airlifted	airlifted
+	+
(Jon	(Jon
(	(
)	)
.	.
enough!	isa!
Team	Team
/	/
,	,
-	-
enough.	isa.
3	3
2	2
return	dawo
1	1
7	7
6	6
5	5
4	4
cafe	cafe
:	:
9	9
retrograde	retrograde
8	8
&amp; Lt; 94318@hydra.gatech.EDU&amp;gt;	&lt;94318@hydra.gatech.EDU&gt;
=	=
Gauche	Gauche
D	D
E	E
based.	tushen.
F	F
SetWUTime	SetWUTime
based,	tushen,
@	@
Giants	Kattai
A	A
B	B
time. &amp; quot;	lokaci.&quot;
sped	sped
C	C
L	L
M	M
ACCOUNTS	MATATTU
H	H
I	I
J	J
Relationships	Dangantaka
U	U
T	T
we	muka
Agency	hukumar
(713)	(713)
Q	Q
S	S
bowls	daruna
\	\
_	_
^	^
area	yankinka
X	X
1846	1846
html>	mmm@cup.portal.com
g	g
d	d
Feb	Feb
e	e
Questions:	Tambayoyi:
in	a
one	daya
solution	bayani
slated	slated
&amp; Lt; 1r10jcINNt1g@lynx.unm.edu&amp;gt;	&lt;1r10jcINNt1g@lynx.unm.edu&gt;
packages &amp; quot;	kunshe-kunshe&quot;
o	o
m	m
Stern.	tsananin.
h	h
i	i
w	w
real	hakikanin
520	520
p	p
Optilink!	Optilink!
conveying	isar
~	~
|	|
&amp; Quot; Re-appear? &amp; Quot;	&quot;Re-bayyana?&quot;
&#39;I	&#39;Ina
x	x
ice	kankara
read,	karanta,
(KJV)	(KJV)
footsteps	zambiyõyin
(Including	(ciki
agressive	agressive
owned.	mallakar.
Melnick)	Melnick)
updated	updated
World-in	Duniya-a
JPEG,	JPEG,
classes	azuzuwan
html>	ocom.okstate.edu
580	580
Adam	Adam
paralleled	paralleled
helium,	helium,
Primary	firamare
Jumping	tsalle
FAQ.	FAQ.
Home	Gida
propaganda.	farfaganda.
helium.	helium.
FAQ	FAQ,
(Sorry	(sorry
&amp; Quot;	&quot;yi
Bonds	hadar
(Including	(haɗa
update	update
contains	ƙunshi
Created	Halitta
Staff	Ma&#39;aikatan
seas.	tekuna.
(__)	(__)
Country	Kasar
&#39;&#39;	&#39;yan&#39;
found]	samu]
&amp; Quot; we	&quot;mun
reasons:	dalilai:
(This	(Wannan
XBell	XBell
DO.	YI.
connection	dangane
access	samun
Attempt	Yunkurin
Sugar	Sugar
lpt1	lpt1
punishment.)	azaba.)
Fir	Fir
3rd	3rd
Thanks	Godiya
pgf@srl02.cacs.usl.edu|Like	pgf@srl02.cacs.usl.edu|Like
Division	Division
Fit	Fit
reasons.	dalilai.
religious	addini
false doctrine?	karya-koyaswa?
Tasco	Tasco
DR250ES	DR250ES
&amp; Quot;	&quot;ko
Percent	Kashi
vesterman.	vesterman.
enough	ishe
redefined	redefined
&amp; Gt; &amp; gt;	&gt;&gt;
jobs.	jobs.
news-conference	labarai-taron
itself.	kanta.
bread.	burodi.
miles)	miles)
&amp; Lt; C51nLs.7As@boi.hp.com&amp;gt ;,	&lt;C51nLs.7As@boi.hp.com&gt;,
noiseless	noiseless
that &amp; quot;	cewa&quot;
Go,	tafi,
Detriot,	Detriot,
m-red	m-ja
cryptography	cryptography
comets	comets
going	faruwa
spotted.	hange.
&amp; gt;	masu&gt;
anti-gun	zanga-gun
freezes,	freezes,
frosted	frosted
question.	tambayar.
reject.	kãfirta.
products.	samfurori.
Internet	Intanet
since &#39;	tun&#39;
go?	tafi?
winter	hunturu
internet:	internet:
trade,	ciniki,
(Blaise	(Blaise
010-A	010-A
homosexuals,	luwadi,
Revolution	Juyin
Prophets.	Annabawa.
4H7	4H7
Prophets,	Annabawa,
&amp; Quot; real &amp; quot; &amp; gt;	&quot;hakikanin&quot;&gt;
Such	Irin
Norway	Norway
&amp; Quot; red	&quot;ja
indepth	indepth
Norway):	Norway):
mountain	dutsen
meetings &amp; gt;	tarurruka&gt;
Algorithms	Algorithms
HOME.	GIDA.
feel	jin
information.	bayanai.
information,	bayanai,
Douglas	Douglas
Homosexuality	Liwadi
Neptune	Neptune
Toyota,	Toyota,
tranfer	tranfer
50.	50.
50	50,
DOUBLE_BUFFER	DOUBLE_BUFFER
having	ciwon
500	500
--------------------------------------------	--------------------------------------------
conditions	yanayi
we	muke
opti	opti
12:26	12:26
tangent	tangent
good &amp; quot;	kyau&quot;
maria,	maria,
Edmond	Edmond
&amp; Quot; &amp; quot;	&quot;kai&quot;
&amp; Quot;	&quot;mu
&amp; Quot;	&quot;na
required	bukata
hair &amp; quot;	gashi&quot;
dunes.	dunes.
colors	launuka
worse	muni
5.7	5.7
accusors.	accusors.
LOVE	LOVE
talks	tattaunawa
Stein)	Stein)
lost	hasãrar
meteoroids.	meteoroids.
5.0	5.0
flooding	ambaliya
1870	1870
we	muna
ring	zobe
Syndrome)	ciwo)
Wolves	Wolves
&amp; Lt; 1r9j33$4g8@hsdndev.harvard.edu&amp;gt ;,	&lt;1r9j33$4g8@hsdndev.harvard.edu&gt;,
2,000	2,000
^^^^^^^^^^^^^^^^^^^^^^^^^^^^^^^^^^^^^^^^^^^^^^^^^^	^^^^^^^^^^^^^^^^^^^^^^^^^^^^^^^^^^^^^^^^^^^^^^^^^^
rooting	rooting
chill.	huce.
fine-grained	m-grained
763-5889	763-5889
top	saman
compelling	tursasawa
84-year	84-shekara
summer	bazara
all &amp; gt;	duk&gt;
production	samar
rule.	mulkin.
html>	timmbake@mcl.ucsb.edu
Window	Window
&amp; Quot; full &amp; quot;	&quot;cika&quot;
Cyrix	Cyrix
rule)	mulkin)
confidence.	amana.
Germany	Jamus
16-169	16-169
it	ita
Blocked	Katange
above)	sama)
brother	ɗan&#39;uwãna
1ff	1ff,
above,	sama,
above.	sama.
Cyric	Cyric
helium	helium
NUETZMAN	NUETZMAN
Heaven?	sama?
functions.	ayyuka.
joules	joules
escalating,	escalating,
FTP	FTP
For &amp; gt;	Domin&gt;
gods.	gumakan.
medical &amp; quot;	likita&quot;
&amp; Lt; sl3b+@andrew.cmu.edu&amp;gt;	&lt;sl3b+@andrew.cmu.edu&gt;
d	ɗ
Days	Kwana
Popup	Popup
deal	magance
presented	gabatar
pinch	tsunkule
Honda	Honda
Back &amp; quot;	Back&quot;
superencipherment	superencipherment
&amp; Lt; 1rbn60$gs7@usenet.INS.CWRU.Edu&amp;gt;	&lt;1rbn60$gs7@usenet.INS.CWRU.Edu&gt;
new	sababbin
community,	al&#39;umma,
such	irin
chipset.	chipset.
community)	al&#39;umma)
&#39;Hearing	&#39;jin
them	musu
health	kiwon
god.	bautawarku.
blows	naushe
(82,178	(82,178
different,	daban-daban,
High,	Maɗaukaki,
themselves.	kansu.
Technology,	Technology,
seconds.	seconds.
themselves,	kansu,
Craters	Craters
&amp; Quot; yeast	&quot;yisti
We	Muka
html>	noring@netcom.com
die	mutu
&amp; Quot; Developing	&quot;Developing
688-8231	688-8231
System	Tsarin
intellegence	tunaninka,
XXX	XXX
Shocked	gigice
pale,	kodadde,
html>	hays@ssd.intel.com
waste	vata
...........	...........
subsystems	subsystems
exist	wanzu
We	Muna
brand	iri
light	haske
enough	isa
books,	littattafai,
Tsai)	Tsai)
&amp; Lt; _Atheism:	&lt;_Atheism:
Thanks!	Godiya!
iconified).	iconified).
snap.	karye.
methane	methane
ships	jiragen
computer	kwamfuta
idea,	ra&#39;ayin,
bug	kwaro
11:25	11:25
Purity	Tsarki
community:	al&#39;umma:
treatment,	magani,
I	inã
(604)	(604)
emissions.	watsi.
treatment.	magani.
idea?	ra&#39;ayin?
insects	kwari
gravitational	gravitational
giant	giant
Traditional	gargajiya
Christ	Almasihu
Palestinian	Palasdinawa
President	Shugaba
Courier &amp; gt;	Fe&gt;
(Almost	(Kusan
life,	rãyuwar,
Reason	Dalilin
PowerPC	PowerPC
right.	hakkin.
population.	yawan.
nitrogen,	nitrogen,
paperwork?	paperwork?
nitrogen.	nitrogen.
(SKELTON	(SKELTON,
&amp; Lt; rauser.734062608@sfu.ca&amp;gt;	&lt;rauser.734062608@sfu.ca&gt;
interrupts.	interrupts.
Crawford)	Crawford)
southeners	southeners,
autoexec.bat	autoexec.bat
============ Echo	============ECHO
relationships	dangantaka
premade	premade
developed	ɓullo
discussion,	tattaunawa,
. &amp; quot;	nan.&quot;
discussion.	tattaunawa.
Egypt	Misira
believe	gaskata
approach	kusanci
colors.	launuka.
shovels,	cokula,
days	kwana
placement	jeri
joke.	wargi.
Nea.	NEA.
resisters	resisters
passage	nassi
row	jere
cancel	soke
Listed	jera
search	caje
Religion &amp; gt;	addini&gt;
html>	jaskew@spam.maths.adelaide.edu
search	caji
means,	nufin,
can	iya
Clint	Clint
Technologies,	Technologies,
Hockey	Hockey
short?	gajeren?
books:	littattafan:
Jordan	Jordan
awning	rumfa
ultraviolet	ultraviolet
they	sunã
Exactly,	Daidai,
&amp; Quot; &amp; quot ;, Christian	&quot;Kirista&quot;,
Marty,	Marty,
1,770	1.770
product	samfurin
word	maganar
percieved	percieved
-391	-391
Months	&#39;watanni
there.	can.
charity.	sadaka.
Columbia	Columbia
great	babba
Original	Original
surveyed.	surveyed.
post.	post.
anti-trust	anti-dogara
post,	post,
fun.	fun.
tour	rangadin
resurrection	tashinsa
receding	matafã
&amp; Amp;	&amp;
html>	rscharfy@magnus.acs.ohio-state.edu
Speaking,	magana,
Speaking.	magana.
there?	can?
resort	mafaka
G20	G20
Christ &amp; gt;	Kristi&gt;
transmission,	watsa,
newsletters	mujalloli
Contact &amp; gt;	tuntube&gt;
power,	ikon,
Technology &amp; gt;	Fasaha&gt;
comfortable	daɗi
copy	kwafe
And	Suka
comparative	kamanta
video	bidiyo
(Top	(saman
.4ID	.4ID
salon	salon
atmospheres	atmospheres
Louis	Louis
Shell	Shell
Chance	Chance
Sun!	Sun!
GOD	ALLAH
meteoroid	meteoroid
dreams,	mafarkai,
where &amp; gt;	inda&gt;
354-1333,	354-1333,
#:	#:
401	401
Charon	Charon
sentence	jimla
400	400
henling	henling
&amp; Quot;	&quot;wadanda
close	kusa,
&amp; Quot; New	&quot;New
Cryptologia	Cryptologia
&amp; Quot; ^^^^^^^^^^^^^^^^^^^^^^^^^^^^^^^^	&quot;^^^^^^^^^^^^^^^^^^^^^^^^^^^^^^^^
1.610	1.610
words	kalmomi
random	bazuwar
hope?	bege?
Arabic	Larabci
170	170,
THEIR	MUSU
2nd	2nd
maybe	watakila
Spaceship	Kumbon
are	suna
securital	securital
!!	!!
door &amp; quot;	kofa&quot;
Nuclear	nukiliya
servers	sabobin
agree	yarda
steel.	karfe.
html>	artmel@well.sf.ca.us
(______	(______
shape	siffar
Book	Littafi
************	************
Elvis	Elvis
spot	suma
reponse	reponse
14-19	14-19
(Karl	(Karl
agree,	yarda,
Martin,	Martin,
keep	kiyaye
leave	barin
agree.	yarda.
&amp; Lt; RVESTERM@vma.cc.nd.edu&amp;gt;	&lt;RVESTERM@vma.cc.nd.edu&gt;
html>	engp2008@nusvm.nus.sg
agree?	yarda?
ken	ken
SAVING	CETO
price	farashin
influence	rinjayar
key	key
35,789	35.789
&amp; Quot; &amp; quot;	&quot;mu&quot;
Council	majalisan
Law. &amp; Quot;	Attaura.&quot;
Several &amp; gt;	dama&gt;
cell	tantanin
100 &amp; gt; &amp; gt;	100&gt;&gt;
Leafs	Leafs
dictionary	ƙamus
($	($
dookie! &amp; quot;	dookie!&quot;
8:31	8:31
tests.	gwaje-gwaje.
surprise	mamaki
blanket	bargo
they	suke
Boston	Boston
Government	gwamnatin
facing	fuskantar
they	suka
people &amp; gt;	mutane&gt;
Sun,	Sun,
majority.	rinjaye.
firearm	firearm
placid-looking	placid-neman
Sun.	Sun.
Satan	shaidan
decrypt	decrypt
Criminal	Laifuka
Prepared	Shirya
,	ke,
tall	dogayen
pizza-change	pizza-canza
stable	barga
Sun;	Sun;
witness	shaidar
width	nisa
Stassen	Stassen
littered	barjat
audio	audio
Are	Suna
&amp; gt;	ake&gt;
funny	funny
repair.	gyara.
fabrication	ƙiren
sightings	sightings
before &amp; gt;	kafin&gt;
everyone.	kowa.
467	467
Foreign	waje
- &amp; Gt;	-&gt;
schematics.	schematics.
Go &amp; gt;	tafi&gt;
deep.	zurfi.
rodents	rodents
lander	lander
Judgment &amp; gt;	Kiyãma&gt;
witness	shaida,
witness.	shaida.
ringlets	ringlets
themself	themself
Driver	Driver
Files	Fayiloli
Witness)	shaida)
Development	bunkasa
(M	(m
**	**
Copy	Kwafa
Wai	Wai
Sue,	Sue,
)	ku)
photochemical	photochemical
miles).	mil).
Program	Shirin
miles),	mil),
Air	Iska
Johnson,	Johnson,
Purchase	Purchase
types.	iri.
+1	+1
++	++
half	rabin
&amp; Quot; promotion &amp; quot;	&quot;gabatarwa&quot;
(A	(A
html>	phj@remus.rutgers.edu
stats: &amp; gt; &amp; gt;	stats:&gt;&gt;
*************************************	*************************************
look-	look-
plexiglassso	plexiglassso
4,094	4.094
Showered	¡uraishi
algorithm	algorithm
(2	(2
lawfully	lawfully
CSHOW	CSHOW
universe.	samaniya.
final	ƙarshe
(1	(1
examination.	jarrabawa.
War	War
(7	(7
actually	zahiri
examination,	jarrabawa,
()	()
be	kasance
them.	cikinsu.
universe,	samaniya,
(	(a
&#39;Real&#39;	&#39;real&#39;
Magic	Magic
AH	hijira
fringes	fringes
(\	(\
events	abubuwan
North	arewa
html>	ritley@uimrl7.mrl.uiuc.edu
&amp; Quot; alternative &amp; quot;	&quot;madadin&quot;
(I	(I
)	),
Cometary	Cometary
debris	tarkace
gods	abũbuwan
Puryear	Puryear
What	Menene
place.	wuri.
preps	preps
hardcore	hardcore
..	..
html>	gonzaled@ucsu.Colorado.EDU
(Korenek@nmti.com)	(korenek@nmti.com)
Altima	Altima
days,	kwanaki,
damage	lalata
days)	kwanaki)
contact	lamba
Act	dokar,
puzzled	ruxani
eroded,	eroded,
league	league
days.	kwanaki.
//	//
&amp; Quot; No	&quot;Babu
items	abubuwa,
exhibiting	exhibiting
items.	abubuwa.
If &amp; gt;	idan&gt;
programs.	shirye-shirye.
motorcycle	babur
Word	Kalmar
place	wurin
Content	Abun
html>	ge!severy%severy@uunet.UU.NET
MAX641,	MAX641,
[Gen	[Gen
tectonics	tectonics
variety	iri-iri
impedance	impedance
between	tsakanin
e-mail:	e-mail:
colder	colder
expansion	faɗaɗa
suspended	dakatar
Ergo	ergo
html>	ILV20078@UDELVM.UDEL.EDU
but	fãce
Gay	Gay
criteria	sharudda
451-0815	451-0815
vain.	banza.
Angry	hushi
4.6	4.6
Cramer	Cramer
Gas	Gas
digest	nike
-.	-.
Raste	raster
maneuvering	maneuvering
duration	duration
group.	kungiyar.
up &amp; quot;	up&quot;
group,	kungiyar,
midsummer.	midsummer.
Son	Ɗan
Kloo	Kloo
liberty	walwala
link	hadewa
break-doctor	karya-likita
personal	sirri
namelplate	namelplate
Morocco	Morocco
35	35
A	Wata
Phone	waya
Tug-of-war	Tug-na-yaki
other	ansu
3:	3:
&amp; Lt; 1993Apr21.170403.22855@yang.earlham.edu&amp;gt;	&lt;1993Apr21.170403.22855@yang.earlham.edu&gt;
4.	4.
4,	4,
Other	Wasu
42	42
40	40
Ark.	jirgin.
(613)	(613)
2:	2:
(128.149.6.2);	(128.149.6.2);
anti	anti
22	22
severy	severy
23	23
24	24
befor	befor
errors.	kurakurai.
PowerBooks?	PowerBooks?
25	25
Rowland	Rowland
push	tura
26	26
1w	1W
specialists.	kwararru.
disposal.	dashi.
3,	3,
purification	tsarkakewa
3.	3.
30	30
1m	1m
Ishii,	Ishii,
31	31
PowerBooks	PowerBooks,
greenhouse,	greenhouse,
3)	3)
enough	isasshe
19	19
1:	1:
rooms	dakunan
17	17
fool	wawa
18	18
15	15
What	Abin
16	16
13	13
14	14
11	11
12	12
21	21
20	20
about	kimanin
2.	2.
That	Lalle
2,	2,
dominated	mamaye
2)	2)
21-22:	21-22:
2%	2%
the sea,	teku,
sea.	teku.
passing	wucewa
window.	taga.
window,	taga,
moon	watã
html>	erikb@idt.unit.no
1.	1.
diseases &amp; quot;	cututtuka&quot;
10	10
time.	lokacin.
1)	1)
time,	lokacin,
1%	1%
supplier	maroƙi
unaccepted	unaccepted
Swartz	Swartz
Gospel?	Linjila?
7:	7:
Sulfur	Sulfur
78	78
West.	West.
Printing	Bugu
7,329.	7.329.
prohipiting	prohipiting
(True),	(gaskiya),
compatable	compatable
brave,	jarumi,
8,	8,
TO	ZUWA
minutes.	minutes.
butterscotch	butterscotch
(Which	(waxanda
6:	6:
Lunar	Lunar
official	hukuma
7)	7)
zur	zur
said: &amp; gt;	ce:&gt;
!!!! &amp; Quot;	!!!!&quot;
7,	7,
errors	kurakurai
generated	generated
70	70
72	72
lost!	rasa!
76	76
modem	modem
model	model
5:	5:
html>	martyj@uiuc.edu
Solomina)	Solomita)
56	56
Update	Update
see	dũbi
55	55
5?	5?
Look	dũba
6,	6,
great	girma
Brothers,	&#39;yan&#39;uwa,
rigo.	rigor.
12,00	12,00
number,	lambar,
context.	mahallin.
60	60
melt	narke
Southern	kudancin
^^^^^^^^^^^^^^^^^^^^^^^^^^^^^^^^^^^	^^^^^^^^^^^^^^^^^^^^^^^^^^^^^^^^^^^
4:	4:
1980s.	1980s.
scheme.	makirci.
4th?	4th?
bands.	makada.
pedal,	feda,
______	______
Which	Wane
70,000th	70,000th
WW2	WW2
drop	maniyyi
5,	5,
cross-check	haye-duba
A	Wani
Clipper	Clipper
subsystem	subsystem
North	Arewacin
pcx,	pcx,
5.	5.
Torre:	Torre:
50	50
access	damar
(508)	(508)
Sheen	Sheen
Azzam)	Azzam)
486	486
*************************************************	*************************************************
that	lalle
99.86	99,86
male, &amp; gt;	namiji,&gt;
care	kulawa
482	482
&amp; Lt;	&lt;a
countries	kasashen
result,	sakamakon,
&amp; Lt; /	&lt;/
do	kar
on	kan
Madrid	Madrid
Coupons	baucoci
head	kai
Applications	Aikace-aikace
experiments	gwaje-gwajen
chocolate	cakulan
Lankform	Lankform,
::	::
10:39:15	10:39:15
contaminated	gurbata
dust	turɓaya
grounded.	grounded.
rotten	rududdugaggu
Maybe	ƙila
a	wani
right?	dama?
:)	:)
bodies	gawawwaki
Source.	Madogararsa.
Lamp,	fitila,
.	ka.
html>	sbp002@acad.drake.edu
perpetrated	kasanta
93	93
90	90
misinformed.	misinformed.
,	ka,
followup	followup
[Christians]	[Kiristoci]
right	daman
==================================================	==================================================
88	88
wrong?	azzãlumai?
company &amp; gt;	kamfanin,&gt;
Cycle	da&#39;ira
&amp; gt;	ce&gt;
the	wato
Alternatively	madadin
Kardon	Kardon
codify	codify
Above. &amp; Quot;	Sama.&quot;
??	??
corner)	kusurwa)
Moon	Watã
MacRae): &amp; gt; &amp; gt; &amp; gt;	MacRae):&gt;&gt;&gt;
mishap,	mishap,
difficulty?	wahala?
prescient	prescient
Several	dama,
?!	?!
translation	fassara
manufacturer	manufacturer
put-down	sa-saukar
&amp; gt;	na&gt;
son.	dansa.
Moon.	Moon.
former	tsohon
science	kimiyyar
servers.	sabobin.
almost	kusan
Moon,	Moon,
hundreds	daruruwan
Leong,	Leong,
strike	dũka
fault-line	laifi-line
please	faranta
lots	kuri&#39;a
X11	X11
(LGV	(LGV
plates	faranti
difficulty.	wahala.
Free download	Bure
difficulty,	wahala,
(Ken	(Ken
For	For
graphics	graphics
Erik	Erik
html>	gt4417a@prism.gatech.EDU
play	wasa
WNI	WNI
other	wasu
created	halicce
Fahrenheit)	Fahrenheit)
rumor	jita-jita
a	wata
gospel	bishara
default,	tsoho,
beware	hattara
motherships	motherships
And	Da
yoghurt	yoghurt
Glance	Glance
need	bukatan
Article	labari
ethane	ethane
4.850	4,850
work?	aiki?
standard	daidaitattun
need	bukatar
Help	&#39;taimako
E.	E.
operation,	aiki,
Land,	Land,
DE	DE
state,	jihar,
Galatians	Galatiyawa
(Korenek@nmti.com) &amp; gt; &amp; gt; &amp; gt;	(korenek@nmti.com)&gt;&gt;&gt;
work.	aiki.
DH	DH
sites	shafukan
state.	jihar.
Eat	Ci
gospel	bisharar
Bures &amp; gt;	Bures&gt;
California.	California.
virus..It	virus..It
340	340
knowledgable	knowledgable
Terrorism)	Ta&#39;addanci)
managers	manajoji
Christianity	Kiristanci
philosophy	falsafa
Lamp	fitilar
GE	GE
Fe	Fe
Wen-Cheng	Wen-Cheng
outlaws	outlaws
great	babbar,
Spaceflight	Spaceflight
dead-end	mutu-karshen
prosperity	wadãta
handbooks	handbooks
Ocean.	tẽkun.
valleys,	kwaruruka,
Ocean,	tẽkun,
IO.	IO.
G.	G.
FM	FM
IO,	IO,
ourselves	kanmu
FI	FI
HG	HG
Place	Place
Compounds	mahadi
To	Ga
product.	samfurin.
&amp; Lt; C5t7Gs.7v3@news.iastate.edu&amp;gt;	&lt;C5t7Gs.7v3@news.iastate.edu&gt;
Christ. &amp; Quot;	Almasihu.&quot;
Incorporated	Incorporated
IP:	IP:
proportionally,	proportionally,
763-2626	763-2626
Arab	Larabawa
sea	teku
they	suKe
people? &amp; quot;	mutane?&quot;
GP	GP
GO	GO
H.	H.
GM	GM
skin)	fata)
(Paul	(Paul
recomendations	recomendations
oddball	oddball
volts	volts
Systems,	Systems,
itself_	itself_
sex.	jima&#39;i.
Secondaries	Secondaries
target	manufa
ride	hau
5:17	5:17
sex)	jima&#39;i)
jusgement	jusgement
Oort	Oort
up	har
cruise	cruise
&amp; Quot; Dan	&quot;Ɗan
How	yaya
struggling	fafitikar
Titan	Titan
spirochetal	spirochetal,
How	Yadda
Johnson &amp; gt;	Johnson,&gt;
1930,	1930,
offers	yayi
A.	A.
====================================== &amp; Gt;	======================================&gt;
AT	AT
300	300
son	ɗan
sun-generated	rana-generated
benefits	amfãni
BA	BA
introduction	gabatarwar
30%	30%
When &amp; gt;	lokacin&gt;
III	III
AM	AM
B.	B.
Sweden	Sweden
30,	30,
Hi,	Hi,
IMMMMMMMMMMMMMMMMMMMMMMMMMMMMMMMMMMMMMMMMMMMMMMMMMMMMMMMMMMM.	IMMMMMMMMMMMMMMMMMMMMMMMMMMMMMMMMMMMMMMMMMMMMMMMMMMMMMMMMMMM.
AN	AN
BV	BV
C:	C:
frame,	frame,
&amp; Lt; C5qsBF.IEK@ms.uky.edu&amp;gt;	&lt;C5qsBF.IEK@ms.uky.edu&gt;
AS	As
Not	Ba
CA	CA
love	ƙaunar
BF	BF
work	aikin
BI	BI
Extraterrestrial	Extraterrestrial
BC	BC
Ad	Ad
ago.	wuce.
An	An
ago	wuce,
(2,147	(2,147
C	C,
C.	C.
Al	Al
3.0	3.0
By	By
3.1	3.1
Eastwood	Eastwood
3.8	3.8
space	sarari
DB	DB
AND	DA
now	yanzu
promotion.	gabatarwa.
3.5	3.5
will	zai
&#39;God. &amp; Quot;	&#39;Allah.&quot;
Jovian	Jovian
I	zan
CD	CD
yourself	kanka
D.	D.
room	dakin
You	Ku
!!)	!!)
(Hebrews	(Ibraniyawa
Assad	Assad
IDE	IDE
!!!	!!!
M.	M.
old	haihuwa
Or	Ko
Twin	Twin
hey	hey
(NASA	(NASA
cratered	cratered
cooperation	gwiwa
whiskey	wuski
Leonard	Leonard
LITTLE	LITTLE
bound	ɗaure
MD	MD
MB	MB
rivers	kõguna
U there,	kananan,
&amp; gt;	da&gt;
162,	162,
reformatting	reformatting
conditions.	yanayi.
N.	N.
conditions,	yanayi,
Gilkey	Gilkey
keyboard,	keyboard,
DEEP	SOSAI
MS	MS
Why	Me
good. &amp; quot;	kirki.&quot;
condense	sandare
NI	NI
worship	bauta
riverbeds	riverbeds
NA	NA
html>	dlb@fanny.wash.inmet.com
NE	NE
tape.	tef.
My	My
We	Mu
Electronics,	Electronics,
Homo	Homo
---------------------------	---------------------------
Will	Zai
NO	NO
I	Zan
&amp; Lt; ekdfc.14.0@ttacs1.ttu.edu&amp;gt ;,	&lt;ekdfc.14.0@ttacs1.ttu.edu&gt;,
P.	P.
(6,200	(6,200
ON	ON
Me	Ni
bride	amaryar
Is	Ne
(&amp; Quot; Plains	(&quot;sararan
Multi-	Multi-da
I	Na
come,	zo,
plate,	farantin,
star	star
P5 +	P5
OP	OP
case	yanayin
html>	lei@rtsg.mot.com
OK	Ok
On	On
(Wen-Cheng	(Wen-Cheng
Oh	Oh
sulfur	sulfur
denied	musun
PA	PA
Pb	PB
PC	PC
pseudo-	pseudo-
I,	I,
Internet.	yanar-gizo.
Central,	tsakiya,
create	kirkiro
matter	al&#39;amari
Barringer	Barringer
Interim	wucin
because,	domin,
(If	(idan
Yankee	Yankee
Addressing	jawabi
meteor.	meteor.
meteorites	meteorites
hit	hit
ID	ID
to:	domin:
IF	IF
II	II
html>	nuet_ke@pts.mot.com
Tom &amp; gt;	Tom&gt;
Hi	Hi
J.	J.
hopes	fatan
IN	IN
quack	quack
IO	IO
skin	fatar
IT	IT
change	canza
html>	dh782@cleveland.Freenet.Edu
stereo	sitiriyo
Club.	Club.
them,	musu,
PLEASE	PLEASE
taking	ɗaukar
Professional	sana&#39;a
Hz	Hz
Network	Network
EGALON)	EGALON)
Arab,	Larabawa,
&amp; Quot;),	&quot;),
run-of-the-mill &amp; gt;	gudu-na-da-niƙa&gt;
christian	christian
I	In
help	taimake
flexing	flexing
misinformation	misinformation
volcanic	volcanic
help	taimaka
JT	JT
validating	validating
middle	tsakiyar
meteorite.	meteorite.
meteors	meteors
(Hamaza	(Hamaza
IBM	IBM
constituents.	yayan.
help	taimako
html>	st1ge@Elroy.UH.EDU
Toyota	Toyota
promiscuous	promiscuous
(Joseph	(Joseph
OR	KO
map	taswira
L.	L.
LED	jagoranci
your	your
bombardment	bombardment
Hal	Hal
ID.	ID.
You	Ka
Nereid	Nereid
LH	LH
1938,	1938,
Science	Kimiyya
Up	Har
thicket	ƙunci
FROMTHEDEAD:	FROMTHEDEAD:
Africa	Afirka
shines,	haskakawa,
swirl	swirl
stephen.guerke@mvs.udel.edu	stephen.guerke@mvs.udel.edu~~V
&amp; Lt; C5w5CB.Ct4@rahul.net&amp;gt ;,	&lt;C5w5CB.Ct4@rahul.net&gt;,
VL	VL
W.	W.
turn	juya
speculate	yayata
Leader	jagoran
Lebannon.	Lebannon.
&amp; Quot; For	&quot;Ga
heading	ashin
photographs	hotunan
diferential	diferential
Jesus &amp; quot ;.	Yesu&quot;.
business.	kasuwanci.
pupil	almajiri
Then	To
Sports	wasanni
input	shigar
By	Ta
partner	abokiyar
&amp; Quot; They	&quot;Bã
TX	TX
TV	TV
To	Su
Volumes	Kundin
html>	wnk@aquifer.geology.uiuc.edu
these	waɗannan
Seats	XT
inconsistency	inconsistency
trust	dogara
Norton	Norton
Landmann	Landmann
pictures.	hotuna.
low &amp; gt;	low&gt;
(Portable)	(Fir)
change	canja
change	canji
Arab?	Larabawa?
friction	gogayya
------------------------	------------------------
Jun&#39;ichiro	Jun&#39;ichiro
liable	dogaro
presentation.	gabatar.
Arab.	Larabawa.
Blocks	tubalan
What	Mene
Open	Open
Sysops)	Sysops)
ago	wuce
legal,	shari&#39;a,
people &#39;	mutane&#39;
Pathfinder &amp; gt; &amp; gt; &amp; gt;	Pathfinder&gt;&gt;&gt;
S.	S.
Jacob &#39;?	Yakubu&#39;?
Gun	Gun
Sunday	Lahadi
Set	Saita
Folta)	Folta)
space.	sarari.
haram	haramun
Guy	Guy
&amp; Quot; ad	&quot;wucin
Science	kimiya
(Various)	(daban-daban),
fitness	dacewa
R.	R.
html>	alin@nyx.cs.du.edu
case	al&#39;amarin
(1.5-mile)	(1.5-mil)
host	rundunar
principles	ka&#39;idodinta
are	mãsu
theoretical	ka&#39;idojin
right	yancin
oranges.	lemu.
Jew	Bayahude
bugs.	kwari.
good &amp; quot;	kirki&quot;
complexity	ganewar
TO	TO
Revolution	juyin
fuel	makãmashin
space	sararin
SS	SS
tears	hawaye
surface,	surface,
prepared	tattali
Chin	Chin
TA	TA
T)	T)
integrity.	mutunci.
SI	SI
surface.	surface.
liscened	liscened
-120	-120
&amp; Quot; gun	&quot;bindiga
RR	RR
DH-like	DH-kamar
regulations.	ka&#39;idoji.
balances	ma&#39;aunan
experiments,	gwaje-gwajen,
fatally	fatally
Chain.	Sarkar.
///////	///////
matter:	al&#39;amari:
html>	franjion@spot.colorado.edu
SA	SA
Driver &amp; gt;	Driver&gt;
Jew,	Bayahude,
&amp; Quot; sign	&quot;alamar
O	Yã
from	​​daga
,	za,
Giants.	Refayawa.
site,	site,
(Ethan	(Etan
N3JXP	N3JXP
Aqueous	ruwa-ruwa
Sale	Sale
planetary	planetary
^)	^)
Severy	Severy
waving	waving
\\	\\
argon	argon
CONFIG.SYS	CONFIG.SYS
=============================================	=============================================
Sam.	Sam.
&amp; gt;	zuwa&gt;
Release	Saki
geyser-like	geyser-kamar
unsympathetic	unsympathetic
choice &amp; gt;	zabi&gt;
people	mutãne
Again	Sake
resistance	jure
&#39;Forever	&#39;madawwama
,	a,
a.	a.
__	__
block	block
&#39;Sure	&#39;haƙiƙa
in!	a!
life	rayuwa
permission	izinin
equator	ekweita
MouseWare	MouseWare
html>	dbernard@clesun.Central.Sun.COM
October	Oktoba
.signature.	.signature.
Hutchison &amp; quot;	Hutchison&quot;
them	cikinsu
poverty	talauci
sent.	aiko.
real	ainihi
r &amp; gt;	r&gt;
[2]	[2]
^^	^^
John	Yahaya
Solution	Bayani
bid	umurni
gun	gun
3-8), &amp; gt;	3-8),&gt;
Press	Press
WILL	ZA
fire.	wuta.
-183	-183
exploring,	binciko,
382	382
Worlds	halittu
To	Ya
about	game,
Renaissance,	Renaissance,
history	tarihi
book	littafin
Renaissance.	Renaissance.
Research	Bincike
Do	Yi
resolves	tattare
Collection	tattara
-179	-179
all	dukkan,
created	halitta
adjustments.	sabawa.
itself	kanta
depleted	tsautsayi
catagories	catagories
Time	Lokacin
Italy,	Italiya,
(Douglas	(Douglas
area,	yankinka,
375	375
DO	YI
release)	saki)
Do &amp; gt;	Shin&gt;
$!	dala}!
another	juna
craters.	craters.
very	sosai
remnants	remnants
himself	kansa
Masters	Masters
again,	sake,
[	[a
Nanaimo,	Nanaimo,
fans	magoya
360	360
Uranus.	Uranus.
Uranus,	Uranus,
By,	rantsuwa,
ADC	Dogarin
They	Sũ
themselves	kansu
Israel.	Isra&#39;ila.
receiver	karbar
depth	zurfin
HRB	HRB
billion	biliyan
Found	Samo
Will	Za
Sams	Sams
apriori.	apriori.
&amp; Quot; quack &amp; quot;	&quot;quack&quot;
Chris	Chris
\)	\)
negative	mummunan
\.	\.
Judgment	¡iyãma
&amp; gt;	ga&gt;
abyss	abyss
JESUS	YESU
48?)	48?)
K1Y	K1Y
throw	jefa
Land	Land
custom	al&#39;adar
Stand	Tsaya
skip	tsallake
(	(nan
to	ga
&amp; Lt; 1qksc2$2mr@fido.asd.sgi.com&amp;gt;	&lt;1qksc2$2mr@fido.asd.sgi.com&gt;
bisexual	bisexual
celebration	bikin
life,	rayuwa,
not	bã
KIND	IRIN
JPL	JPL
more	fi
life.	rayuwa.
hot-livered	zafi-livered
faith	bangaskiya
Paul	Paul
Iraq?	Iraki?
203	203
whip	bulala
200	200
teach	koyar
201	201
20:	20:
Had	dã
Serbian	Serbian
people	mutane
her.	ita.
Mountain	Dutsen
html>	SLEGGE@kean.ucs.munc.ca
reports.	rahotannin.
To	Yin
20%	20%
fire	wutar
cameras	kyamarori
cleanse	tsarkake
millions	miliyoyin
you	cikinku
20-	20-
if	idan
20,	20,
lasting	zaunanniya
Father,	Uba,
Father.	Uba.
Beta	Beta
probably	yiwuwa
By	Rantsuwa
opinions	ra&#39;ayoyin
&amp; Quot; ...	&quot;...
recklessly	recklessly
there	akwai
thrusters	thrusters
facade?	facade?
Aili	ailin
&amp; Quot; I know	&quot;nasan
Banks	Banks
key &amp; quot;	key&quot;
21)	21)
life	rayuwar
Iftccu:	Iftccu:
21,	21,
tacky,	tacky,
Through	Hanyar
look	look
Faith	ĩmãni,
).	su).
believe.	ĩmãni.
I	Ina
delusional &amp; gt;	delusional&gt;
Advanced	Advanced
significant	gagarumin
(UNT-Tech	(UNT-Tech
wife,	matar,
back	bãya
Apollo	Apollo
2,300	2,300
en	en
delight	murna
Fraering)	Fraering)
schedule.	jadawalin.
(No	(babu
references	nassoshi
disappears,	vuya,
by	by
Lantz)	Lantz)
(Dostoevsky)	(Dostoevsky)
d,	d,
June	Yuni
body	jikin
(62-mile)	(62-mile)
etching	etching
(Objectivity,	(objectivity,
Follow	bi
eyes	idanu
poor,	talakawa,
1610,	1610,
and	da
ordinary.	talakawa.
Teem	Teemu
?	ya?
&amp; Quot; objective &amp; quot;	&quot;haƙiƙa&quot;
(Do	(Shin,
Translation	fassarar
ordinary:	talakawa:
(&amp; Gt;	(da&gt;
location	wuri
eat	ci
.	ya.
said	ce
&#39;	&#39;mai
,	ya,
blank &amp; quot ;.	blank&quot;.
XT350	XT350
html>	ab245@cleveland.Freenet.Edu
Beep	Ihu
Public	Jama&#39;a
topics	batutuwa
statistics	statistics
html>	geb@cs.pitt.edu
centers	cibiyoyin
Speaking	magana
astronomers	falaki
ice	ice
stolen	sace
action	mataki
lower	ƙananan
``	``
Worlds	halittu,
treatment	magani
July	Yuli
Logically	Azancin
average	talakawan
&amp; Quot; back	&quot;mayar
fire	wuta
not	ba
prepared	tattalin
at	at
usual	saba
eye	ido
transfering	transfering
Law,	Law,
c:	c:
National	National
html>	franjion@spot.Colorado.EDU
denied	ƙaryata
memory	memory
treating	zalunta
c.	c.
JKN	JKN
Telephone	Tarho
ai	ai
today	yau
daughter	yar
January,	Janairu,
No,	A&#39;a,
an	an
s	yan
[1]	[1]
prophecies	annabce-annabce
expose	bijirar
realy	realy
target!	manufa!
Cadillac &amp; quot;	Cadillac&quot;
California	California
claim	da&#39;awar
of	of
target.	manufa.
delivered	tsĩrar
return	mayar
on	on
target,	manufa,
issue	batun
html>	schuster@panix.com
This	Wannan
more	yafi
texts	texts
slow	jinkirin
occasional	wuccin
mountain-sized	dutse-sized
Pilate	Bilatus
Lippard)	Lippard)
or	kõ
I),	ni),
repairs,	gyare-gyare,
Body	Jiki
pe	pe
&amp; Quot;	&quot;Na
pc	pc
pl	pl
fledged	fledged
amps,	amps,
pm	pm
amps.	amps.
comment	comment
stations,	tashoshin,
radiation	radiation
Member	Member
html>	psyrobtw@ubvmsb.cc.buffalo.edu
Yan	Yan
dos.	dos.
myselfe	myselfe
body.	jiki.
meteor	meteor
widely	yadu
Today	Yau
point:	batu:
wild,	daji,
&amp; Quot; I	&quot;Ni
Daughter	Yar
novices	novices
purpose	manufar
throw away	yada
sinusitis	sinusitis
too	ma
mb	mb
body,	jiki,
three.	uku.
world-sized	duniya-sized
Closure &amp; gt; &amp; gt;	ƙulli,&gt;&gt;
Why	me
Ditto.	Ditto.
point,	batu,
eye,	ido,
Messier	Messier
46904	46904
shipper	shipper
ms	ms
we	mu
inning	inning
tangled	garwaya
&amp; Quot; complete &amp; quot;	&quot;kammala&quot;
ink	tawada
I	na
is	ne
travel	tafiya
me	ni
p.	p.
weapons,	makamai,
Fahrenheit),	Fahrenheit),
idea	ra&#39;ayin
good	nagarta
these,	waɗannan,
Fahrenheit).	Fahrenheit).
Orbiters	Orbiters
praise	yabo
knife	wuka
html>	mock@watt.support.Corp.Sun.COM
P.S.	P.S.
beat	doke
cars	motoci
law	doka
like,	kama,
XQueryTree	XQueryTree
surgical,	m,
Corollas,	Corollas,
ki	ki
)	yi)
me.)	ni.)
to	ke
.	yi.
I	ina
,	yi,
you	ka
About	Kimanin
Bressler)	Bressler)
Jerusalem	Urushalima
you	ku
?	yi?
or	ko
m.	m.
home	gida
Rubenfeld)	Rubenfeld)
loose	sako-sako
Highlands	tsaunuka
&amp; Quot; cantaloupe &amp; quot;	&quot;cantaloupe&quot;
low.	low.
&amp; Quot;	&quot;mai
murmurs	murmurs
Baptism	Baftisma
as	kamar
power	iko
===========	===========
catastrophic	catastrophic
Orbiter,	Orbiter,
opinion.	ra&#39;ayi.
anticipated.	tsammani.
Orbiter.	Orbiter.
&#39;	da&#39;
hi	hi
&amp; Gt; &amp; gt; &amp; gt ;?	&gt;&gt;&gt;?
alt.psychology.personality!	alt.psychology.personality!
page.	shafi.
All	Dukan
amounted	amounted
ila	ila
opinion:	ra&#39;ayi:
to	yin
young	matasa
opinion?	ra&#39;ayi?
from &amp; quot;	daga&quot;
html>	livesey@solntze.wpd.sgi.com
Xelion	Xelion
html>	rauser@sfu.ca
puck	puck
____	____
default	tsoho
&amp; Quot;	&quot;Ka
music.	kida.
down.	down.
disclaimer	disclaimer]
Countries	Kasashen
must	dole
in	in
go	je
disclaimers	disclaimers
blue	blue
Hearing	ji
watching	kallon
draft	daftarin
pledge,	jinginar,
red	ja
healing	warkarwa
html>	COEGALON@LARC.NASA.GOV
Sharma)	Sharma)
&amp; Lt; belief	&lt;imani
&amp; Quot; allowed &amp; quot;	&quot;yarda&quot;
culture.	al&#39;adu.
YYY	YYY
Seats	xt
Question	Tambayata
seat	mazauni
Trondheim	Trondheim
&#39;	&#39;yana
PowerBook	Powerbook
Schaufenbuel	Schaufenbuel
bading@cs.tu-	bading@cs.tu-
VV	vv
upperleft	upperleft
&amp; Quot; I	&quot;Zan
taken	ɗauka
to	wa
carrying	ɗauke
my name,	sunana,
Lantz	Lantz
html>	nodrog@hardy.u.washington.edu
&amp; Lt; C4Hyou.1Iz@mentor.cc.purdue.edu&amp;gt;	&lt;C4Hyou.1Iz@mentor.cc.purdue.edu&gt;
Pull	Pull
vs	vs
teachers	malaman
insurance	inshora
airlift	airlift
that,	cẽwa,
sex &amp; quot ;.	jima&#39;i&quot;.
Calls	Kira
air	iska
wave &#39;	kaɗawa&#39;
(James	(James
11-15,	11-15,
is	yana
existence	kasancewar
(Hats,	(huluna,
matrix	matrix
we	mũ
deportes	deportes
Kinsley	Kinsley
parts,	sassa,
up	up
rethorical.	rethorical.
animals?	dabbobi?
part	part
&amp; Quot; Minnesota	&quot;Minnesota
I	nĩ
to	to
v.	v.
ISA.	ISA.
(Let	(bari
des	des,
Cephas	Kefas,
Please	roƙonka
ISA)	ISA)
(Marcus	(Marcus
des)	des)
Actually,	gaskiya,
pre-amp &amp; gt;	pre-amp&gt;
te	te
is	yake
true.	gaskiya.
crustal	crustal
Truth)	gaskiya)
fight	yaki
by	ta
to	su
markings	markings
cancellation	sakewa
men,	maza,
mystery	asiri
sm	sm
men.	maza.
smart	kaifin
Delaware,	Delaware,
wills	so
hte	hte
multiple	mahara
Texas	Texas
change.	canji.
deep	zurfi
html>	brenner@ldgo.columbia.edu
makes	sa
news.	labarai.
identify,	gano,
identified.	gano.
cracked	fashe
I	nã
The	&#39;Yan
months	watanni
copying	kwashe
Nereid,	Nereid,
PowerBook	powerbook
CHRISTIAN	Krista
System	System
&amp; Quot;	&quot;da
Christ	Kristi
competition.	gasar.
rolling	mirgina
-221	-221
flocking	flocking
html>	bressler@iftccu.ca.boeing.com
extending	mikawa
bridgehead	bridgehead
cities,	birane,
control &amp; quot; &amp; gt;	iko&quot;&gt;
requirements	bukatun
&#39;&#39;	&#39;&#39;
Banks)	Banks)
octagonal	octagonal
chains,	sarƙoƙi,
North &amp; quot;	Arewa&quot;
messages	sakonni
Activities	Ayyukan
orbiting	orbiting
forced	tilasta
silicate	silicate
280	280
report	rahoton
Brooks)	Brooks)
Arab	Arab
Streaming	yawo
January	Janairu
no	bãbu
28:	28:
see	gani,
Rumored	yayatawa
people	mutãnen
answer: &amp; gt;	amsa:&gt;
&amp; Quot; Bureau &amp; quot;	&quot;Bure&quot;
many	yawa
27,	27,
NHL.	NHL.
rivers	koguna
tribe	kabilar
html>	engp2008@nusunix.nus.sg
html>	winfrvk@dutiws.twi.tudelft.nl
Rifle	bindiga
40-22k	40-22k
html>	willisw@willisw.ENG.CLEMSON.edu
Systems	Systems
sneakers	sneakers
&amp; Quot; O	&quot;Yã
trial)	fitina)
propter	propter
hitter	hitter
583.	583.
Egalon	Egalon
fast-moving	azumi-motsi
will	zã
drum-shaped	drum-dimbin
&amp; Quot; What	&quot;Mene
ANTI-TRUST	zanga-TRUST
items	abubuwa
see	ganin
building	gina
famous	shahara
Watts	Watts
building	gini
reading,	karatu,
Cooperation	hadin
Paul:	Bulus:
29,	29,
through	hanyar
logo	logo
&amp; Lt; BADING.93Apr23105229@athene.cs.tu-berlin.de&amp;gt;	&lt;BADING.93Apr23105229@athene.cs.tu-berlin.de&gt;
talk.politics.guns	talk.politics.guns
groups!	ƙungiyoyin!
leveling	leveling
City	City
(Memory	(memory
hard	wuya
degrees	darajõji,
List	Jerin
rod.	sanda.
&amp; Quot;	&quot;a,
html>	pubinfo.jpl.nasa.gov
Snail	katantanwa
trial.	fitina.
prominent	shahararren
Promise	wa&#39;adin
End	Qarshen
24,	24,
Seeing &amp; gt;	gani&gt;
html>	caltech.edu
Bounty	falalarSa
240	240
Flex	lankwasa
indeed,	haƙĩƙa,
little	little
gist	gist
morning,	safiya,
teacher.	malami.
Journal	Journal
wounded	raunata
today.	yau.
243	243
Ming)	Ming)
Prescribing	Prescribing
Hays)	Hays)
(5.25	(5.25
perpetuate	perpetuate
word	kalmar
way:	hanya:
today,	yau,
way.	hanya.
&amp; Quot; more	&quot;mafi
Rotation	juyawa
24-bit	24-bit
way,	hanya,
doctors,	likitoci,
Shopper)	Shopper)
ISA	ISA
gentile	ummiyan
boy	yaro
they	sũ
kludgy	kludgy
&amp; Lt; not	&lt;basu
match	ze
children	yara
Bloom	Bloom
will	za
help	taimakawa
&amp; Quot; MAGIC &amp; quot; &amp; gt; &amp; gt;	&quot;MAGIC&quot;&gt;&gt;
Japan &amp; gt;	Japan&gt;
(Walter	(Walter
come	zo
250	250
(Henling	(Henling,
J23	J23
plate	farantin
25,	25,
to	ya
*****	*****
people,	mutãne,
(	(mai
word,	kalma,
Winding.	Winding.
encrypted	rufaffen
[&amp; Quot; People	[&quot;Mutanen
White	White
this	wannan
all	dukansu,
html>	berlin.de
&amp; Lt; 1r0vk6INNaft@cronkite.Central.Sun.COM&amp;gt;	&lt;1r0vk6INNaft@cronkite.Central.Sun.COM&gt;
do	yi
Brenner	Brenner
GetGeometry	GetGeometry
nothing.	kõme.
Iaccoca	Iaccoca
Shopper	Shopper
seriousness	muhimmancin
green	kore
Matrix	Matrix
more	mafi
effect &amp; quot;	sakamako&quot;
&#39;No	&#39;Ba
guidelines	jagororin
Mitsubishi	Mitsubishi
**************	**************
amatuer	amatuer
smudges	smudges
(Phil	(Phil
Spot,	Spot,
comic	comic
Pathfinder	Pathfinder
murder	kisan
hydrogen,	hydrogen,
hydrogen.	hydrogen.
Hiroki	Hiroki
name &amp; gt;	sunan&gt;
App	App
Hard	Hard
Apr	Apr
Sport	Sport
recommended	shawarar
company,	kamfanin,
chip.	guntu.
Pure-lovers	Tsarki-masoya
expected	saran
probably,	tabbas,
PowerBook)?	PowerBook)?
&amp; Lt; 1993Apr20.102756.1709@mala.bc.ca&amp;gt ;,	&lt;1993Apr20.102756.1709@mala.bc.ca&gt;,
Europe	Turai
ethics	xa&#39;a
Stony	Stony
start,	fara,
floppy..BURN	floppy..BURN
advice:	shawara:
(Ie,	(watau,
Weiss	Weiss
advice,	shawara,
destroyed	hallaka
field,	filin,
developer	developer
html>	hall@boi.hp.com
91%	91%
html>	pharvey@quack.kfu.com
more.	fi.
more	fi,
advice.	shawara.
burning	kona
fastball	fastball
html>	lippard@skyblu.ccit.arizona.edu
(Almost)	(kusan)
Zbib)	Zbib)
2000	2000,
hatred	ƙiyayya
specifics	ƙayyadaddu
(GIF,	(GIF,
drawing	jawo
Brian	Brian
created.	halitta.
border	iyakar
personal-computer	sirri-kwamfuta
Hawk	Hawk
Device	na&#39;ura
contact:	lamba:
North	North
lightning	walƙiya
US &amp; quot;	Amurka&quot;
points	maki
older	mazan
ever,	abada,
fax	fax
Posting	Posting
number	lambar
luck	luck
therapy	far
week	mako
fan	fan
974	974
Summary	Summary
State	jihar
diseases.	cututtuka.
you	maka
(872	(872
World	duniya
Store	Store
PROOFOF ::::	PROOFOF::::
hostilities	tashin
banschbach	banschbach
Amerika	Amerika
johnson)	johnson)
atomic	atomic
thread,	thread,
mags	mags
Creation	halittar
They	Sun
Jew &amp; quot;	Bayahude&quot;
(842	(842
Terms	Sharuddan
mail	mail
140.	140.
Toronto,	Toronto,
number.	lamba.
main	main
Nissan	Nissan
Europa	Europa
pre-amp	pre-amp
html>	billq@ms.uky.edu
HAD	KASANCE
Father.	Uban.
box	akwatin
So	Haka
Shadow	Shadow
Hunting	farauta
Headline	Kanun
selected	zaba
states	jihohi
poll	zabe
664-6354	664-6354
selected	zabi
Meteorology	meteorology
&amp; gt;	ba&gt;
-This	-This
orientation	fuskantarwa
Fiction	Fiction
echoed	echoed
Chips	Kwakwalwan
limit.	iyaka.
#From	#From
steam.	tururi.
========	========
eyes.	idanuna.
very	ƙwarai
Brothers	Brothers
Internet:	Intanit:
frank@D012S658.uucp	frank@D012S658.uucp
core-temperature	core-zafin
Right.	DMA.
as-is	as-ne
Krsek)	Krsek)
Uranus	Uranus
Halo	Halo
Hutchison	Hutchison
Internet	yanar-gizo
Word	kalma
Required	Bukata
Venus	Venus
mistake?	kuskure?
1959,	1959,
9:31	9:31
Noring	Noring
exhausted,	ƙãre,
good).	alhẽri).
mistake,	kuskure,
mistake.	kuskure.
encryption &amp; gt;	boye-boye&gt;
least	kalla
O&#39;Dwyer)	O&#39;Dwyer)
&amp; Quot; nameplates. &amp; Quot;	&quot;nameplates.&quot;
Other	Sauran
=========================	=========================
everyone	kowa
1958,	1958,
Contacts	lambobi
State	Jihar
distinctive,	rarrabe,
looking	kallo
forming	forming
woman	mace
Hans	Hans
Boston?	Boston?
critics	sukar
forgive	gafarta
html>	uu.net
teaching &amp; gt;	koyarwar&gt;
Yes	Na&#39;am
_CRAZY_?	_CRAZY_?
I	Ban
techniques,	dabaru,
techniques.	dabaru.
Disclaimer!	Disclaimer!
&amp; Quot; motorcycle, &amp; quot;	&quot;babur,&quot;
&amp; Quot; terminator &amp; quot ;,	&quot;Terminator&quot;,
94550	94550
security	jingina
Frmwrks	Frmwrks
Glance &amp; quot;	Glance&quot;
Music	Kida
Great	Babbar
&amp; Quot; healers &amp; quot;	&quot;healers&quot;
rippled	rippled
Circuits	haihuwarka
diagnoses?	diagnoses?
Galileo	Galileo
(317)	(317)
Galilei	Galilei
learn	koya
[Male]	[namiji]
Disclaimer?	Disclaimer?
Knowles &amp; quot;	Knowles&quot;
David.	David.
airless,	airless,
learn	koyi
learning	koyo
Great	Babban
aberrant	aberrant
&#39;Witness&#39;.	&#39;shaida&#39;.
Statistics	Statistics
html>	punjabi@leland.Stanford.EDU
study:	binciken:
million	miliyan
light,	haske,
comment	sharhi
light.	haske.
dishes.	jita-jita.
study.	binciken.
09:02:48	09:02:48
Yamakawa,	Yamakawa,
Promises &amp; gt;	alkawuran&gt;
Test	Gwada
&amp; Lt; This	&lt;Wannan
easy	sauƙi
twenty	ashirin
Clayton	Clayton
fields.	filayen.
radioactive	rediyoaktif
SuperVGA	SuperVGA
hypersensitivity	hypersensitivity
Learn.	Koyi.
Roth)	roth)
Israel	Isra&#39;ila
somwhere	somwhere,
Abu	Abu
difficult)	wuya,)
It	Shi
Malaspina	Malaspina
Hebrews]	Ibraniyawa],
visit	ziyara
V-Mail:	V-Mail:
light	hasken
&amp; Quot; white	&quot;fararen
style,	style,
&amp; gt;	ya&gt;
technique,	dabara,
comparatively	comparatively
e_mail:	e_mail:
Craig	Craig
m-word	m-magana
Meeting	gamuwa
mentioned.	ambata.
Sir	Sir
author	marubucin
tidal	tidal
power,	mulki,
VMS.	vms.
--------------------	--------------------
women	mata
BIOS	BIOS
darn,	darn,
lives	rayuwarsu,
be	zama
gun-club	bindiga-kulob
Peter &amp; gt;	Bitrus&gt;
Reliability	AMINCI
THE	THE
(From	(daga
prayer.	salla.
(Chris	(Chris
Member	memba
events,	faru,
pitied.	dski.
range	kewayon
machines	inji
orange	orange
photocell	photocell
hot	zafi
context	mahallin
outposts.	outposts.
new,	sabon,
sci.med	sci.med
(Darryl	(Darryl
rule	mulkin
Conclusion	Kammalawa
vfintd.386	vfintd.386
You	Zaka
men	maza
Macworld	Macworld
Bitnet	Bitnet
wide.	faɗi.
Denning	Denning
overriding	overriding
::	&#39;::
replacement	maye
wispy	wispy
devide	devide
between	tsakaninka
delete,	share,
----------------------------------------------	----------------------------------------------
large,	manyan,
happened?	faru?
resolve,	warware,
each	kowace
examples.	misalai.
sys.ini	sys.ini
pro-gun	pro-gun
drivers,	direbobi,
night.	dare.
examples,	misalai,
complete	cikasa
that	wancan
around.	kewaye.
Know:	Sanin:
Richard	Richard
TTL	TTL
info	info
St.	St.
:-)	:-)
astronomers	falakin
tomb	kabarin
boasted	boasted
white	fari,
Important	Muhimman
generators	janareto
statements &amp; gt;	kalamai&gt;
en,	en,
me	mani
bad	sharri
research	bincike
us	mana
html>	oak.oakland.edu:pub/msdos/windows3/winjp210.zip
Air	Air
Witness	Shaidar
&amp; gt;	zai&gt;
search	bincika
navigation	kewayawa
etc.)	sauransu)
rise.	tashi.
distinguishing	bayãnin
aid	agaji
Cuesta	Cuesta
Activity	Activity
appearance,	bayyanar,
long	dogon
Truth	Gaskiya
C.)	C.)
Dodson)	Dodson)
exploring	binciko
answer.	amsar.
translation	translation
night	daren
stock	jari
star,	star,
star.	star.
do.	aikatãwa.
nothing	kome
deceitful	fallacious
return	koma
&#39;NF&#39;	&#39;NF&#39;
will	zasu
Teaching	Koyar
recommendations.	shawarwari.
Lodge	zaunar
white	farin
&amp; Lt; 188@ky3b.UUCP&amp;gt;	&lt;188@ky3b.UUCP&gt;
BMP	BMP
TSC	TSC
fancy	zato
Tidal	Tidal
love &amp; gt;	son&gt;
Giotto	Giotto
Heights	Heights
grows	tsiro
house	gidansa,
volcanoes	volcanoes
freeware.	freeware.
(There	(akwai
part	bangare
life,	rayuwata,
use.	amfani.
Barton)	Barton)
wake	farka
design	zane
notch	daraja
wheel	dabaran
use,	amfani,
draw	zana
his	masa
survived	tsira
All	All
the	masu
we	zamu
parody	parody
First	farko
Southeast	maso
Ami	Ami
Formats,	Formats,
Formats.	Formats.
Genie:	Genie:
high-speed	high-gudun
each	kowane
Register	rijista
because	saboda
Shattered	rafke
E-mail	E-mail
Davis)	Davis)
lasting?	wanzuwa?
Crash	Crash
Nice	Nice
theory	ka&#39;idar
shipping).	shipping).
charges	zargin
C2.	C2.
Sol	Sol
Are	Ana
transistor?	transistor?
door	kofa
1-301-340-4543	1-301-340-4543
repair	gyara
benefits	amfanin
around	kewayen
().	().
resistive	resistive
medical &amp; gt; &amp; gt;	likita&gt;&gt;
time	lokaci
Alane	Alane
where	inda
(10-105	(10-105
compound &amp; gt;	fili&gt;
obstacles,	cikas,
all	dukkan
&amp; Gt; &amp; gt ;,	&gt;&gt;,
Road	Road
river	kogi
Delaware	Delaware
heavenly	samaniya
Children	&#39;ya&#39;yan
Finland	Finland
email:	email:
755-8742	755-8742
station	tashar
email.	email.
&amp; Gt; &amp; gt ;?	&gt;&gt;?
Galant,	Galant,
1970s.	1970s.
and programs	da-tsare
Layer	Layer
&#39;Clouds	&#39;girgije
cover,	cover,
Existence	wanzuwar
html>	jmilhoan@magnus.acs.ohio-state.edu
Pure,	Tsarki,
Source	Madogararsa
incidences	bijiro
html>	gt7469a@prism.gatech.edu
died.	mutu.
1312	1312
white	fararen
die,	mutu,
Science	kimiyya
altitudes.	altitudes.
family	mutãnensa
Law &amp; quot;	Attaura&quot;
thyroid	thyroid
1949.	1949.
Buy	Buy
(	(zuwa
high &amp; gt;	high&gt;
Juliet.	Juliet.
out	fito
good &#39;	kyau&#39;
Replay	Replay
(6)	(6)
University	Jami&#39;ar
of course,	shakka,
out	fita
(59	(59
arcs	arcs
1948:	1948:
Adaptec	Adaptec
especially,	musamman,
shirts,	shirts,
8.6	8.6
Thermocouple	THERMOCOUPLE
gif	gif
1948,	1948,
year-long	shekara-dogon
arab	arab
(5)	(5)
yesterday,	jiya,
Meeting,	gamuwa,
Umbriel	Umbriel,
man	mutum
Examination	jarrabawa
effective	tasiri
American	Amirka,
Lions &amp; gt;	.com&gt;
Asteroids	Asteroids
Page)	Page)
Dream.	Mafarki.
(	(sunã
Barton	Barton
continent.	nahiyar.
greeted	gaishe
(4)	(4)
Landmann &amp; gt;	Landmann&gt;
tangents.	tangents.
Momentary	yanzu-yanzu
Days	Kwanaki
hydrogen	hydrogen
plots	mãkirci
Lord	Ubangijinku,
Harman	Harman
(32	(32
very large	manya-manyan
closed	abar
(3)	(3)
Ru?	Ru?
eccentricity	eccentricity
variaty	variaty
[26]	[26]
theories	theories
end,	karshen,
&amp; Quot; Pink	&quot;Pink
(27	(27
outer	matsanancin
metal	ƙarfe
strength	ƙarfi
example.	misali.
Sometimes,	lokatai,
estimates.	kiyasin.
for example,	misali,
(2)	(2)
recovery	maida
buried,	binne,
Miranda,	Miranda,
======================	======================
Pioneer	Majagaba
Miranda.	Miranda.
Celsius	Celsius
82:	82:
(1)	(1)
windows,	windows,
laws, &amp; gt;	dokokin,&gt;
windows.	windows.
(6,118	(6,118
jps &amp; gt;	jps&gt;
dust	turbaya
============================================	============================================
(745	(745
[23]	[23]
trade,	cinikayya,
Dancing	Dancing
LaStrange)	LaStrange)
crookedness	karkata
detail.	daki-daki.
goaltender	goaltender
imagery	hasashe
fix.	fix.
[24]	[24]
example	misalin
electronic	lantarki
Christians	Kiristoci
Elders	dattawan
Earth	Ƙasã,
Pure.	Tsarki.
stay,	zauna,
[25]	[25]
sat.	zauna.
which,	wanda,
satisfies	kosad
Iraq	Iraki
speakers	jawabai
principles	ka&#39;idodin
letter	wasika
resolution?	ƙuduri?
&amp; Quot; Pavel	&quot;Pavel
X11R4.	X11R4.
thanks.	godiya.
html>	I3150101@dbstu1.rz.tu-bs.de
html>	jh6r@andrew.cmu.edu
vary	bambanta
five	biyar
IBM?	IBM?
James,	James,
thanks,	godiya,
Quest	nema
students,	dalibai,
warning	gargaɗi
And	Sai
thanks!	godiya!
Sam	Sam
sought	nemi
computer	kwamfutarka
imprints	ragowar
Franjione)	Franjione)
Cramer)	Cramer)
(?)	(?)
Triantafyllopoulos	Triantafyllopoulos
&amp; quot;	kai&quot;
weight.	nauyi.
weight,	nauyi,
plutoneon	plutoneon,
gas	gas
concluded	kammala
gay	gay
IBM.	IBM.
Jews &amp; gt;	Yahudawa&gt;
&amp; Lt; id.XNFZ.VJ8@nmti.com&amp;gt;	&lt;id.XNFZ.VJ8@nmti.com&gt;
community &amp; quot ;,	al&#39;umma&quot;,
see	gan
more	fiye
hander	hander
good.	kyau.
slots,	ramummuka,
=====================================	=====================================
9.846	9,846
posted	posted
good	kyau,
hobbiest	hobbiest
nickel.	nickel.
incest	lalatar
(Richard	(Richard
html>	c23st@kocrsv01.delcoelect.com
acetylene,	acetylene,
other &amp; gt;	sauran&gt;
6x9	6x9
Games,	wasannin,
receiver)	karɓar)
base,	tushe,
Times	Sau
wave	kaɗawa
exceptions.)	ware.)
newer	sabo-sabo
San	San
(Scott	(Scott
resources,	albarkatun,
storm	hadiri
Q4	Q4ayata,
entertainment.	liyãfa.
investment,	jari,
Canadiens	Canadiens
attaches	ɗora
weather,	weather,
subscription	biyan
marriage,	aure,
weather.	weather.
beautiful	kyaun
.	wa.
battery	batirin
Khan	Khan
Kinsey	Kinsey
traffic?	zirga-zirga?
&amp; Quot; health	&quot;kiwon
what	abin
The guardian	riqo
xterm	xterm
Dream &amp; quot;	Mafarki&quot;
753-3245,	753-3245,
view,	duba,
shorelines,	shorelines,
damage.	lalata.
&amp; Quot;	&quot;sai
Rosa	Rosa
Rockville,	Rockville,
I suppose	ganina
&#39;Rings	&#39;zobba
Research	Research
pretty	kyawawan
omitted.	tsallake.
(95	(95
(93	(93
source	tushen
ammonia	ammonia
exclusive	tsattsarkar
etiologic	etiologic
advise	shawarta
paid.	biya.
Apparently,	fili,
html>	cj195@cleveland.Freenet.Edu
final	karshe
stylizied	stylizied
Agency	Agency
Ancient	Ancient
uunet.	uunet.
(88	(88
ESPN	ESPN
Car	Car
Energy	makamashi
bounce?	billa?
uunet!	uunet!
Bashing?	Bashing?
speech	jawabin
stop).	tsayar).
Insurance	Inshora
1,200	1,200
show,	nuna,
show.	nuna.
untreatable	untreatable
field	filin
comic,	comic,
examples	misalai
ed &amp; quot ;,	ed&quot;,
html>	korenek@nmti.com
HE	SHI
Accessories	Hadi
Whether	Shin,
Note	lura
particles	gaɓãɓuwa
windowed	windowed
characteristic	halayyar
left	hagu
used	takan
Harumph.	Harumph.
&amp; Quot; let	&quot;bari
constraints	constraints
exposed	fallasa
very),	sosai),
frozen	daskararre
it).	shi).
Nelson)	Nelson)
maintained.	kiyaye.
access.	damar.
A &amp; gt;	A&gt;
Zbib	Zbib
goals,	raga,
whirling	whirling
VanHeyningen	VanHeyningen
guest	baƙo
faith	bangaskiyarku
black	baƙi
baseball.	baseball.
(No	(Ba
allowing	kyale
fuse	fus
those	waɗanda
SKS	SKS
thanks	godiya
dark	duhu
muted	muted
Church	Ikkilisiyar
html>	leonard@aix3090b.uky.edu
hurt,	cuce,
already	riga
fields	filayen
paperwork	paperwork
(My wife).	(matata).
rock	falalen
Bacteria.	Kwayoyin.
00ecgillespi@leo.bsuvc.bsu.edu&amp;gt;	00ecgillespi@leo.bsuvc.bsu.edu&gt;
new	sabuwar
thing,	abu,
artistically	artistically
including	hada
combination	hade
bread	burodi
&amp; gt;	tare&gt;
Citizen	Citizen
all	duka
415-	415-
worthless	banza
agressive.	agressive.
parented	parented
Our family	gidanmu
&amp; Quot; jargonese &amp; quot;	&quot;jargonese&quot;
Kirk.	Kirk.
Agreement	yarjejeniyar
particles,	barbashi,
&amp; Lt; jh6r+@andrew.cmu.edu&amp;gt;	&lt;jh6r+@andrew.cmu.edu&gt;
satisfactory	gamsarwa
size	size
hitter.	hitter.
all?	duk?
content	abun
Robert	Robert
display,	nuni,
[	[wata
hitter)	hitter)
offer	tayin
hitter,	hitter,
When	lõkacin
&amp; gt;	iya&gt;
SER	SER
SET	SET
compatible &amp; quot;)	jituwa&quot;)
including	haɗa
role	rawar
believe	ĩmãni
Re:	Re:
title	take,
shame	kunya
Red	Red
lives	rayuwarsu
property	dukiya
outs	saɓani
April	Afrilu
Acting	riko
posts	posts,
Laws	Dokokin
Full	Cikakken
rules	dokoki
spiral	karkace
megatest.com &amp; gt ;,	megatest.com&gt;,
millions).	miliyoyin).
hold	rike
lurk	lurk
distance	nesa
chip-set	guntu-sa
&amp; Quot; Jonathan	&quot;Jonathan
html&gt;	html>
flash	flash
SPL	SPL
via	via
create	ƙirƙirar
for	for
&amp; Quot; Home	&quot;Home
two)	biyu)
As	Kamar
two.	biyu.
two,	biyu,
Foo	foo
values	dabi&#39;u
).	da).
Memory	kwakwalwa
two:	biyu:
COD	COD
---------------------	---------------------
York	York
Six	Shida
two?	biyu?
tilted	tilted
POBox	POBox
(Tvtwm).	(tvtwm).
pin.	fil.
offer,	tayin,
difference	bambanci
Ron	Ron
FROM:	DAGA:
base	tushe
high-pressure	high-matsa
Aeronautics	Aeronautics
benefit	amfana
(Mike	(Mike
do	aikata
speed	bugun
Perhaps,	yiwu,
(Martin	(martin
HITTER	HITTER
Crawford	Crawford
messengers.	manzanni.
messengers,	manzanni,
Dual	dual
(	(Ka
yarmulke	yarmulke
Submit	sallama,
PowerBook	PowerBook
Rifle &amp; gt;	bindiga&gt;
Lyme,	Lyme,
Treatment	jiyya
(Or	(Ko
800m.	800mA.
(Family	(Family
Grounding	Grounding
king.	sarkin.
phrases	phrases
more	ƙarin
Spot	Spot
use	amfani
lot.	yawa.
&amp; Quot; Personal	&quot;Personal
thousand	dubu
(Especially	(musamman
device	na&#39;urar
Jupiter	Jupiter
profit	riba
many)	yawa)
(J.	(J.
274-5357	274-5357
sure	tabbata
&amp; Lt; 1993Apr21.234159.1206@ualr.edu&amp;gt;	&lt;1993Apr21.234159.1206@ualr.edu&gt;
speed	gudun
century	ƙarni
Gained	tsiwirwirinsu
&amp; Quot; Drakula &amp; quot;	&quot;Drakula&quot;
flank	flank
cars.	motoci.
...]]	...]]
loss.	asara.
regulators.	gwamnoni.
and	alhãli
(Edward	(Edward
Many?	yawa?
view	duba
next &amp; gt;	gaba&gt;
Look	dubi
laws,	dokokin,
population	yawan
pin	fil
star	tauraro
full	cikakken
great	manyan
Messengers	Manzanni
Matsuo,	Matsuo,
Baptism &amp; gt;	Baftisma&gt;
scheme	makirci
options.	zažužžukan.
fuse	fis
counterparts	takwarorinsu
partners.	abokan.
stars	taurari
fix	fix
park	shakatawa
partners,	abokan,
run.	gudu.
run,	gudu,
and &amp; quot;	da&quot;
Columbia &amp; gt;	Columbia&gt;
Apparently	fili
Finally &amp; gt;	karshe&gt;
Bos	Bos
90%	90%
video	video,
Jupiter,	Jupiter,
Exporting	aikawa
: &amp; gt; &amp; gt;	cewa:&gt;&gt;
BUFFERS	BUFFERS
Implementation	aiwatarwa
90,	90,
Jupiter.	Jupiter.
Advancements	Advancements
Jupiter;	Jupiter;
Planners	tsarawa
Herschel.	Herschel.
different	dabam-dabam
Inc.,	Inc.,
Vehical	Vehical
shell	ɓawon
html>	sharma@tiger.vill.edu
line?	line?
&amp; gt;	su&gt;
training	horo
fight	yãƙi
weak	rauni
this:	wannan:
peers).	takwarorina).
27.6	27,6
asymmetric	asymmetric
faulting	faulting
inventory	kaya
encryption &amp; quot;	boye-boye&quot;
this?	wannan?
pass	auku
above	bisa
which,	wadda,
video	video
(&amp; Lt; o &amp; gt;	(&lt;o&gt;
fixing	kayyade
animation	animation
this.	wannan.
^^^^^^^^^^^^^^^^^^^^^^^^^^	^^^^^^^^^^^^^^^^^^^^^^^^^^
illusions	kawayeniya
this,	wannan,
Low	Maras
etc. &amp; gt; &amp; gt;	sauransu&gt;&gt;
xelion!	xelion!
Controversial	rigima
Neptunian	Neptunian
&amp; Quot; there	&quot;akwai
73,	73,
Friedman	Friedman
Scarring	Scarring
CHRIST:	KRISTI:
instead	baicin
appearance	bayyanar
&amp; Lt; pgf.735012282@srl03.cacs.usl.edu&amp;gt ;,	&lt;pgf.735012282@srl03.cacs.usl.edu&gt;,
?	da?
Callsign:	Callsign:
picture	hoto
Station	Station
names	sunayen
27.2	27.2
proven &amp; gt;	tabbatar&gt;
(Detroit,	(Detroit,
Ocean	tekun
&amp; Quot; smog &amp; quot;	&quot;smog&quot;
Therapy!	Far!
and,	da,
Disks	DISKs
measured	auna
)	da)
Lampoon_	Lampoon_
Asteroid	Asteroid
1,500	1,500
Selannes	Selannes
Recognition.	LURA.
bring	kawo
!	da!
contact	tuntubi
Attempt	Yunƙurin
N-8-1.	N-8-1.
contact	tuntube
&amp; Quot;	&quot;wanda
electronically	electronically
line.	line.
.	da.
410-34-1	410-34-1
files	fayiloli
Software	Software
West	Yammacin
magic	sihiri
promises	alkawuran
700	700
gods.	alloli.
703	703
quarter &amp; gt;	kwata&gt;
G20,	G20,
Years	Shekaru
stone-pocked	dutse-pocked
However	dai
Microsoft	Microsoft
Maplewood	Maplewood
code	code
dc)	dc)
G20.	G20.
DX)	DX)
recharge	recharge
carry on	cigaba
&amp; gt;	wannan&gt;
son	dan
course &amp; gt;	shakka&gt;
Fax:	Fax:
Lee)	Lee)
protect	kare
paraphrase:	fasara:
speculating	speculating
Extensions	kari
Hiroshi	Hiroshi
sci.med	sci.med,
phone:	wayar:
Nanaimo	Nanaimo
&amp; Lt; o &amp; gt;)	&lt;o&gt;)
further	kara
These	Wadannan
Christ,	Almasihu,
Attend	halarci
Christ.	Almasihu.
7.5	7.5
time	karo
Kennedy	Kennedy
indistinct	indistinct
html>	cl056@cleveland.Freenet.Edu
(Spiros	(Spiros
&amp; Lt; space &amp; gt;	&lt;sarari&gt;
ground	kasa
cloak	alkyabbar
html>	&lt;1APR199313404295@skyblu.ccit.arizona.edu
200uf	200uf
dawn,	alfijir,
Pushing,	Turawa,
Brenda	Brenda
(61302	(61302
Ave.	Ave.
redrawn	redrawn
plans	tsare-tsaren
Henry	Henry
Whitten	Whitten
strong.	ƙarfi.
html>	zbib@bnr.ca
millitary	millitary
html>	betel@camelot.bradley.edu
&amp; Quot; Skepticism	&quot;Wasi-wasi
views	ra&#39;ayi
Shipping	Shipping
&amp; Lt ;,	&lt;,
desperately	iyakacin
Lines	Lines
(Provided	(azurta
McCord,	McCord,
to	zuwa
top &amp; quot;	saman&quot;
Pressure:	Turawa:
? &amp; quot;	ta?]&quot;]
jesus	jesus
groups,	kungiyoyin,
US	Amurka
24:46,	24:46,
auto	auto
DOSKEY	DOSKEY
Possibility	Yiwuwar
events	al&#39;amura
Pentium	Pentium
_outside_	_outside_
Medicare	Medicare
(1,430	(1,430
html>	rauser@fraser.sfu.ca
pictures	hotuna
empiric	empiric
League,	League,
&amp; Lt;	&lt;na
League.	League.
Colorado,	Colorado,
power	ƙarfin
involved	akayi
HMMMMMMMMMMMMMMMMMMMMMMMMMMMMMMMMMMMMMMMMMMMMMMMMMMMMMMMMMMM	HMMMMMMMMMMMMMMMMMMMMMMMMMMMMMMMMMMMMMMMMMMMMMMMMMMMMMMMMMMM
issues.	al&#39;amurran.
rights	hakkokin
payments	biya
review.	bitar.
(Severy)	(severy)
Voyagers	Voyagers
(	(kasance
question)	tambaya,)
articles	articles
Baptist	Maibaftisma
And	Alhãli
links	links
Price	Farashin
zone,	zone,
Oberon	Oberon
brenner)	brenner)
it .....	shi.....
.....	.....
Van	Van
two	biyu
partially	partially
&amp; Lt; 2958804@QUCDN.QueensU.CA&amp;gt;	&lt;2958804@QUCDN.QueensU.CA&gt;
sunlit	sunlit
Wai-Ming	Wai-Ming
Legislature	Majalisun
home	gida,
related	related
home.	gida.
1979,	1979,
&#39;Arms&#39;	&#39;makamai&#39;
stated,	bayyana,
1979.	1979.
Help:	Taimakon:
clear.	bayyana.
offered	miƙa
consumer	mabukaci
printer	firinta
(Euro-bashing?)	(Yuro-Bashing?)
Frameworks	frameworks
html>	gt7469a@prism.gatech.EDU
Frank	Frank
switch	canjawa
MUSCLE	TASHIN
Nice.	Nice.
622121	622121
DiGi-Key	Digi-Key
gun-license	bindiga-lasisi
treatment &amp; gt;	magani,&gt;
circling	circling
1978	1978,
&amp; Quot; objective	&quot;haƙiƙa
placebo	placebo
1978.	1978.
Kreiling)	Kreiling)
Son	Dan
less &amp; gt;	kasa&gt;
Region	Regio
&amp; Quot; arab? &amp; Quot;	&quot;arab?&quot;
expansion	fadada
house	gidan
low-density	low-yawa
sins.	zunubanku.
Indonesia.	Indonesia.
sins,	zunubanku,
orbiters	orbiters
honored	girmama
Hiram	Hiram
html>	goolsbey@cs.utexas.edu
&#39;Conditions	&#39;yanayi
dozen	dozin
facts	hujjoji
record	rikodin
flow	ƙarƙashinsu
involve	unsa
&amp; Quot; You	&quot;Kai
Faehl	Faehl
1976	1976,
Friedman:	Friedman:
Technology	Fasaha
marriage	aure
Final	Karshe
disk,	faifai,
weight	nauyi
Last year,	bara,
VLB	VLB
32-bit	32-bit
across	fadin
1974.	1974.
1974,	1974,
Deletion	shafewa
ice.	kankara.
html>	king@reasoning.com
ice,	kankara,
486DX-33	486DX-33
4.0-4.3	4.0-4.3
Martian	Martian
measured.	auna.
Mars?	Mars?
undocumented	undocumented
Mars,	Mars,
Steve	Steve
Mars.	Mars.
VLX	VLX
strong,	karfi,
Action	Mataki
1975	1975,
agencies	hukumomin
?	kai?
R &amp; gt;	R&gt;
DLC	DLC
messenger,	manzo,
html>	blaisec@sr.hp.com
Three	Uku
mother	uwa
check	rajistan
King)	Sarki)
component	bangaren
creator	mahaliccin
Um,	Um,
wide,	fadi,
regions	yankuna
Huygens,	Huygens,
1972,	1972,
escape	kubuta
Mocker)	Mocker)
Right	DMA
1970s	1970s
&amp; Quot; help	&quot;taimaka
,	kai,
Access	Samun
.	kai.
1973,	1973,
&amp; gt;	daya&gt;
&amp; gt;	cewa&gt;
possession	mallaki
(Hal	(Hal
Mitsubushi	Mitsubushi
design.	zane.
Montreal,	Montreal,
coma	coma
own	mallaka
reference	zance
----	----
set	kafa
(Henry	(Henry
up).	up).
part.	bangare.
belts,	belts,
encryption &amp; quot; &amp; gt;	boye-boye&quot;&gt;
Mexico,	Mexico,
&#39;	&#39;to
______________________________________________	______________________________________________
(But	(amma
sleep	barci
&amp; Lt; May.12.04.27.47.1993.9935@athos.rutgers.edu&amp;gt;	&lt;May.12.04.27.47.1993.9935@athos.rutgers.edu&gt;
molten	zubi
html>	ron.roth@rose.com
Formats	Formats
Cooperation	haɗin
answer	amsar
authority	dalĩli
unethical	unethical
Finally.	ƙarshe.
7.3.	7.3.
answer:	amsa:
&amp; Quot; nameplate &amp; quot;	&quot;nameplate&quot;
Finally,	ƙarshe,
specs	tabarau
1971,	1971,
modified	modified
spinning	kadi
single.	guda.
&#39;93).	&#39;93).
single	guda,
Purpose	Manufar
do	kada
dispute	husũma
outs	sabani
good	alhẽri
chips	kwakwalwan
(317)743-1394	(317)743-1394
(Error),	(kuskure),
how	yadda
integrity &amp; gt;	kirki&gt;
Mike	Mike
(2,544	(2,544
strong &amp; gt;	ƙarfi&gt;
&#39;Ve	&#39;ve
Multi-ethnic	Multi-kabilanci
140-165	140-165
sun4nl!	sun4nl!
(Claudio	(Claudio
listen	saurari
cases	lokuta
Greetings,	Gaisuwa,
power	karfin
Computers	Computers
end	ƙarshen
html>	batman@cisco.com
pour	zuba
Comer,	cometa,
(-290	(-290
drive,	drive,
Earth-sized	Duniya-sized
sources	kafofin
(-298	(-298
core	core
DATE:	DATE:
King	Sarkin
said:	ce:
off,	kashe,
[Example	[misali
March	Maris
implementation	aiwatar
glitter	kyalkyali
out,	fitar,
Engineering	Engineering
said,	ce,
said.	ce.
Diffie-Hellman	Diffie-Hellman
tiff	tiff
level	matakin
8.1	8.1
hours	hours
up.	up.
World &amp; gt;	duniya&gt;
up	up,
differences	bambance-bambance
Rosenau)	Rosenau)
accuracy.	daidaito.
public-key	jama&#39;a-key
&amp; Quot; You	&quot;Kun
peg,	fegi,
three	uku
motorcycle.	babur.
_____________	_____________
Club	Club
views	ra&#39;ayoyi
part	ɓangare
Thanks	gode
God.)	Allah.)
advice	shawara
encryption,	boye-boye,
materials.	kayan.
Mouting	Mouting
encryption)	boye-boye)
(5,000	(5,000
doctor	likita
North	arewacin
html>	alane@microsoft.com
hit &amp; gt;	hit&gt;
afronted	afronted
Rhode	Rhode
Theodore	Theodore
vegetation	ciyayi
you	kana
Japan	Japan
nothing.	kome.
Church.	Church.
blend	gauraya
asteroids	asteroids
Member	mamba
addicted	kamu
SUV	landiroba
radar	radar
DEVICEHIGH	DEVICEHIGH
motorcycles	babura
Springs,	Springs,
other.	sauran.
catch	kama
oil	fetur
service	hidima
Le	&#39;le
experience.	kwarewa.
impedance.	impedance.
CLR	Clr
on?	kan?
experience,	kwarewa,
gaps,	gibba,
bruise	uje
com1	com1
cool,	sanyi,
Power	Power
Stein	Stein
(As	(kamar
format	format
&amp; Lt; 1993Apr21.032427.22464@leland.Stanford.EDU&amp;gt ;,	&lt;1993Apr21.032427.22464@leland.Stanford.EDU&gt;,
encryption.	boye-boye.
mediator	matsakanci
(-235	(-235
Gretzky	Gretzky
nothing	komai
559.	559.
powered	powered
designer	zanen
England	Ingila
small	ƙanana
DOS	DOS
(Leonard	(Leonard
&amp; Lt; 1qvb5aINNmoi@darkstar.UCSC.EDU&amp;gt ;,	&lt;1qvb5aINNmoi@darkstar.UCSC.EDU&gt;,
Law &amp; gt;	Attaura,&gt;
clicks	akafi
article,	kasida,
care,	kula,
care.	kula.
Coping &amp; gt;	fama&gt;
(	(har
draw,	kusantar,
Lowest	Magangara
microsoft	microsoft
veneer	veneer
Path	ɗã&#39;a
autumn	kaka
Deptt.	Deptt.
Canucks)	Canucks)
eating	cin
comfort	sanyin
definition	definition
general.	general.
design,	zane],
(Michael	(Michael
Cool.	Sanyi.
Promise	Alkawari
everywhere,	ko&#39;ina,
human	adam
fever	zazzabi
chances	chances
(Spain)	(Spain)
[Ped]	[ped]
Safety &amp; quot;	Safety&quot;
comfortable	dadi
Gaza	Gaza
means	nufi
bits	ragowa
utzoo!	utzoo!
opposition	adawa
address	nufa
Magnetic	Magnetic
: -) &amp; Gt; &amp; gt;	:-)&gt;&gt;
images.	images.
FAQ	FAQ
parties	jam&#39;iyyun
html>	sguerke@brahms.udel.edu
html>	koutd@hiramb.hiram.edu
Pearl	lu&#39;ulu&#39;u
card,	katin,
card.	katin.
Hell &amp; gt;	Jahannama&gt;
Flyby	Flyby
weapon	makami
point-of-view.	batu-na-view.
V9R	V9R
man	mutumin
Mongols	mangolawa
&amp; Quot; last &amp; gt;	&quot;karshe&gt;
key &amp; quot ;.	mažalli&quot;.
Stalin	Stalin
homosexual	kishili
manager	sarrafa
statements	maganganun
league!	league!
steps	matakai
league.	league.
Online	layi
23-25).	23-25).
&amp; Quot; homosexual	&quot;kishili
suitable	dace
korenek)	korenek)
committ	committ
standing.	tsaye.
Schemes	makircinsu
days	kwanaki
packaged	kunsasshen
copy	kwafin
feature &amp; gt;	alama&gt;
Cleopatra.	Cleopatra.
detail	daki-daki
bodies,	gawarwakin,
miscommunication.	miscommunication.
original &amp; gt;	asali,&gt;
which	wanda
low-pressure	low-matsa
destroyed &amp; quot;	halaka&quot;
long	dade
lmouse	lmouse
increase	dada
&amp; Quot; lock	&quot;kulle
(For example,	(misali,
Almost	Kusan
(Eg)	(misali)
city	birnin
stage.	mataki.
Newtonian	Newtonian
99.9	99.9
(29.95)	(29.95)
Establish	tsayar
understood	fahimci
himself,	kansa,
welcome &amp; gt;	maraba&gt;
Mariners.	Mariners.
contains &amp; gt;	kunshi&gt;
html>	nelson_p@apollo.hp.com
Camera	kamara
(932	(932
Dorothy	Dorothy
pipe.	bututu.
.indiana.edu	.indiana.edu
Resources	Resources
6-7	6-7
son	dansa
fine-tune	lafiya-tune
stand,	tsaya,
&amp; Quot; Konstantinov &amp; quot;	&quot;Konstantinov&quot;
won	lashe
6.4	6.4
Father	uba
points,	maki,
Radio	Radio
a,	wani,
Central	tsakiya
RETURN	SAMA
chunk	bantara
hockey,	hockey,
drivers-license	direbobi-lasisi
device,	na&#39;urar,
adulation &amp; gt;	adulation&gt;
THEWITNESS	THEWITNESS
experience	kwarewa
ax	gatari
Corinthians	Korantiyawa
Donut &amp; quot;	Donut&quot;
&amp; Quot; significant &amp; quot;	&quot;muhimmanci&quot;
call.	kira.
recipient,	karɓa,
Products	Kayayyakin
percent.	kashi.
should	kamata
POSTITION	POSTITION
times &amp; gt;	sau&gt;
lack	rashin
disease. &amp; quot;	cuta.&quot;
waiiiiiit	waiiiiiit,
Because	Saboda
S5R3.2).	S5R3.2).
&#39;M&#39;:	&#39;m&#39;:
than	wanin
Must	Dole
Charon,	Charon,
actually,	hakika,
adjust,	daidaita,
median	tsakãtsaki
Center	Center
window).	taga).
enough	isasshen
decoration.	ado.
4th	4th
&#39;	ga&#39;
display	nuni
Shostack	Shostack
heading:	ashin:
thousand &amp; gt;	dubu&gt;
frigid	frigid
System, &amp; quot;	System,&quot;
Dwarf &amp; quot;	Dwarf&quot;
Hughes	Hughes
change.	sauya.
1968.	1968.
escalated	escalated
beeps.	beeps.
294-8153	294-8153
locked	kulle
deals	kulla
Montes,	Montes,
hardware	hardware
Germany,	Jamus,
redraws.	redraws.
circle	da&#39;irar
(900	(900
ethically	ethically
information	bayanai
flights	flights
Manager	Sarrafa
openlook.	openlook.
justice	adalci
Dodson	Dodson
shows	nuna
VDC	VDC
cool	sanyi
sharp	kaifi
Windows.	Windows.
5X9	5X9
rock.	dutsen.
rock,	dutsen,
installation	shigarwa
Law &amp; gt;	Attaura&gt;
traditions.	hadisai.
(John	(Yahaya
compensation	fansa
Landers	Landers
John?	Yohanna?
Gary	Gary
made	sanya
Georgia	Georgia
Hotan	hotan
html>	vax839@tid.es
wearing	sanye
Bake	Gasa
human.	adam.
gleaned	gleaned
week,	mako,
human,	adam,
Identified	Gano
html>	MLINDROOS@FINABO.ABO.FI
Crazy	Gans
VGA	VGA
information:	bayani:
Exodus	Fitowa
640	640
information?	bayani?
Thousands	Dubban
labels	tasirin
ongoing.	gudana.
club	kulob
Galilean	Bagalile
Yes.	Ee.
armada	armada
1965,	1965,
wanna	wanna
(10,000	(10,000
solution.	bayani.
(JT)	(JT)
diseases	cututtuka
court	kotun
Signs	ãyõyin
About	Game
(same to you	(kuma
flag	flag
since	tun
Mercury,	Mercury,
For	Gama
fuels	haɓaka
Mercury.	Mercury.
1964,	1964,
Diplomacy	Diplomasiyyar
proud	alfahari
Marty	Marty
(I	(Ina
Atkinson	Atkinson
(JPL	(JPL
stuck	makale
above).	bisa).
held	gudanar
486DLC-33	486DLC-33
Specialty	fanni
layout	layout
1967,	1967,
Brian,	Brian,
star	tauraron
faith &amp; gt;	bangaskiya&gt;
VHS	VHS
Comparisons	Kwatancen
cypher	cypher
born	haifi
Houston	Houston
counterclockwise	counterclockwise
lava	lawa
650	650
APPRECITATED.	APPRECITATED.
FBI	FBI
quibble-	quibble-
Virago	Virago
Carlos	Carlos
death	mutuwa
to	don
hi	sannu
mock	izgili
html>	km@ky3b.pgh.pa.us
ions	ions
Sanjeev	Sanjeev
dos	dos
With	Tare
fraud	zamba
baseball	baseball
(Other than	(wanin
(-366	(-366
DPI	dpi
Pontius	Buntus
html>	Nunnally@acs.Harding.edu
session	zaman
(Matt.	(Matt.
American	American
windows	windows
good	kirki
canyons,	canyons,
output	fitarwa
Canada	Canada
interested	sha&#39;awar
man	mutum,
Baerecke)	Bading)
man.	mutum.
Siemon)	Siemon)
focus	hankali
unalterably	unalterably
myself	kaina
Jose,	Jose,
Note	Lura
six	shida
data	data
400dpi)	400dpi)
1962	1962,
fog.	hazo.
be?	zama?
Signal	sigina
The	The
Logitech	Logitech
features,	fasali,
northeners	northeners
harmful	cutarwa
Few	&#39;yan
features.	fasali.
AutoCAD	AutoCAD
Thu	Thu
terms	sharuddan
League	League
,	zama,
figure	adadi
interest)	sha&#39;awa)
(Edmonton,	(Edmonton,
auroral	auroral
(Dave	(Dave
School	School,
auroras	auroras
The slow	&#39;jinkirin
Granny)	Brenn)
)	zama)
Tim	Tim
Granny,	Brenn,
(1,500	(1,500
256k	256k
optilink	optilink
html>	newsdesk@jplpost.jpl.nasa.gov
Two	Biyu
exchange,	musayar,
understand	fahimta
fiction	almarar
&amp; Lt; 1993Apr7.221357.12533@lamont.ldgo.columbia.edu&amp;gt;	&lt;1993Apr7.221357.12533@lamont.ldgo.columbia.edu&gt;
enteritis	enteritis
Fade	Fade
hoax	hoax
age &amp; gt;	shekaru&gt;
strong,	ƙarfi,
av	dari
fallout	fallout
night	dare
then	to,
Christian &amp; gt;	Krista&gt;
html>	stephen@orchid.UCSC.EDU
Briefly,	takaice,
knowing	sanin
all	duk
Unfortunately	takaici
Briefly	takaice
proprietary	tajirai
Sister	&#39;yar&#39;uwa
(	(wanda
&amp; Gt; &amp; gt; &amp; gt;	&gt;&gt;&gt;
Publications	wallafe
-----------------	-----------------
10:34	10:34
elliptical	elliptical
swing.	lilo.
communicants.	communicants.
Cassini	Cassini
stars.	taurari.
your name,	sunanka,
December	Disamba
imports	shigo
steel,	ƙarfe,
&#39;	&#39;
If	Idan
stars	taurari,
VL-bus	VL-bus
(Version	(Version
&amp; Gt;	&gt;
passed	shige
months	months
enter	shiga
html>	schauf@iastate.edu
Then	To,
serial	serial
&amp; gt;	zama&gt;
call	kiran
is	shine
All	Duk
carries	daukawa
worry	damu
Those	Wadanda
Christ, &amp; quot;	Almasihu,&quot;
Campus)	Campus)
&amp; Gt; &amp; gt; &amp; gt; &amp; gt;	&gt;&gt;&gt;&gt;
Too	Too
gazed	gazed
bothered	dame
Venusian	Venusian
right	dama
Tom	Tom
Finally.	karshe.
Finally)	karshe)
divider	divider
100-km	100-kilomita
Lei)	Lei)
Weapon:	Weapon:
article	kasida
god	bautãwa
instruction,	wa&#39;azi,
100,	100,
1000	1000
much	gwargwadon
Personaly	Personaly,
der	der
(Source	(tushen
des	des
Alpha	Alpha
same to you,	kuma,
islamic	islamic
&amp; Quot; Science &amp; quot;	&quot;kimiyya&quot;
leads	kaiwa
html>	&lt;31MAR199321091163@juliet.caltech.edu
same to you:	kuma:
bike	bike
Yemen	Yemen
larry	larry
holiday	biki
Recently	Kwanan
&amp; Lt; p00261@psilink.com&amp;gt;	&lt;p00261@psilink.com&gt;
Luis	Luis
same to you.	kuma.
lava-filled	lawa-cika
designs	kayayyaki
know?	sani?
with you	dake
Four	Hudu
Freedom.	&#39;yanci.
XRaiseWindow	XRaiseWindow
malpractice	malpractice
Phone:	WAYAR:
comets,	comets,
Visible	bayyane
know.	sani.
USA	USA
compatible	jituwa
Luke	Luka
victory	nasarar
&#39;I	&#39;Ni
watch	agogon
conveniences	dãɗin
Above.	Sama.
comparisons?	kwatancen?
know,	sani,
appear	bayyana
wild	daji
plan	shiri
degree.	digiri.
anecdotal	anecdotal
1ff &amp; gt;	1ff,&gt;
definite	tabbataccen
indicting	indicting
August	Agusta
candy	alewa
process &amp; quot ;.	tsari&quot;.
(	(yadda
Länder	Länder
gilkey	gilkey,
Dr.	Dr.
alternating	alternating
&amp; Quot; pop	&quot;pop
burned	ƙone
arrogant	kangara
announced	sanar
&amp; Quot; Dual	&quot;dual
arrogant	kangare
Scams &amp; gt;	zamba&gt;
LaStrange	LaStrange
////	////
Moroccan	Moroccan
html>	henry@zoo.toronto.edu
&amp; Quot; difficult &amp; quot;	&quot;wuya&quot;
Giants.	Kattai.
criteria.	sharudda.
unethical.	unethical.
Lindroos	Lindroos
&amp; gt;	wanda&gt;
Dod	Dod
3511,	3511,
bitnet:	bitnet:
Fang	Fang
1024	1024
CLIMATE	sauyin
DOS6	DOS6
batting	batting
Support	Support
Huh?	Huh?
Finney	Finney
fast	azumi
withs	withs
DOS.	DOS.
However,	dai,
&amp; Quot; X9 &amp; quot;	&quot;x9&quot;
Hui)	Hui)
benefits:	amfanin:
police	sanda
Freedom	&#39;yanci
back &amp; quot ;.	baya&quot;.
Lucifer,	Lucifer,
Chastity	farjinsu
&amp; gt;	cikin&gt;
end	karshen
from	daga
Dos	Dos
Since	Tun
100k	100k
To	Don
codified	codified
more.	more.
supported	goyan
Jon.	Jon.
Study	Nazarin
Therefore,	haka,
.	haka.
verbatim).	verbatim).
fear.	tsoro.
neccities	neccities
altimeter	altimeter
Orthodoxy	orthodoxy
right	hakkin
Dream	Mafarki
(Americans)	(Amirkawa)
male,	namiji,
training.	horo.
Buffalo	Buffalo
claim	da&#39;awar,
agents	jamiái
*************************	*************************
horns	ƙahonin
Magazine	Magazine
Further	Ƙara
the	cikin
exeption.	exeption.
quake	girgizar
revealed	wahayi
field	saura
size.	size.
size,	size,
faster	sauri
(Steve	(Steve
Bloom,	Bloom,
down.	saukar.
Georgetown,	Georgetown,
since &amp; gt;	tun&gt;
Language	Harshen
down,	saukar,
misleading	yaudarar
(Kirk	(Kirk
Christianity	Kristanci
&amp; Quot; all	&quot;duk
Lee	​​Lee
rem	rem
worthy	cancantar
miles).	miles).
United	{asar
TIFF,	TIFF,
Proud	Proud
-428-0800	-428-0800
interior.	ciki.
including,	ciki,
John	John
Rifleman &amp; quot ;,	Rifleman&quot;,
Pluto,	Pluto,
Pluto.	Pluto.
minor	qananan
Insurance	Assurance
Spencer)	Spencer)
description	description
sound	sauti
Have	Ashe,
press	latsa
Overall	Overall
vertically	vertically
Dave	Dave
Sunday	lahadi
Note: &amp; gt ;:	lura:&gt;:
Tapered	Tapered
Dealer	dila
tvtwm	tvtwm,
one. &amp; quot;	daya.&quot;
Heat	Heat
override	override
-486-9975	-486-9975
17th,	17th,
story	lãbãri
&amp; Lt; No.	&lt;Ba.
raw	raw
responses	martani
din.	din.
jon,	jon,
One	Daya
cautious	taƙawa
Confirmed	Tabbatar
first.	farko.
First,	farko,
html>	rind@enterprise.bih.harvard.edu
Hello,	Sannu,
... &amp; Gt; &amp; gt; &amp; gt;	...&gt;&gt;&gt;
adapter.	adaftan.
Alan	Alan
For	Alal
Me	Ni,
5X9 &amp; gt; &amp; gt;	5X9&gt;&gt;
perturbations	perturbations
clouds.	girgije.
commited	commited
axis	axis
clouds,	girgije,
Systems &amp; gt;	Systems&gt;
New	New
told,	gaya,
inorganic	inorganic
drivers	direbobi
life	rai
expected	ran
&amp; Quot; see &amp; quot ;,	&quot;gani&quot;,
Gays	luwadi
well-built	rijiya-gina
east-to-west	gabas-da-yamma
Reaction	Amsawa
^^^^^^^^^^^^^^^^^^^^^^^^^^^	^^^^^^^^^^^^^^^^^^^^^^^^^^^
cup	kofin
more	ƙarin,
questions	tambayoyi
Is	Yake
8,000	8,000
Leifson)	Leifson)
early	farkon
cents!	aninai!
Trial	Shari&#39;ar
destroyed &amp; quot; &amp; gt;	halaka&quot;&gt;
patterns	alamu
chemicals.	sunadarai.
possibility	yiwuwar
short	gajeren
inflammation	kumburi
feature	alama
new &amp; gt;	sabuwa&gt;
BUT	AMMA
1986	1986,
1986.	1986.
WNCI	WNCI
change	sauya
free,	free,
Idea?	Ra&#39;ayin?
Syria	Syria
yourself,	kanka,
(22,238	(22,238
Soviet	Soviet
10,000	10,000
Clipper	clipper
Is	Yana
good?	alhẽri?
1985.	1985.
&amp; Lt; mvanheyn@cs.indiana.edu&amp;gt;	&lt;mvanheyn@cs.indiana.edu&gt;
Whethe	Whethe
motif.	motif.
Venus.	Venus.
UNIX	UNIX
anything &amp; gt;	kome&gt;
body,	jikinsa,
disk	faifai
clears	clears
spit	tofa
Venus,	Venus,
availability	kasancewa
html>	nagle@netcom.com
drives	gudãnar
Which	Wanda
acetylene	acetylene
Ground	Ground
Here	Nan
words.	kalmomi.
seethes	seethes
Explorer	Explorer
Stop &amp; gt;	daina&gt;
guns	bindigogi
1983.	1983.
These &amp; gt;	Wadannan&gt;
Utopia	Utopia
apple	kwayar
core.	core.
principles?	ka&#39;idojin?
core,	core,
Bacterial	kwayan
palastenians	palastenians
ulysses.att..com	ulysses.att..com
Europa,	Europa,
mixer!	mahautsini!
cool	kwantar
principles.	ka&#39;idojin.
example	misali
health.	lafiya.
generations.	al&#39;ummomi.
Health	lafiya,
law,	doka,
law.	doka.
Columbia,	Columbia,
currents	igiyoyin
disciples)	almajiran)
***************	***************
words	kalmomin
elevated	dagagge
news	labarai
overlapping	overlapping
1981.	1981.
Mixture	cakuda
severe	tsanani
Stores	Stores
use &amp; gt;	amfani&gt;
culture	al&#39;adu
rip	rip
falling	fadowa
Cheers	Bisimillah
Health	lafiyar
custom	al&#39;ada
&amp; Quot; long	&quot;dogon
1980,	1980,
Book,	Littafi,
Bzzt!	Bzzt!
-rigth	-rigth
related	alaka
Timmons)	Timmons)
Timmons,	Timmons,
computer.	kwamfutarka.
shrank,	shrank,
5-11,	5-11,
promiscuous &amp; quot;	promiscuous&quot;
martian,	martian,
html>	hrubin@pop.stat.purdue.edu
Arms	makamai
Nissan.	Nissan.
Celsius,	Celsius,
inventory,	kaya,
Salah)	Salah)
inventory)	kaya)
Law?	Attaura?
stuff.	kaya.
phone	wayar
majority	rinjaye
being &amp; gt;	kasancewa&gt;
(Leong	(Leong
html>	martyj@mrcnext.cso.uiuc.edu
difficulty	wahala
little	kaɗan
Law,	Attaura,
Law.	Attaura.
&amp; Lt; 1qnb9tINN7ff@rave.larc.nasa.gov&amp;gt;	&lt;1qnb9tINN7ff@rave.larc.nasa.gov&gt;
accuire	accuire
inherently	inherently
&amp; Quot; Remember	&quot;tuna
quack, &amp; gt;	quack,&gt;
97.9	97,9
&amp; Quot; All	&quot;Duk
GSX-145	GSX-145
teams	teams
linked	nasaba
container	akwati
Comics.	Comics.
Mives	Mives
Control	Control
earth-moon-sun	ƙasa-moon-rãnã
equipment	kayan
way.	hanyar.
Reeves)	reeves)
html>	cfaehl@vesta.unm.edu
cap.	hula.
way,	hanyar,
above,	bisa,
&amp; Quot; q	&quot;q
Border	Iyakar
way)	hanyar)
cryptography.	cryptography.
Connecting	sadar
support	goyon
html>	brian@gab.unt.edu
comp.sys.ibm.pc.hardware	comp.sys.ibm.pc.hardware
Hell	Jahannama
need.	bukatar.
Canucks	Canucks
(Sam	(Sam
products	samfurori
training	horar
Stephen	Stephen
Livermore,	Livermore,
daily	kullum
FRED&#39;S	FRED&#39;S
&#39;Created	&#39;halitta
doctors	likitoci
Redelfs)	Redelfs)
des-like	des-kamar
html>	nstassen@magnus.acs.ohio-state.edu
prayer &amp; gt;	addu&#39;a&gt;
cases,	lokuta,
Ibrahim,	Ibrahim,
&amp; Quot;	&quot;
language	harshe
Prayer	Addu&#39;a
formation.	samuwar.
Bread	yisti
completed.	kammala.
hand	hannun
Acting	riko,
Same to you,	Kuma,
Maxwell	Maxwell
imputs	imputs
friendly?	sada?
anger	fushin
&amp; Quot; tails. &amp; Quot;	&quot;wutsiyoyi.&quot;
Electronics	Electronics
bodies.	jikinsu.
worth,	daraja,
sand.	rairayi.
Neptune.	Neptune.
places	wuraren
Neptune,	Neptune,
486-33DX)	486-33DX)
blank.	blank.
drops	saukad
Contact	hulda
Law &amp; quot; &amp; gt;	Attaura&quot;&gt;
ohms	ohms
martians	martians
terrestrial	terrestrial
down	saukar
possible.	yiwuwa.
probably,	yiwuwa,
&amp; Quot; final	&quot;karshe
==========	==========
Purity)	Tsarki,)
(Carl	(Carl
Gnostein?	&#39;gnostein?&#39;
hand.	hannu.
Comparisons,	Kwatancen,
mobile,	hannu,
1989	1989,
blind),	makafi),
collapse	durkushe
Wagner,	Wagner,
Howdy	Howdy
Coons)	Coons)
River	kogin
possible	yiwu
eruptions	eruptions
-Karl &amp; Gt;	-Karl&gt;
(Ncsc8!	(ncsc8!
stations	tashoshin
lin)	lin)
Federal	tarayya
html>	fang@en.ecn.purdue.edu
Sharma	Sharma
Hospital &amp; gt;	asibitin&gt;
telescopic	telescopic
and	sai
World.	Duniya.
World	Duniya,
anti-gun	anti-gun
carbon	carbon
Anecdotal	Anecdotal
easy.	sauki.
upgradable	upgradable
interpreting	tafsirin
Everest.	Everest.
know	san
times	sau
spec&#39;d	spec&#39;d
years	years
living	zaune
stay	zauna
line	line
Paul	Bulus
,	sa,
Properties	Properties
regions.	yankuna&#39;.
weight &amp; gt;	nauyin&gt;
(Bryan	(Bryan
Treasures	taskõkin
messages	saƙonni
(Kevin	(Kevin
SCSI	SCSI
free-man	free-mutumin
Mercy	rahama
Darryl	Darryl
jumper	jumper
important	muhimmanci
each,	kowane,
each.	kowane.
[Ban	[ban
Browsing	lilo
&amp; Lt; &amp; lt;	&lt;&lt;
===	===
Russia	Rasha
Quest)	nema)
wings	fuka-fuki
all &amp; gt;	dukan&gt;
750.	750.
Thomas	Thomas
lyme	lyme
&amp; Quot; large	&quot;manyan
&amp; Quot; beat	&quot;doke
RS-6903	RS-6903
back.	mayar.
All!	All!
but &amp; gt;	amma&gt;
Ohio	Ohio
82%,	82%,
Potvin,	Potvin,
verses	ayoyi
Gosh..I	Gosh..I
html>	J.David.W.Reeves@dartmouth.edu
m-rock	m-dutsen
&amp; Quot; Stephen	&quot;Stephen
html>	aep@world.std.com
mouth	baƙin
Ranger,	Ranger,
Bentz	Bentz
unlike	sabanin
(Perhaps	(watakila
Near-hurricane	Kusa-guguwa
&amp; Lt;	&lt;
Books	Littattafan
So?	haka?
Day	yini
made &amp; gt;	sanya&gt;
beauty &amp; gt;	kyau&gt;
natonal	natonal
Suzuki	Suzuki
forces	sojojin
Spencer	Spencer
easily	saukin
emulators	emulators
Center.	Center.
Planitia	Planitia
laboratory	awon
mechanics	makanikai
color	launi
there.	akwai.
!! &amp; Quot;	!!&quot;
keys	makullin
Winslow,	Winslow,
drink	sha
cycle,	zagayowar,
&#39;God &amp; quot;	&#39;Allah&quot;
SU &amp; gt;	SU&gt;
16804	16804
University	University
bikes,	kekuna,
morning	safiya
away,	bãya,
Next	Gaba
away.	bãya.
applications	aikace-aikace
neighborhood	unguwa
(JPS)	(JPS)
debt	bashin
it	shi
(All	(All
section	sashen
Washington.	Washington.
victory	nasara
crimes,	laifuka,
Communications	sadarwa
shields	garkuwoyi
Dayton,	Dayton,
steps.	matakai.
_in	_in
foot	kafar
Surveyor	safiyo
water.	ruwan.
under	ƙarƙashin
water,	ruwan,
Worm	macijin
spending	ƙãrẽwar
you)	kuka)
Excellent	madalla
serial,	siriyal,
license	lasisi
theater	kwaikwayo
(______________________________________)	(______________________________________)
Health &amp; quot ;.	lafiya&quot;.
top &amp; gt;	saman&gt;
Pgf@srl02.cacs.usl.edu|Like	Pgf@srl02.cacs.usl.edu|Like
10/82	10/82
US	Amirka
Kawasaki	Kawasaki
(About	(game
publication	ɗaba&#39;ar
under	karkashin
keyboard	keyboard
1990.	1990.
1990,	1990,
mouth	bakin
brake	birki
list	jerin
html>	ekdfc@ttacs1.ttu.edu
College	College
combat.	fama.
4Runner &amp; gt;	4Runner&gt;
For	Domin
Oh,	Oh,
Djakarta,	Djakarta,
4/26/93.	4/26/93.
Ok,	Ok,
Callisto	Callisto
anecdotally &amp; gt;	anecdotally&gt;
promiscuity	promiscuity
Space	Space
6/91	6/91
minor)	qananan)
dogma	akidarsu
what &amp; gt;	abinda&gt;
adjust	daidaita
particles	barbashi
Canada,	Canada,
strengthen	karfafa
Fla.	Fla.
00ECGILLESPIE	00ECGILLESPIE
country,	kasar,
consistency	daidaito
-14	-14
degeneration.	degeneration.
irregularly	irregularly
Scharfy)	Scharfy)
&amp; gt;	ne,&gt;
hours).	hours).
gate	ƙofar
efforts	ƙoƙari
identification	ganewa
2230	2230
(Amy	(Amy
PMS	PMS
before	kafin
commerce,	fatauci,
You	Kuna
Payment &amp; gt;	biyan&gt;
injury.	rauni.
Franjione	Franjione
HOMOSEXUAL-	HOMOSEXUAL-
rocketry	rocketry
complexities	complexities
Kaufman)	Kaufman)
Telecope	Telecope
Same to you	Kuma
Volcanic	Volcanic
Edwin	Edwin
sleep.	barci.
sleep,	barci,
Voice:	murya:
home-from	gida-daga
cleanly	cleanly
election	zaben
enemies &amp; gt;	maƙiya&gt;
outermost	outermost
View	Duba
retinue	retinue
Ludwick &amp; quot;	Ludwick&quot;
bigots.	bigots.
(Andrew	(Andrew
&amp; gt; &amp; gt;	game,&gt;&gt;
(Tobias	(Tobiya
(3,010	(3,010
Sorry.	haƙuri.
(-184	(-184
files:	files:
Sorry,	haƙuri,
offer &amp; gt;	mika&gt;
amino	amino
pitcher,	tulun,
love	son
Clouds	girgije
touch	shãfe
quality &amp; gt;	inganci&gt;
I &amp; gt;	ni&gt;
a &amp; gt;	babban&gt;
---	---
&#39;.	&#39;.
leanings,	leanings,
invading	invading
Ryan	Ryan
records	records
Hoffman	Hoffman
!	su!
themon	themon
option.	zabi.
korean,	korean,
File,	File,
speed;	gudun;
alt.atheism	alt.atheism
Santa	Santa
1999.	1999.
crisscrossing	crisscrossing
&amp; Quot; Lyme	&quot;Lyme
Stanza	Stanza
floods	ambaliyar
10 &amp; quot ;,	10&quot;,
gaseous	gaseous
handgun,	handgun,
dazzling	dazzling
slopes	gangaren
a &amp; gt;	a&gt;
prayer	addu&#39;a
20th	20th
transactions.	ma&#39;amaloli.
taxes	haraji
Multiprobe	Multiprobe
feature.	alama.
traditions	hadisai
--clh	--clh]
ruling	hukuncin
shaped	dimbin
&amp; Lt; C5r60r	&lt;C5r60r
homosexual.	kishili.
___	___
homosexual,	kishili,
shipping	shipping
typical	hankula
html>	lvc@cbnews.cb.att.com
table	tebur
1993	1993,
ha	sababinsa,
Edit:	Gyara:
deceleration.	deceleration.
fight	yaƙi
Altimas	Altimas
&amp; Quot; sense &amp; quot;	&quot;gabar&quot;
Candida	Candida
freezes	freezes
clear	bayyananniya
(Cyanide	(cyanide
hour,	awa,
period	tsawon
1992	1992,
html>	adam@das.harvard.edu
must.	dole.
judge.	hukunci.
radioed	radioed
William	William
dilemma!	kwanda!
He	shĩ
Surprise	Mamaki
instruction	wa&#39;azi
&#39;:	&#39;:
Lauri)	Lauria)
each other.	juna.
handers.	handers.
each other,	juna,
real	real
orbit	kewayewa
energy.	makamashi.
1995	1995,
articals	articals
Pushing	Turawa
apples	apples
html>	daviss@sweetpea.jsc.nasa.gov
star-son	tauraron-dan
Appear	Bayyana
[Speaking	[magana
19947	19947
wanted,	so,
forsale	forsale
want.	so.
Altima,	Altima,
Obo	Obo
wills;	so;
instead	maimakon
reason	dalili
^^^^^	^^^^^
teams.	teams.
Gen3:	Gen3:
&#39;S	&#39;s
PCX	PCX
character &amp; quot;	hali&quot;
HCl.	HCI.
Panels	bangarori
want)	so)
diameter	diamita
M	&#39;m
homes	gidajen
bad.	mugu.
luck.	luck.
attention.	hankali.
rules.	dokoki.
intelligence,	hankali,
Poster	Poster
ergonomically	ergonomically
history,	tarihi,
planet-wide	tamu-fadi
wakeup	wakeup
ford	hyundai
program	shirin
history.	tarihi.
Dale	Dale
isolator &amp; quot;	isolator&quot;
Out	Out
motorcycles,	babura,
Our	Our
32-bit).	32-bit).
less than	kasada
happed	happed
motorcycles.	babura.
strawman	strawman
27611@athos.rutgers.edu	27611@athos.rutgers.edu,
cypher.	cypher.
96.5	96,5
html>	folta@zen.holonet.net
Skelton	Skelton
driver	direba
The	Cikin
seed	zuriyar
writers	marubuta
area.	yankin.
laws	dokokin
area,	yankin,
-oOOO	-oOOO
programs	shirye-shirye
html>	astein@nysernet.org
urged	buƙaci
original	asali
diseases, &amp; gt;	cututtuka,&gt;
late	marigayi
area:	yankin:
^^^^^^^^^^^^^^^^^^^^^^^^^^^^^^^^^^^^^^^^^^^^^	^^^^^^^^^^^^^^^^^^^^^^^^^^^^^^^^^^^^^^^^^^^^^
everywhere	ko&#39;ina
html>	sharma@monet.vill.edu
Patient-Doctor	Patient-Likita
Earth	Qasa
Kolodny	Kolodny
(Dick	(Dick
allocation	kasafi
BMP,	BMP,
html>	sguerke@ravel.udel.edu
OTOH,	OTOH,
Oliveira	Oliveira
nothing	kõme
GMT	GMT,
innermost	sadarin
html>	kfrank@magnus.acs.ohio-state.edu
computer?	kwamfutarka?
9600	9600
That	Wancan
Independence.	Independence.
coalesced	coalesced
you&#39;re not.	baka.
.	su.
,	su,
html>	hans@xelion.nl
interested,	sha&#39;awar,
Motherboards	Motherboards
rake,	rake,
Sermon &amp; gt;	Huduba&gt;
as &amp; gt;	kamar&gt;
&#39;Arab.	&#39;Larabawa.
SMARTDRV	SMARTDRV
story	labarin
lankford	lankford
Williams,	Williams,
Environment.	muhalli.
ie,	watau,
&amp; Quot; typical &amp; quot;	&quot;hankula&quot;
After	Bayan
money	kudi
Report	Report
room	ɗakin
forget	manta
stuck,	makale,
volumes	kundin
they	sun
history	tarihin
Frank)	Frank)
South	kudu
rakes	rakes
televison. &amp; quot;	televison.&quot;
representation	wakilci
Bottle	kwalban
plant	shuka
never	taɓa
teacher	malami
Represents	Wakiltar
html>	holsend@mhd.moorhead.msus.edu
Mails	Wasiku
From	Daga
decrypting	decrypting
cyphers	cyphers
(Robert	(Robert
main-belt	main-bel
subwindows	subwindows
beauty	kyakkyawa
Religion	addinin
FORSALE	FORSALE
Submit	sallama
Callisto,	Callisto,
down	sauka
Disclaim:	Disclaim-ta:
locations	wurare
statistics &amp; gt;	statistics&gt;
friend	aboki
weather	weather
(12V	(12V
===========================================	===========================================
WP51	WP51
religion,	addini,
nails	kusoshi
religion.	addini.
character,	hali,
covet	gurin
groups	kungiyoyin
&amp; Lt; 1993Apr22.153959.12328@ucsu.Colorado.EDU&amp;gt;	&lt;1993Apr22.153959.12328@ucsu.Colorado.EDU&gt;
character.	hali.
Latin	Latin
religion?	addini?
pitchers	pitchers
noise	hayaniya
(125	(125
cyanide.	cyanide.
tap	tap
(JPL)	(JPL)
packing	shiryawa
Dark	Dark
nursing	reno
Lawrence	Lawrence
&amp; Lt; 1qkoel$5fr@horus.ap.mchp.sni.de&amp;gt ;,	&lt;1qkoel$5fr@horus.ap.mchp.sni.de&gt;,
closed	rufe
Moses,	Musa,
doctors).	likitoci).
(Stephen	(Stephen
Geiger	Geiger
crazy	mahaukaci
character	halin
safety &amp; quot;	aminci&quot;
&amp; Lt; C5DxBs.5ov@panix.com&amp;gt;	&lt;C5DxBs.5ov@panix.com&gt;
&amp; Quot; Sports &amp; quot;	&quot;wasanni&quot;
****	****
Dual-Sport	dual-Sport
liscenced	liscenced
PS:	PS:
find	sãmun
black,	baki,
Fusion.	Fusion.
Return	kõma
Premier	ƙwalo
halfway	halfway
(175	(175
closed	rufaffiyar
Life	Rayuwa
html>	NUNNALLY@acs.harding.edu
Duo)	Duo)
[...	[...
canals	canals
WOW!	WOW!
&amp; Quot; Do	&quot;Kada
bearings	bearings
set,	kafa,
html>	psyrobtw@ubvms.cc.buffalo.edu
flow).	gudãna).
Christian.	Kirista.
very &amp; gt;	sosai&gt;
(RvKampen)	(RvKampen)
century.	karni.
set.	kafa.
!!!!	!!!!
faith.	bangaskiya.
Phil	Phil
unravel	unravel
always	yaushe
Christian?	Kirista?
license.	lasis.
--- &amp; Gt; &amp; gt; &amp; gt; &amp; gt;	....&gt;&gt;&gt;&gt;
(Usually	(yawanci
html>	banschbach@vms.ocom.okstate.edu
Willis)	Willis)
tail,	wutsiya,
)	ta)
,	ta,
curtain	labulen
&amp; Quot; open &amp; quot;	&quot;bude&quot;
Europe.	Turai.
Worry	Damu
Europe	Turai,
PTO	PTO
bakes	bakes
?	ta?
grants	bãyar
great	babban
Foreign	harkokin
rules,	dokoki,
Religious	addinai
(Tim	(Tim
after	bãyan
easy	sauki
Personally,	kaina,
.	ta.
uneventful,	uneventful,
drop	sauke
^^^^^^^^^^^^^^^^^^ &amp; Gt;	^^^^^^^^^^^^^^^^^^&gt;
Know)	Sani)
World &amp; gt;	Duniya&gt;
diameter,	diamita,
myself.	kaina.
great	babbar
dormant	dormant
:	ta:
must &amp; gt;	dole&gt;
French	French
HRB.	HRB.
crumbling	crumbling
problem.	matsala.
before	gabansa
shorted	shorted
food	abincin
14-19?	14-19?
Save	Ajiye
View	View,
god	bautawa
I	nake
Point	Point
.	nan.
Then,	nan,
rings	zobba
html>	toml@boulder.parcplace.com
kenyee	kenyee
year	shekarar
defenseless	defenseless
Closure]	ƙulli]
bit	bit
20-39	20-39
key,	key,
(Gregh@niagara.dcrt.nih.gov)	(gregh@niagara.dcrt.nih.gov)
key.	key.
bin	bin
)	nan)
9,256	9.256
....	....
metal-rich	ƙarfe-arziki
possibility,	yiwuwar,
God &amp; gt;	Allah&gt;
lankford	lankford,
dust	kura
...:	...:
Munns)	Munns)
(39.95)	(39.95)
...?	...?
amplifier	amfilifa
Roger.	Roger.
countless	imbin
seed	zuriyarka
(Tom	(Tom
Italy	Italiya
as	tamkar
&amp; Quot; jargon &amp; quot ;,	&quot;jargon&quot;,
resources	albarkatun
year	shekara,
survey	binciken
close	kusa
plan	dabara
good	kyakkyawan
year.	shekara.
parts	sassa
(Aaron	(Hãrũna
keyat	keya
Allen	Allen
techniques	dabaru
experts	masana
Goolsbey)	Goolsbey)
bodies	jikinsu
bob	bob
one.	daya.
one,	daya,
-Arlo	-Arlo
Florida	Florida
Man	Mutum
powder	foda
Manufacturers	kera
Attribute	sifa
(	(mu
crack	crack
advertising	talla
research.	bincike.
&amp; Quot; 90%	&quot;90%
(	(na
good.	kirki.
fair,	kirki,
&amp; Lt; rauser.734062608@sfu.ca&amp;gt ;,	&lt;rauser.734062608@sfu.ca&gt;,
...)	...)
bmw	bmw
...!	...!
erosion.	yashwa.
nor	balle
Spirit-	Ruhu-kai
Travel &amp; gt;	tafiya&gt;
ours	namu
(New)	(sabon)
Cuesta)	Cuesta)
test	gwada
(Frank	(Frank
&amp; Lt; C5r60r.4ID@megatest.com&amp;gt ;,	&lt;C5r60r.4ID@megatest.com&gt;,
Detroit	Detroit
really.	gaske.
really,	gaske,
Russia,	Rasha,
inspiration.	wahayi.
Here?	nan?
while	wa&#39;adi
infringement	keta
Once,	zarar,
property	dũkiyõyinsu
orbits	falakinsu
(	(ku
surveyed	surveyed
body	jikinsa
and	kuwa
&amp; Gt;	Za&gt;
html>	whitsebd@nextwork.rose-hulman.edu
God	Allah
streaky	streaky
HITEN	HITEN
streaks	streaks
(Or	(ko
5,500	5.500
bench.	benci.
html>	Rauser@sfu.ca
you	kuke
B433EI2.	B433EI2.
you	kuka
(Follow	(bi
,	suna,
Note,	lura,
nuclei	nuclei
4Runner	4Runner
(	(ba
RAM)	RAM)
danger,	hadari,
own	nasu
areas	yankunan
care	kula
1,000	1,000
believers)	mũminai)
I	ban
computergenerated	computergenerated
not	bai
proof	hujja
_your_	_your_
storm.	hadari.
era	zamanin
&amp; Quot; Robert	&quot;Robert
bad	bad
landing?	saukowa?
(As	(as
same to you	kuma
believers.	mũminai.
bar	bar
motherboard	motherboard
search.	bincika.
Believe	Imani
flock,	garken,
name	sunan
program.	shirin.
The sunlit	&#39;sunlit
fragments	niƙaƙƙun
flyby,	flyby,
(Bentz.e.puryear)	(bentz.e.puryear)
flyby.	flyby.
lie,	ƙarya,
regions.	yankuna.
break.	ƙarya.
Be	Za&#39;a
Norway,	Norway,
price	diyyar
spaceflight	spaceflight
dioxide	dioxide
Norway:	Norway:
September	Satumba
bark,	haushi,
fill. &amp; quot;	cika.&quot;
Engineer	Engineer
Voyager	Voyager
bed	gadon
Activate	Kunna
400	400,
***	***
landing	saukowa
dead?	matattu?
water	ruwa
html>	gchin@Eng.Sun.Com
companies	kamfanoni
flybys	flybys
Rick.	Rick.
for	sabõda
House	House
Replica	Replica
effects	illa
clack	clack
Professional &amp; gt;	sana&#39;a&gt;
belt	bel
HIMEM.SYS	HIMEM.SYS
education	ilmi
Colorado	Colorado
dead.	matattu.
dead	matattu,
(	(da
enveloped	wajaba
ammonia,	ammonia,
Depth	Zurfin
Statistics	kididdiga
you	kuna
problem	matsalar
teaching	koyarwar
Chryse	Chryse
water-ice,	ruwa-kankara,
for	domin
engaged	tsunduma
Originator	ƙãga
followed.	bi.
dwarfs	dwarfs
play	play
Legge	Legge
My	nawa
80111	80111
FACTS	BAYANIN
thorns	ƙayayuwa
close-range	kusa-range
Ten	Goma
below:	ƙasa:
gays	gays
ground?	ƙasa?
pop	pop
______________________________________	______________________________________
boast	fariya
Agency	Hukumar
&amp; Quot; Europe	&quot;Turai
(	(Ya
messages?	sakonni?
Triton.	Triton.
education	ilmin
told	gaya
round	kewaye
Antisemitic	AntiSemitic
be	za&#39;a
Computer	Computer
products	kayayyakin
Product	samfur
prosecution	la&#39;anta
61153	61153
country	ƙasar
Joel	Yowel
(Read	(karanta
navigate	kewaya
Shapiro	Shapiro
Good	Good
encryption	boye-boye
_him_	_him_
ten	goma
Star	Tauraron
before.	kafin.
motherboards,	motherboards,
removed	kawar
coach?	kocin?
electromechanical	electromechanical
knowledge,	ilmi,
only	kawai
coach)	kocin)
drives	tafiyarwa
site	site
Items	Items
slots	ramummuka
Wells,	Wells,
strengthen	ƙarfafa
Ullal	Nunnally
designs,	kayayyaki,
change	musanyãwa
blomberg	blomberg
tossing	tossing
side.	gefe.
male	namiji
Force	Force
earth	ƙasa,
583. &amp; gt;	583.&gt;
Round	Zagaye
communication.	sadarwa.
warehouse	sito
prevention	rigakafin
before?	kafin?
motherboards?	motherboards?
below.	ƙasa.
(Mark	(Markus
posters	posters
1990s,	1990s,
experimentation.	experimentation.
members	mambobi
62.4	62,4
Laboratory	Laboratory
&amp; quot ;,	su&quot;,
soften	laushi
bep)	bep)
blow	busa
one	ɗaya
Lung)	Huhu)
said: &amp; gt; &amp; gt;	ce:&gt;&gt;
promiscuous,	promiscuous,
Heart	Heart
six-	six-
Site	Site
flight	jirgin
^^^^^^	&#39;^^^^^^&#39;,
Gold &amp; quot;)	Gold&quot;)
workstation	workstation
Ganymede	Ganymede
nations?	al&#39;ummai?
usual.	saba.
html>	dans@uxa.cso.uiuc.edu
Question	Tambayar
hard	rumbun
-------------------	-------------------
freeze	daskare
&amp; Quot;	&quot;Sai
there	can
case-control	hali-kula
Normally,	saba,
risk	hadarin
(Obviously)?	(fili)?
________)	________)
*******************	*******************
Infinity	dawwama
years,	shekaru,
know &amp; gt;	san&gt;
Company	Company
years.	shekaru.
false	ƙarya
small	karamin
NRA-certified	NRA-bokan
(Microsoft	(Microsoft
declared	ayyana
Wings	Wings
signal	siginar
..:	&#39;..:
pass,	auku,
tents,	alfarwansu,
X3153	X3153
waves	tãguwar
weightier	weightier
Gown	goon
giant, &amp; quot;	giant,&quot;
Jews	Yahudu
Ten?	Goma?
labels.	tasirin.
published	buga
&amp; Lt; Fenton@Kaleida.Com&amp;gt;	&lt;Fenton@Kaleida.Com&gt;
Chin)	Chin)
balls.	bukukuwa.
policies,	manufofin,
Bos)	Bos)
finished	ƙãre
Surgery,	Surgery,
strike	buge
gas.	gas.
gas,	gas,
expeditions,	expeditions,
final): &amp; gt;	karshe):&gt;
buy-backs	buy-bãyansu
Buyers	Buyers
Avenue	Avenue
trade	fatauci
Gen.	janar
Isa	Ĩsã
testing	gwaji
(SF	(SF
Ishtar	Ishtar
Pleiades,	Pleiades,
Algeria	Algeria
&amp; Quot; buy	&quot;saya
(No	(No
inspection	dubawa
elections),	zaben),
(P.	(P.
Spiros	Spiros
Foundation	Foundation
final	fanareti
B2: &amp; gt;	B2:&gt;
html>	geb@cadre.dsl.pitt.edu
discuss	tattauna
(Juan	(Juan
av	ɗari
neighbors	makwabta
Rubin	Rubin
Protection &amp; quot;	Kariya&quot;
(Two	(biyu
&amp; Quot; relative. &amp; Quot;	&quot;zumunta.&quot;
reduce &amp; gt;	rage&gt;
she is	itace
principally	principally
1Meg	1Meg
romantic	romantic
belt.	bel.
belt,	bel,
lowers &amp; gt;	lowers&gt;
identified	gano
promiscuous?	promiscuous?
THANX	Dabauá
recognized	gane
Rules	Dokoki
open	bude
Kentucky	Kentucky
Titania	Titania
Audio	Audio
North	Arewa
see	gani
386DX-40	386DX-40
bus	bus
ranked	ranked
Rauser)	Rauser)
possess!	mallaka!
human-crewed	mutum-crewed
authorization	izni
Java	Java
advertising.	talla.
welcome	maraba
healers	healers
Medical	Medical
GMT &amp; gt;	GMT&gt;
two-for	biyu-domin
reign	sarauta
seriously!	tsanani!
stones.	duwatsu.
Cellphone	salula
severe)	tsanani)
seriously.	tsanani.
html>	bc744@cleveland.Freenet.Edu
Interim).	gadi).
Cirelli)	Cirelli)
Albertan,	Albertan,
Path &amp; gt;	ɗã&#39;a&gt;
html>	caldwell8102@mtroyal.ab.ca
agreed,	amince,
etc.	sauransu
closed &amp; quot;	rufe&quot;
full? &amp; quot;	cika?&quot;
my house,	gidana,
hope	bege
vantage	vantage
toyota	toyota
Galant	Galant
civilization	wayewa
support	goyi
(Arthur	(Arthur
Welles	Welles
sweeping	sweeping
title-	title-
Severe	tsananin
food.	abinci.
deviants.	deviants.
8.20).	8.20).
for	gare
test	jarraba
html>	jhardono@nickel.ucs.indiana.edu
guidance	shiriya
power	mallakar
quite	quite
Energy	Energy
corner	kusurwa
html>	gchin@ssf.Eng.Sun.COM
ARMM &amp; quot;	ARMM&quot;
ROM	ROM
was	aka
stars.	taurãri.
are	ake
bullshit	bullshit
taking	shan
travelers	matafiya
true. &amp; quot;	gaskiya.&quot;
Shipper)	Shipper)
class	aji
Verse	Verse
traveler	matafiyi
curly	curly
high-altitude	high-tsawo
9,128	9.128
Agreement	Yarjejeniya
people.	mutane.
posted,	posted,
people,	mutane,
thousands	dubban
Criminal	laifuka
them	yawansu
five	biyar,
sent	aika
AUTOEXEC.BAT	AUTOEXEC.BAT
image	image
instead,	baicin,
Capacity:	Capacity:
Dispute	jayayya
principles	akida,
nude	tsirara
Email	Email
subject &amp; quot;	batun&quot;
Finney)	Finney)
*****************	*****************
Card)	Card)
Between	Tsakanin
control? &amp; quot;	iko?&quot;
Interestingly	Sha&#39;awa
Circuits?	haihuwarka?
lesbians?	madigo?
ours.	tamu.
our,	tamu,
Do	Kada
Christ.	Kristi.
Circuits,	haihuwarka,
lesbianism.	madigo.
8300	8300
-or-	-or-
Terrorism	Ta&#39;addanci
people	mutanen
recyle	recyle
knives:	wukake:
VLB.	VLB.
&amp; gt;	daga&gt;
quack,	quack,
Education	Ilmin
empiric &amp; gt;	empiric&gt;
html>	engp2008@nusunix1.nus.sg
Act	Dokar
commitment	sadaukar
bases	kwasfansu
different	daban
Separately	dabam
avail.	wadãtar.
beast	dabba
12-14)	12-14)
\ &amp; Gt;	\&gt;
chilly	chilly
Lynn	Lynn
&amp; gt;	ne&gt;
Alabama	Alabama
agreed	amince
&amp; Lt; 1r1i7mINN4n4@cronkite.cisco.com&amp;gt ;,	&lt;1r1i7mINN4n4@cronkite.cisco.com&gt;,
safety	aminci
&amp; gt;	wurin&gt;
Union	Tarayyar
^^^^^^^^^^^^^^^^^^^^^^^^^^^^^^	^^^^^^^^^^^^^^^^^^^^^^^^^^^^^^
Lyme	Lyme
Isreal.	Isreal.
PowerBook.	powerbook.
test	gwajin
are	ana
new	sabon
prophets.	annabawa.
terms),	sharuddan),
Hitter	Hitter,
Repo	Repo
,	shi,
Villanova	Villanova
Orson	Orson
noise	amo
.	shi.
harmful,	cutarwa,
sins &amp; gt;	zunubansu&gt;
BEEN	ANYI
misinformed	misinformed
---------------------------------	---------------------------------
U there	kananan
work	aiki
search	neman
P7625)	P7625)
degrees	darajõji
complex	hadaddun
Scanned	leka
sent	aiko
Loneliness)	Punjabi)
&amp; Quot; un-authorized &amp; quot;	&quot;un-izini&quot;
testing.	gwaji.
methane,	methane,
methane.	methane.
about	game
yellow	rawaya
my	raina
;-)	;-)
tiny	kankanin
500.	500.
exactly.	daidai.
+31	+31
S.)	S.)
right,	daidai,
market	kasuwa
for	gama
(Request	(nemi
pacifist	pacifist
Treaty,	Alkawari,
overrepresented	overrepresented
Pluto	Pluto
exactly!	daidai!
published.	buga.
also,	suma,
Hostilities	Tashin
warm.	dumi.
claims	iƙirari
&#39;&#39; &amp; Gt;	&#39;mu&#39;&gt;
Brothers	&#39;yan&#39;uwa
earth	ƙasã
Ottawa,	Ottawa,
thing	abu
=============================	=============================
feature	siffa
US.	Amurka.
417-4101	417-4101
Randall	Randall
flaw	aibi
priest.	firist.
walk.	tafiya.
Timothy	Timothawus
html>	willisw@coe-nw.clemson.edu
fixed	gyarawa
talk &amp; quot ;.	magana&quot;.
End	Karshen
Micronics	Micronics
pounds),	fam),
Persecution	tsananta
Law &amp; quot ;?	Attaura&quot;?
Schuster)	Schuster)
them, &amp; quot;	musu,&quot;
weeks.	makonni.
&amp; Lt; 1993Apr21.182606.6798@ra.royalroads.ca&amp;gt;	&lt;1993Apr21.182606.6798@ra.royalroads.ca&gt;
CHRISTIAN.	Krista.
car	mota
DR350S	DR350S
&amp; Quot; pay &amp; quot;	&quot;biya&quot;
Smart!	wayo!
research	nazari
**********	**********
Italian	Italian
team	tawagar
Documents	daftarorin
Saturnian	Saturnian
gravitationally	gravitationally
Right),	DMA),
&amp; Quot; A	&quot;A
Fenton	Fenton
Travel	tafiyar
gun-laws.	bindiga-dokokin.
value,	darajar,
live &amp; gt;	rayu&gt;
relative	zumunta
&amp; Quot ;,	&quot;,
Prophet	Annabi
&amp; Quot; -	&quot;-
name,	sunan,
&amp; Quot ;.	&quot;.
html>	m-it2691@cs.nyu.edu
&#39;Cause	&#39;hanyar
Isaac,	Ishaku,
ground	ƙasa
You	Kana
teacher. &amp; quot;	malami.&quot;
effective	inganci
Disciples	Almajiran
html>	dlb@hudson.wash.inmet.com
next	gaba
argon,	argon,
property,	dukiya,
property.	dukiya.
SUPERVGA	SUPERVGA
maybe.	watakila.
Extensions	ƙari
protect	ƙare
further	ƙara
Askew	Askew
Catch	Kama
identity &amp; gt;	ainihi&gt;
&amp; gt;	ka&gt;
^^^^ &amp; Gt;	^^^^&gt;
students	daliban
easy &amp; gt;	sauki&gt;
are quacks	quacks
Nitrogen	Nitrogen
students	dalibai
jewelery	ado
Ulysses,	Ulysses,
moon	moon
Electronic	Lantarki
&amp; Quot; mysteries &amp; quot;	&quot;asirai&quot;
Conference	taron,
Whitsell	Whitsell
CHRIST	KRISTI
Origin	Asalin
Interim	gadi
OFF	KASHE
public	jama&#39;a
roads	hanyoyi
bridge	gada
Solar	Solar
alternately	alternately
++.	++.
healing	warkar
process &amp; gt;	aiwatar&gt;
613)	613)
&amp; Lt; 15378	&lt;15378
homosexuality	liwadi
Costner	Costner
consume	cinye
floor.	bene.
and,	har,
html>	hambidge@bms.com
18:33	18:33
bench	benci
floor,	bene,
Manually	hannu
power,	iko,
html>	DBD@ICF.HRB.COM
control)	iko)
(Clayton	(Clayton
wrong	zãlunci
theists)	theists)
Guerke	Guerke,
Guerke)	Guerke)
Cant	Cant
theists,	theists,
loved ones	masõyansa
&#39;Open&#39;.	&#39;bude&#39;.
raised	tãyar
Project	Project
load	aza
disease,	cuta,
surprise:	mamaki:
disease.	cuta.
Cape	Cape
(	(ya
greeting	gaisuwa
Round	Kewaye
cyphers?)	cyphers?)
untimely	untimely
backup &amp; gt;	madadin&gt;
outside.	waje.
11:26),	11:26),
business &amp; quot ;,	kasuwanci&quot;,
Karl	Karl
my religion	addinĩna
Sabres,	Sabres,
plastic	filastik
depression	ciki
3-8),	3-8),
full	cike
Surveyor	Surveyor
Cyclists	kekuna
carry on	ci-gaba
provided	azurta
(Herman	(Herman
seized	kãma
html>	ai843@yfn.ysu.edu
html>	thomasp@ifi.uio.no
spouts	spouts
shield	garkuwa
disease	cutar
Three-Way	Three-Way
fill	cika
Quebec &amp; gt;	Quebec,&gt;
Quest) &amp; gt;	nema)&gt;
Truth	gaskiya
Ground	Kasa
(Peter	(Peter
situated	ayi
control?	iko?
review	mujalla
Proteus	Proteus
(21,648	(21,648
Stone)	Stone)
people.	mutãnenta.
concern,	damuwa,
control.	iko.
magazines	mujallu
magic,	sihirin,
Concern)	damuwa)
compensation	diyya
usually	yawanci
v	aya
23-26,	23-26,
paper	takarda
behavior	hali
,	ba,
html>	alung@megatest.com
area	yankin
.	ba.
scholar	masanin
info.	info.
lowest	ƙasƙanci
back-door	baya-kofa
FJ1200	FJ1200
bodies	gawawwakin
documents	takardu
officials	jami&#39;an
coldest	coldest
going-out-of-work	faruwa-fito-na-aiki
so	haka
(Dan	(Dan
Thorson	Thorson
power	ikon
? &amp; quot;	mu?&quot;
relax &amp; gt;	shakata&gt;
hockey	hockey
Pharasees	Pharasees
stolen.	sace.
eavesdropper	eavesdropper
Stars	Stars
stabilization	ƙarfafawa
for	dõmin
(1,100	(1,100
resistance.	juriya.
--------------------------	--------------------------
km	kilomita
Corolla	Corolla
prevent	hana
licenses,	lasisi,
Muslim	Musulmi
que	que
Nagle	Nagle
complex	hadadden
Moon	Moon
probably	tabbas
to	wajen
Each	Kowane
==========================================	==========================================
&amp; Quot; Oh,	&quot;Kaitona,
Rauser	Rauser
leftist	leftist
2.5-km	2.5-kilomita
efforts	kokarin
HAMZA	HAMZA
meaning.	ma&#39;ana.
(Nicki	(Nicki
friends	abokai
Prime	Firayim
# &amp; Gt;	#&gt;
friends	abokan
Barry Bonds	Barry-hadar
sludge.	sludge.
Messenger	Manzo
Ulysses	Ulysses
unchanged	canzawa
Palestine	Palestine
itraconazole	itraconazole
years).	shekaru).
&amp; Quot;	&quot;Kuma
415-688-8231	415-688-8231
Nobuaki	Nobuaki
Ammonia	Ammonia
).	kasance).
20Meg	20Meg
countries?	kasashen?
Nowadys	Nowadys
Brooks	Brooks
cover	murfin
Switching	sheka
margins	ribace-ribace
spotted	hange
gloss	sheki
Pioneers	Pioneers
Hello,	Hello,
Telematics	Telematics
different.	daban.
section	sashe
ship	ship
--------	--------
fog	hazo
Name	Sunansa
JESUSCHRIST	JESUSCHRIST
Monitor	Monitor
: &amp; gt;	cewa:&gt;
candidate	takarar
short	kankanen
chunks.	chunks.
crossed	haye
(Rock)	(dutse),
there will be.	za&#39;ayi.
separately.	dabam.
junk	takarce
study	nazarin
Kokomo,	Kokomo,
ulterior	ulterior
gasoline,	fetur,
it?	shi?
for?	for?
refering	refering
deduced	deduced
trumpet	ƙaho
remove	cire
believe	imani
(	(su
definitely	shakka
(Der	(der
anti-fungal	anti-fungal
Ottoman	Ottoman
high-altitude,	high-tsawo,
poor	talakawa
Askew,	Askew,
(	(ta
Chicago.	Chicago.
surprise),	mamaki),
reasonning	reasonning
question	tambaya
improve	inganta
review	nazari,
conscience	lamiri
hours	awa
imaged	imaged
Ask	tambayi
asked	tambaye
unclumped	unclumped
Meaning	Ma&#39;ana
(1,170	(1,170
meaning	ma&#39;anar
Freq.	Freq.
animals	dabbobi
images	images
inactive	ƙeƙasasshiya
Small	Small
Palmer	Palmer
father	uban
multimillion	multimillion
before	gabãnin
Ullal)	Nunnally)
Order	Order
Alyosha	Alyosha
Keys	Makullin
&amp; Quot; That-a-kind	&quot;Wannan-da-irin
Askew)	Askew)
Lankford	Lankford
disciples	almajiransa
RSEVERY	RSEVERY
Carl	Carl
boulders.	boulders.
wherein &amp; gt; &amp; gt;	cikinta&gt;&gt;
Card	Card
(Where	(inda
Represented	wakilcin
me	ni,
headed,	gangarawa,
Justification_	Justification_,
me.	ni.
Tampa	Tampa
connection &amp; quot;	dangane&quot;
html>	pgf@srl03.cacs.usl.edu
Natal,	Natal&#39;,
detrimental	detrimental
role	rawa
UUNET:	UUNET:
Best!	Best!
I)	ni)
Conference	taron
8.1	8.1,
homosexal	homosexal
settings	saituna
Bacteria	Kwayoyin
Revelation	Ruya
Jesus	Yesu
&amp; Quot; full &amp; quot; &amp; gt;	&quot;cika&quot;&gt;
shed	zubar
me?	ni?
paradox	paradox
touch	touch
incinerate	incinerate
craters	craters
a,	wata,
a.	wata.
Alternation	Sãɓãwar
answers	amsoshin
&amp; Quot; comfort	&quot;sanyin
AT)	AT)
sale	sayarwa
Canadiens?	Canadiens?
&amp; Quot; conversations &amp; quot;	&quot;tattaunawa&quot;
_____	_____
net	net
sight	ganinsu
see	ganinsa
concept &amp; gt;	ra&#39;ayi&gt;
Development	raya
disciples	almajiran
prisoners	fursunoni
Range	Range
seem &amp; gt;	ze&gt;
No	Babu
Jesus	yesu
Invention	Ira
Asteroid	asteroid
Brothers	&#39;yan&#39;uwanku
From:	Daga:
Experts	Masana
Master	Ubangiji
Communications	Communications
class,	aji,
040	040
Knowing	Masani
20X-60X60mm	20X-60X60mm,
extermination	wargajewa
hetero	hetero
mountain	dutse
People	Mutane
bandwith	bandwith
Of course,	Hakika,
,	ne,
.	ne.
my opinion).	ganina).
length,	tsawon,
seven	bakwai
way	hanya
ultrahigh-resolution	ultrahigh-ƙuduri
ventured	ventured
Closure	ƙulli
Lamp	fitila
Language	Yaren
AIAA	AIAA
out.	fito.
men),	maza),
antennas	antennas
avoid	kauce
abide	madawwama
_______________________	_______________________
rescinded.	rescinded.
Phobos	Phobos
ridden.	assirtar.
&amp; Lt; C5xxq0.18M@cs.columbia.edu&amp;gt;	&lt;C5xxq0.18M@cs.columbia.edu&gt;
live	rayu
French-	French-
Carlton	Carlton
Read	Karanta
===============	===============
is:	ne:
problem	matsala
(Hawks	(shaho
.	aikin.
kasassun	kasassun
here	nan
Orient	Orient
low	maras
Panoramic	Panoramic
Baseball	Baseball
wrap.	kunsa.
BEFORE	KAFIN
Hyundai	Hyundai
WinJPEG	WinJPEG
&amp; Quot; Making	&quot;Yin
Magellan,	Magellan,
extension	faɗi
Its	Its
(OO)	(OO)
fight	faɗa
(Ron	(ron
classic	classic
tickets	tikiti
&amp; Quot; &amp; gt;	&quot;&gt;
5vdc	5vdc
000	000
Activity	ayyuka
ie	watau
month	watan
Humphreys	Humphreys
3.1	3.1,
&amp; Quot; draw	&quot;zana
Passing	Wucewa
Mystique &amp; quot;	Mystique&quot;
)	na)
summer	rani
day	rana
.	na.
apps,	apps,
,	na,
Statistics	ƙididdiga
132.252	132,252
INTRODUCTION	GABATARWA
belts	belts
ruling	mulki
Active	Active
html>	toml@boulder.ParcPlace.COM
Herman,	Herman,
hole	rami
proclaim	shelar
Word?	maganar?
^^^^^^	^^^^^^
Psalm	Zabura
oxygen	oxygen
al - 92-186,	al--92-186,
Jesus.	Yesu.
spaceship	kumbon
Jesus?	Yesu?
minutes.	minti.
meaning	ma&#39;ana
(Romans.	(Romawa.
Felix	Felix
movie	movie
&amp; Quot;	&quot;yin
all &amp; gt;	duka&gt;
Jesus,	Yesu,
light.	hasken.
Claudio	Claudio
Jesus)	Yesu)
disobedience	sãɓã
chipset	chipset
square	square
3.1?	3.1?
hurricane-like	guguwa-kamar
air,	iska,
ongoing	gudana
Americans).	Amirkawa).
help!)	taimake!)
(Bill	(Bill
lost	rasa
&amp; Quot;	&quot;Ya,
rare	rare
Jesus &amp; gt;	Yesu&gt;
interview	hira
&amp; gt;	suka&gt;
Once	zarar
| &amp; Gt; &amp; gt;	|&gt;&gt;
stop	tsayi
TranslateCoordinates	TranslateCoordinates
attack	farmaki
al /	al-/
Marlyn	marly
TIFF	TIFF
West	yamma
Timmons	Timmons
literally &amp; gt; &amp; gt;	zahiri&gt;&gt;
Fisher	Fisher
apple	apple
standing	tsaye
stand	tsaya
&amp; Quot; &amp; quot ;,	&quot;suka&quot;,
12-year	12-shekara
which	waxanda
memory.	memory.
weeks	makonni
formation	samuwar
6/92,	6/92,
mwm	mwm
stop	daina
&amp; Gt;	Shi&gt;
way: &amp; gt;	hanya:&gt;
death	mutuwar
Photos	Photos
html>	mlee@post.RoyalRoads.ca
rent	tsãge
love	kauna
girlfriend.	budurwa.
html>	v124p7kk@ubvmsc.cc.buffalo.edu
Work	Aikin
neccacery	neccacery
Ethnic	kabilanci
Change	Canza
height	tsawo
There &amp; gt;	Akwai&gt;
included	kunshe
features	siffofi
contains	kunshi
out	fitar
exceed	zarce
____________________________________________	____________________________________________
1992/93	1992/93
Perturbations	Perturbations
Jet	Jet
Inc.	Inc.
curable	curable
Date:	Date:
status	matsayi
feedback	feedback
player	kunnawa
business	kasuwanci
Triantafyllopoulos)	Triantafyllopoulos)
smaller	karami
day.	rana.
day	rana,
Safety	Safety
Mitchum)	Mitchum)
discoverer,	discoverer,
&amp; gt; &amp; gt;	da&gt;&gt;
while	yayin
cycle	zagayowar
Law	Attaura
Englewood,	Englewood,
namely,	wato,
Information)	Bayani)
questions.	tambayoyi.
community	al&#39;umma
different	daban-daban
motives	muradi
Adam.	Adam.
(Craf)	(CRAF)
leadership	shugabanci
Adam,	Adam,
Japan,	Japan,
Let	Bari
Flying	Flying
buried	binne
least	ƙanƙanta
knifes	knifes
Track	Track
(Hans	(Hans
html>	jaskew@spam.maths.adelaide.edu.au
Pasadena,	Pasadena,
radioisotopes.	radioisotopes.
Jay	Jay
Earth-Moon	Duniya-Moon
Vancouver	Vancouver
Faehl)	Faehl)
dioxide.	dioxide.
photovoltaic	photovoltaic
government	gwamnati
system.	tsarin.
guns.	bindigogi.
next.	gaba.
(Jews).	(Yahudawa).
option.	zabin.
system,	tsarin,
guns,	bindigogi,
emissions	watsi
ki	ƙi
Accelerator	totur
(AIR)	(AIR)
Data	Bayanan
up	dashi
College,	College,
resistors	resistors
sink	nutse
again))	sake))
parameters	sigogi
means	nufin
Back)	Back)
&amp; Quot; electroglow. &amp; Quot;	&quot;electroglow.&quot;
occasionally	lokaci-lokaci
Adams	Adams
Masters,	Masters,
these	wadannan
enemy	maƙiyi
Lore	Lore
tail	wutsiya
Where	Inda
email	email
enemies	maƙiya
Results	Sakamakon
^),	^),
Connector	haši
blowing	hurawa
exist &#39;	wanzu&#39;
gold	zinariya
Jews	Yahudawa
(303)488-6120	(303)488-6120
before	gaban
[386enh]	[386enh]
(_______________________)	(_______________________)
. &amp; quot;	yi.&quot;
Methods	hanyoyin
good	nagari
East	gabas
(Matt	(Matt
Speed	Gudun
bumper	damina
Low.	Low.
interactions	interactions
thrill	burge
fungal	fungal
(	(sai
point.	nufi.
Viking	Viking
language	harshen
general	general
Nagle)	Nagle)
on	ranar
system?	tsarin?
next?	gaba?
transmission	watsa
Galilei,	Galilei,
atraction	atraction
History,	Tarihi,
laetril	laetril
(National)	(National)
scan	scan
Info	Info
properties	kaddarorin
high	high
Easily	Saukake
system;	tsarin;
MacRae)	MacRae)
Later	Baya
surface	surface
His coming,	zuwansa,
&amp; Lt; 1993Apr17.125545.22457@rose.com&amp;gt;	&lt;1993Apr17.125545.22457@rose.com&gt;
my friend	abokina
AIR	AIR
^^^^^^^^^^^^^^^^^^^^^^^	^^^^^^^^^^^^^^^^^^^^^^^
ways.	hanyoyi.
Horus	Horus
West	yammacin
(Aili	(ailin
definition,	definition,
similarities,	kamance,
Christians,	Kiristoci,
There	Akwai
Christians.	Kiristoci.
rigths	rigths
issues	al&#39;amurra
html>	xx155@yfn.ysu.edu
Joseph	Joseph
reader	karatu
issues	al&#39;amurran
deriving	deriving
OR.	KO.
sea	tẽku
Microsystems	Microsystems
Galileo,	Galileo,
Equatorial	Equatorial
(437	(437
(Rick	(Rick
friend.	abokin.
distance.	nisa.
Bloomberg,	Bloomberg,
file	fayil
Management	Management
placebos	placebos
range	range
hearts	zukatan
******************	******************
rise	tashi
months.	watanni.
raised	tashe
Months	watanni,
economy	arzikin
100 &amp; gt;	100&gt;
Prime	Firaministan
Activity &amp; quot;	Ayyuka&quot;
mine	mine
gods	alloli
(Brian	(Brian
love	soyayya
me	mini
volts &amp; gt;	volts&gt;
lowers	lowers
radio	rediyo
803-654-8817	803-654-8817
dizzying	dizzying
British	British
gender.	jinsi.
house-sized	gidan-sized
Science	Science
flow	gudãna
Great)	girma)
&amp; Quot; hard	&quot;wuya
neighbor	maƙwabcinsa
Lots	Kuri&#39;a
Great,	girma,
Internet:	Yanar-gizo:
efforts	ƙoƙarin
2,400	2,400
rotational	rotational
astronaut	jannati
semiconductor	semiconductor
rich!	arziki!
(Only	(kawai
closed &amp; quot ;?	rufe&quot;?
word?	kalmar?
cloud-like	girgije-kamar
contains	kunshi,
component,	bangaren,
crime.	laifi.
Basu	Basu
Radio-Shack	Radio-Shack-iya
34.839	34,839
&amp; Quot; This	&quot;Wannan
size	girman
sci.crypt	sci.crypt
calculation	lissafi
state	furta
Arizona.	Arizona.
(Greek	(Greek
Jon	Jon
(447	(447
Island	Island
inept	inept
my opinion,	ganina,
Joe	Joe
Opposition	Adawa
-club	-club
record	rubũta
Bay,	Bay,
Before	Kafin
[LDS]	[LDS]
40Meg	40Meg
minutes	minutes
package	kunshin
molesters	molesters
unacceptable	unacceptable
Delco	Delco
guarantee	tabbacin
traces	burbushi
Infiniti?	Infiniti?
total	total
Things &amp; gt;	Things&gt;
Ju)	Ju)
life	rayuwata
ANY	KOWANE
let)	bari),
15:	15:
radar-draw	radar-zana
Harvey)	Harvey)
150	150
free	free
Only	Kawai
you	muku,
15,	15,
Stanley	Stanley
``. &#39;	``.&#39;
bbs:	bbs:
Remember,	tuna,
Although	Kodayake
sold	sayar
&amp; Quot; feel	&quot;jin
purchase	sayan
92.8	92,8
Apple	Apple
flyby	flyby
primeval	primeval
infusions	infusions
Wizzard	Wizzard
Tick	Tick
Rkba.	RKBA.
sins.	zunubansu.
only &amp; gt;	kawai&gt;
(215)645-6463	(215)645-6463
16,	16,
Wait?	jira?
country.	ƙasar.
relationship.	dangantaka.
country,	ƙasar,
manufacturing	masana&#39;antu
176	176
17:	17:
170	170
Now,	Yanzu,
warmer	warmer
_hard_	_hard_
patients	marasa
knowingly	sane
rendezvous	rendezvous
know	sani
purchase,	saya,
X-Window	X-Window
(Brian@gab.unt.edu)	(Brian@gab.unt.edu)
think.	tunani.
himself.	kansa.]
update	sabunta
thought,	tunani,
More	Mafi
Think!	tunani!
NCI.	NCI.
johnson	johnson
found	sami
bar	guntu
(David	(David
heaven	sama
(Post	(post
time.	lokaci.
straight	mike
time,	lokaci,
relations	dangantakar
address.	address.
offered	mika
transmission	yaɗuwar
intentionally	ganganci
1984 &amp; gt;	1984&gt;
A,	Mai,
11.	11.
numbers	lambobin
DEVICE	NA&#39;URA
Noring)	Noring)
found	samu
20850	20850
purchasing	sayen
Outline	Shaci
&amp; Quot; As	&quot;Amma
html>	cramer@optilink.COM
know,	san,
122	122
Shack	Shack
miles)	mil)
Wise)	hikima)
sale	sale
play,	wasa,
(	(aka
play.	wasa.
Hebrews	Ibraniyawa
yesterday	jiya
Imagine	tunanin
arab,	arab,
120	120
12)	12)
12,	12,
&amp; gt;	haka&gt;
Quinn)	Quinn)
Phone	Phone
release	saki
meaning	ma&#39;anarta
again	sake
Healers	Healers
insert	saka
(408)	(408)
Launched	kaddamar
molestation	molestation
real	ainihin
characteristics	halaye
Orbiter	Orbiter
Palestine?	Palestine?
sickening, &amp; gt;	sickening,&gt;
myslef)	myslef)
Camary	Camary
13,	13,
Clark.	Clark.
Mail	Mail
window &amp; gt;	taga&gt;
------------------------------	------------------------------
&amp; Lt; timmbake@mcl.ucsb.edu&amp;gt; &amp; gt; &amp; gt;	&lt;timmbake@mcl.ucsb.edu&gt;&gt;&gt;
fun	ba&#39;a
waiting	jiran
149	149
14:	14:
distributor	rabawa
predicted	annabta
********	********
company	kamfani
tight	ƙanƙan
match	wasan
14,	14,
cryptoanalysis.	cryptoanalysis.
Consider	la&#39;akari
asteroids,	asteroids,
all)	duka)
all	duka,
Torre	Torre
storm	hadari
Chemical	Chemical
perturbed	perturbed
cut	yanke
Section	Sashen
area	yanki
markets	kasuwanni
Median	Bamediye
buy	saya
brother,	ɗan&#39;uwansa,
purchase	saye
buy	sayi
html>	wagner@mala.bc.ca
Latonia)	Latonia)
called.)	kirawo.)
(Noring	(Noring
Expansion-cruel	Fadada-muguwar
Church	Ikilisiya
numbers.	lambobi.
streaks,	streaks,
vitamin &amp; gt;	bitamin&gt;
events	al&#39;amuran
Bonds.	hadar.
seed	zuriya
LA	LA,
Streaming,	yawo,
Craf	CRAF
imagination	kwatanci
(Audible	(audible
null	ɓãta
&amp; Lt; 93095@hydra.gatech.EDU&amp;gt ;,	&lt;93095@hydra.gatech.EDU&gt;,
cut	yanka
readiing	readiing
martian	martian
prohibited,	haramta,
clusters	gungu
disease	cuta
Bell-Northern	Bell-Northern
19,	19,
mean?	nufa?
html>	mouse@thunder.mcrcim.mcgill.edu
Fraering	Fraering
(Oh,	(Oh,
Mayans	Mayans
VESA	VESA
RA &amp; gt;	RA&gt;
pitching	pitching
Tourism	yawon
19?	19?
President.	shugaban.]
&#39;Who	&#39;Wanda
19:	19:
&amp; Quot; standard &amp; quot;	&quot;misali&quot;
life	rãyuwar
face	fuskar
array	tsararru
Comments?	Comments?
Halley	Halley
Diseases	Cututtuka
Head	Kai
trillionth	trillionth
keys.	makullin.
petty	tausayin
&amp; Quot; If	&quot;Idan
Mercury	Mercury
card	katin
pointers	pointers
VE7GDA	VE7GDA
---------------	---------------
all	dukan
Equipment	Boats
seafarers	seafarers
Resp.	Resp.
LDS	LDS
sophisticated	nagartaccen
Antarctica.	Antarctica.
next Bonds	gaba-hadar
LED	LED
Health &amp; quot;	lafiya&quot;
title	lakabi
honors	karrama
~~~	~~~
can,	iya,
driver,	direba,
(Isaac	(Is&#39;hãƙa
accused	zargi
create	haifar
Grounds	filaye
&amp; gt;	sa&gt;
Ken	Ken
compulsory	wajibi
reduced	rage
evening	maraice
set	saita
lamb	rago
while	matukar
life.	rai.
read	karanta
floppies	floppies
Matt	Matt
six.	shida.
tails.	wutsiyoyi.
decrease	ragu
tails,	wutsiyoyi,
&#39;Normal	&#39;al&#39;ada
difference	bambancin
gravitacional	gravitacional
&amp; Lt; 1993Apr4.221228.17577@bsu-ucs&amp;gt;	&lt;1993Apr4.221228.17577@bsu-ucs&gt;
agriculture.	noma.
negative.	korau.
It,	Shi,
visiting	ziyartar
&#39;Theos&#39;	&#39;Theos&#39;
The	Masu
trees,	itatuwa,
writings	rubuce-rubucen
born,	haife,
intent	niyyar
problems	matsaloli
dust	ƙura
export?	fitarwa?
(Gordon	(Gordon
(510)	(510)
Scandinavians	Scandinavians
(Homosexual	(kishili
Pan-European	Pan-Turai
Washington	Washington
fight	fada
plausible	plausible
mountains	duwatsu
find &amp; gt;	samu&gt;
factor	factor
html>	astein@israel.nysernet.org
changes	canje-canje
(Keith	(Keith
Rafi	rafi
collisions	collisions
Whether	Shin
death.	mutuwa.
competition	gasar
death,	mutuwa,
patches	faci
100,000	100,000
Closed	Rufe
travesty	travesty
beauty	kyan
Express	Express
Sports	Sports
northerly	northerly
Infiniti	Infiniti
extension	fadi
witness	shaida
mountain	tudu
evacuated.	kwashe.
html>	vacsc0qe@VAX.CSUN.EDU
keybd	keybd
html>	scott@asd.com
index	index
Selective	zababben
1-26	1-26
Education	ilimin
Office:	Ofishin:
Kipling	Kipling
colors &amp; gt;	launukansa&gt;
dialup	dialup
years	shekaru
propulsion	propulsion
David.	Dawuda.
html>	starowl@rahul.net
good	kyau
playoffs!	playoffs!
tobacco,	taba,
converted	tuba
motion	motsi
prophetic	annabci
tube	tube
move	motsa
anti-gun,	anti-gun,
year	shekara
resistance	juriya
&amp; Quot; Borshevshky &amp; quot ;.	&quot;Borshevshky&quot;.
cooling	sanyaya
(Alan	(Alan
Gordon	Gordon
Weiss)	Weiss)
ciphertext	ciphertext
machine)?	injin)?
Michael	Michael
5.0.	5.0.
Benedikt	Benedikt
Men	Maza
PB170	PB170
syria.	syria.
M.)	M.)
Oil,	Man,
migrating	migrating
plumes	plumes
break-teacher?	karya-malami?
mine!	mine!
Or,	Ko,
season,	kakar,
Pittsburgh,	Pittsburgh,
patient	haƙuri
mine.	mine.
on	akan
cover	cover
Barman)	Barman)
basis	akai
Healing	warkewa
Cipher?	cipher?
other.	wasu.
Folta	Folta
Palestine.	Palestine.
others	wasu,
1.3	1.3
Male	Male
1.1	1.1
Related	Shafi
represented.	wakilta.
system	tsarin
frequently	akai-akai
html>	bep1@cbnewsg.cb.att.com
5-minutes	5-minti
&amp; Lt; lsj4ruINNl7o@saltillo.cs.utexas.edu&amp;gt;	&lt;lsj4ruINNl7o@saltillo.cs.utexas.edu&gt;
hair	gashi
him?	masa?
1-2	1-2
10.	10.
10,	10,
0,14	0,14
relays?	relays?
encrypting	encrypting
saving	ceton
paraphrase: &amp; gt; &amp; gt;	fasara:&gt;&gt;
really	gaske
barrier	shãmaki
(Malcolm	(Malcolm
intollerent	intollerent
pounds)	fam)
volcanoes.	volcanoes.
represents	wakiltar
Kou	Kou
saing	saing
100	100
bought.	sayi.
channels	tashoshi
office	ofishin
absent	faku
Edmonton	Edmonton
debate	shawarwari
Vicar	Vica
comparison	kwatanta
ionosphere,	ionosphere,
fan.	fan.
1/2	1/2
purity	tsarki
myopic,	myopic,
(Baked	(Gasa
Free download,	Bure,
on-line	on-line
victims	fama
clueless	clueless
(Gary	(Gary
Adams.	Adams.
radiated	radiated
Adams)	Adams)
saved,	ceto,
separated	rabu
Remember	tuna
Rule	Mulkin
Tiff	Tiff
Bernard)	Bernard)
_National	_National
thermocouples	thermocouples
MIniVas	MIniVas
Transmission	Watsin
Switching &amp; gt;	sheka&gt;
actually,	zahiri,
Questions	Tambayoyi
security	tsaro,
ugly	mummuna
security.	tsaro.
planets.	duniyoyi.
ruins	kufai
books	littattafai
Bures	Bures
&amp; Quot; T &amp; quot;	&quot;T&quot;
assult	assult
Mars	Mars
etc. &amp; gt;	sauransu&gt;
rings,	zobba,
screen	allon
driving	tuki
rings.	zobba.
&amp; Quot; security	&quot;tsaro
tranfer &amp; gt;	tranfer&gt;
Mark	Mark
Marc	Marc
reserve	ajiye
share	rabo
GIF.	GIF.
ours.	namu.
Rule	Rule
GIF,	GIF,
ours,	namu,
half	rabi
me?	mini?
gases	gases
short-lived.	short-rayu.
therapy,	far,
therapy.	far.
beautified	ƙawãta
share	raba
thermocouple,	thermocouple,
Singapore	Singapore
stargazers	stargazers
ExposureMask	ExposureMask
spheres	duniyoyin
last year	bara
below.	kasa.
sale?	sayarwa?
help	taimako,
top-left	saman-hagu
pains	raɗaɗin
Pluto),	Pluto),
relays	relays
sale.	sayarwa.
Neal	Neal
Bicentennial.	Bicentennial.
let	bari
cleared,	barrantar,
vshield	vshield
bequest	wasiyya
Hour	sa&#39;a
...	...
Fang)	Fang)
question	tambayar
estimated	kiyasta
Mountain	Tsauni
Eurosport	Eurosport
TIMES	lokatan
effect.	sakamako.
guess	tsammani
Reward	sakamako,
Reward:	sakamako:
and &amp; gt;	kuma&gt;
phosphorus)	phosphorus)
country	kasar
computer;	kwamfuta;
Cipriani)	Cipriani)
help	taimakon
error	bata
competently	competently
not	basu
Spend	ciyar
jargon	jargon
computer?	kwamfuta?
Matthew	Matiyu
fax:	fax:
&#39;&#39;	&#39;a&#39;
Speaking).	magana).
cryptanalysis.	cryptanalysis.
fax.	fax.
island	tsibirin
worthy	cancanta
fuel &amp; gt;	makãmashin&gt;
replacement	sauyawa
results	sakamakon
trading	ciniki
oozed	oozed
across,	fadin,
computer.	kwamfuta.
window	taga
computer,	kwamfuta,
us	bamu
precursor	precursor
photographed	photographed
skin	fata
bane	bane
Canadians	Canadians
software	software
band	band
(April	(Afrilu
is	tana
lumpy	lumpy
parents	iyaye
tap,	tap,
car.	mota.
our	tamu
calls	kira
ppm,	ppm,
hour.	sa&#39;a.
bust	fasa
all.	dukan.
bisexual.	bisexual.
all	dukan,
all)	dukan)
NOBODY	NOBODY
guilty	laifi
murder &#39;	kisankai&#39;
&amp; Quot;	&quot;wani
Americans,	Amirkawa,
or	ko&#39;
written.	rubuce.
-Karl	-Karl
writing,	rubuce,
world.	duniya.
color,	launi,
causing	haddasa
World	duniya,
Americans:	Amirkawa:
nickel-core	nickel-core
screen	allo
another	jũna
[People]	[mutãne]
start	fara
skills	basira
audio.	audio.
sure.	tabbatar.
drought	fari
sure,	tabbatar,
events	faru
lan	lan
handles	iyawa
Consulting,	Consulting,
&amp; Lt; 15464@optilink.COM&amp;gt;	&lt;15464@optilink.COM&gt;
left,	bar,
Pittsburgh	Pittsburgh
audio,	audio,
snowball.	snowball.
and	sa&#39;an
Imagine.	tunanin.
which	wadda
Educating	Ilmantar
statement.	sanarwa.
statement,	sanarwa,
Kaldis	Kaldis
SRESURRECTION ::::	&#39;SRESURRECTION::::
Mariner	Mariner
Youth-Leith)	matasa-Leith)
orbiter	orbiter
play	taka
orbited	orbited
title	take
hospital	asibiti
Wisdom	Hikimar
Manure	taki
volts.	volts.
color	launin
when	sa&#39;ad
important	muhimman
screens &amp; gt;	fuska&gt;
world	duniyar
sit &amp; gt;	zauna&gt;
off	kashe
ratio &amp; gt;	rabo&gt;
Lines.	Lines.
percent	kashi
conference	taro
other	sauran
Tug-of-war	Tug-na-yaƙi
Miranda	Miranda
with	tare
it	tanã
war.	yaki.
Key	mažalli
family	iyali
gun.	bindiga.
bowl	tasa
&#39;Interpretation&#39;	&#39;fassarar&#39;
you	kun
Rifle,	bindiga,
exception.	togiya.
together	taru
tails	wutsiyoyi
meat	naman
palm	itãcen
promiscuity &amp; gt;	promiscuity&gt;
Eve	Hauwa&#39;u
html>	mls@panix.com
Adjustable	Daidaitacce
Gnomes	Gnomes
exploiting	tozarta
family	iyalinsu
increase.	dadewa.
Lee	Lee
nine	tara
position.	matsayi.
&amp; Lt; C4vG3F.Kx3@apollo.hp.com&amp;gt ;,	&lt;C4vG3F.Kx3@apollo.hp.com&gt;,
Debate	Shawarwari
Price	Price
Limited	iyaka
later	baya
added).	kara).
statement	sanarwar
spread	shimfiɗa
England	England
Thorson)	Thorson)
War	yakin
God	Allahn
Shapiro)	Shapiro)
you?	ku?
race	kabila
understanding	fahimtar
Dr.Banzai	Dr.Banzai
understand	hankalta
planetology.	planetology.
,	ku,
(0,0)	(0,0)
Law	Law
........	........
.	ku.
Support)	Support)
&amp; Gt;	Yana&gt;
MDs	MDs
mode,	yanayin,
mode.	yanayin.
provision	arziki
motif	motif
.45	.45
html>	dbd@icf.hrb.com
English	Turanci
mode:	yanayin:
as	matsayin
1-800-344-4539.	1-800-344-4539.
Mouse	Mouse
The islands	tsibiran
.	yake.
,	yake,
&amp; gt; &amp; gt;	cewa&gt;&gt;
400 &amp; gt;	400&gt;
MC)	MC)
Canadians:	Canadians:
replaced	gurbin
rebooted	rebooted
Rubin)	Rubin)
is:	yake:
minutes	minti
oOOO	oOOO
cash	tsabar
FJ1200 &amp; gt;	FJ1200&gt;
complications	rikitarwa
Rubin.	Rubin.
Rubin,	Rubin,
X11R5	X11R5
X11R4	X11R4
deserts,	hamadar,
ethane,	ethane,
&amp; Quot; business &amp; quot;	&quot;kasuwanci&quot;
&amp; Quot; Ninety	&quot;Casa&#39;in
mistakes	kuskure
&#39;Surface,	&#39;surface,
seeded	seeded
do	aikatãwa
issue	batu
html>	kmac@cisco.com
total	jimlar
process &amp; gt;	tsari&gt;
characteristic &amp; gt;	halayyar&gt;
Neon	Neon
Priests	firistoci
Agnosticism	Agnosticism
McDonnell	McDonnell
range.	range.
shapes	suranta
html>	hal@cco.caltech.edu
Administration	Administration
Honda,	Honda,
Flown	Flown
(38.8	(38.8
prepared	shirya
dept.	dept.
water-ice	ruwa-kankara
float	taso
ready	shirye
characterization	faye
&amp; Quot; Note	&quot;lura
move	matsa
dissolved	narkar
excoriate	excoriate
html>	joshuaf@yang.earlham.edu
SETVER.EXE	SETVER.EXE
html>	munns@cae.wisc.edu
group	kungiyar
Model	Model
&amp; Lt; 19613@pitt.UUCP&amp;gt ;,	&lt;19613@pitt.UUCP&gt;,
e-mail	e-mail
homosexuality &amp; gt;	liwadi&gt;
sex	jima&#39;i
html>	Steve.Shapiro@f440.n101.z1.fidonet.org
Distance	Nesa
body	jiki
&amp; Quot; license	&quot;lasisi
time	karon
Siemon	Siemon
reference	tunani
rigorous	rigorous
right &amp; gt;	daidai&gt;
Infusion	jiko
XR250L	XR250L
Andreas	Andreas
Press-Democrat,	Latsa-Democrat,
for &amp; gt;	saboda&gt;
see),	ganin),
Terra	Terra
century	karni
low	low
honor	girmamawa
Luis &amp; gt;	Luis&gt;
Dual-air	dual-iska
Former	Tsohon
circular	madauwari
Patricia	Patricia
scripts	rubutun
Star	Tauraro
lengthy	lengthy
p.s.	p.s.
baby	baby
International	International
&amp; gt;	kan&gt;
no	babu
help!	taimaka!
offers	tayi
rises	yakan
cosmic	cosmic
lmh	lmh
&amp; Lt; Apr.9.01.09.22.1993.16580@athos.rutgers.edu&amp;gt;	&lt;Apr.9.01.09.22.1993.16580@athos.rutgers.edu&gt;
service.	sabis.
designed-in	tsara-in
(Yeast)	(yisti)
&amp; Quot; Proper	&quot;Proper
giving	bada
service,	sabis,
MLS	MLS
winter.	hunturu.
Torre	torre
Premier,	ƙwalo,
do.	aikata.
Special	musamman
Cisco	Cisco
visit.	ziyarci.
search-	bimbinin
beleive	beleive
ethane-methane	ethane-methane
read &amp; gt;	karanta&gt;
uucp:	uucp:
(This	(wannan
activities	ayyukan
Korenek	Korenek
(Ryan	(Ryan
drugs	kwayoyi
more	karin
nicad	nicad
Rocket &amp; quot;	Rocket&quot;
_ARE_	_ARE_
Comets	Comets
Jews?	Yahudawa?
&amp; Quot; gun	&quot;gun
offering	hadaya
Center	Cibiyar
html>	192.100.81.100
&amp; Quot; placebo	&quot;placebo
3 &amp; quot ;,	3&quot;,
beautiful	kyawawa
html>	lmh@juliet.caltech.edu
outright.	outright.
mother-	mother-
cap	hula
features	fasali
interpretations.	fassarori.
may not	bazai
Sound	Sauti
Davis	Davis
Internet:	Internet:
bound	daure
henry	henry
(By the way,	(Af,
repopulation	repopulation
BIND	daura
Mail:	Mail:
Stalin?	Stalin?
David	David
blood	jinin
Mountains	Duwatsu
Cardinals	Kadina
Help!	taimake!
(Starowl@a2i.rahul.net)	(starowl@a2i.rahul.net)
important	muhimmiyar
Basic	Basic
at least	akalla
PCX,	PCX,
???	???
Institute	Institue
5-7)	5-7)
&amp; Lt; May.7.01.08.16.1993.14381@athos.rutgers.edu&amp;gt;	&lt;May.7.01.08.16.1993.14381@athos.rutgers.edu&gt;
same to you&#39;	kuma&#39;
Mormonism	Mormonism
previous	gabata
.....)	.....)
memorial	tunawa
regulation	ka&#39;ida
Prism	Prism
Twilight	faduwar
&amp; Quot; Buy	&quot;Buy
(225	(225
only.	kawai.
crews	crews
level	baje
capacitive	capacitive
CAS.	CAS.
Ezekiel)	Ezekiel)
Only	kawai,
reason	dalilin
Several &amp; quot;	dama&quot;
NatLamp	NatLamp
return	komawa
women;	mata;
Bucky	Bucky
stats.	stats.
women,	mata,
5-6.	5-6.
controllers	rinjãya
Technology,	Fasaha,
N81	N81
Canaveral	Canaveral
black	baki
interested,	interested,
bankrupt	fatara
Pixel	pixel
... &amp; Gt;	...&gt;
hint	ambato
lair.	lair.
heat	zafin
fairly	fairly
Sent	Sent
Orbital	orbital
sell	sell
&amp; Quot; adequately	&quot;mayalwaci
distance.	nesa.
mother	uwar
false	karya
fly-change	tashi-canza
ball	ball
post	post
cache	cache
day).	ran).
(Life	(Life
trillion	tiriliyan
secure	amintattu
field	fagen
November	Nuwamba
wait	jira
mentioned	ambata
god)	bautãwa)
html>	m-it2691@DOC.CS.NYU.EDU
Cloud,	Cloud,
god,	bautãwa,
god.	bautãwa.
Mouse)	Mouse)
heat.	zafi.
heat,	zafi,
town	garin
game!	wasan!
NASA,	NASA,
Disease	Cuta
Rights	hakkoki
game.	wasan.
Roman	Roman
Wednesday	badi
bags)	bags)
18th	18th
--------------------------- &amp; Gt;	---------------------------&gt;
game?	wasan?
html>	folta@well.sf.ca.us
time	lokacin
to:	zuwa:
blue	shuɗe,
East)	gabas)
price.	price.
to.	zuwa.
Landmann)	Landmann)
facade	facade
price	price,
Replace	Sauya
recedes	recedes
She is	Itace
from.	daga.
symbolisms	symbolisms
from	daga,
Maybe	Watakila
People	Mutanen
to	zuwa,
)	zuwa)
TIDSA	TIDSA
(We	(muna
Triton	Triton
question?	tambaya?
algorithm?	algorithm?
Christian	Kirista
1742	1742a
four	hudu
Halley,	Halley,
origin	asalin
Christ	Kiristi
Loc	Loc
question,	tambaya,
question.	tambaya.
1.00	1.00
===================================	===================================
(	(wadanda
taken	dauka
(800)	(800)
degree	digiri
algorithm,	algorithm,
balls	bukukuwa
reason.	dalili.
Magellan	Magellan
blood	jini
astronaut.	jannati.
center	cibiyar
reaction	dauki
astronaut,	jannati,
carrying	dauke
welshed	welshed
options	zažužžukan
Devices	na&#39;urorin
lead.	gubar.
determined	ƙaddara
Schaufenbuel)	Schaufenbuel)
Help:	Taimako:
Foreign	Harkokin
LM350T	LM350T
colors	launukansa
electronic?)	lantarki?)
thread	thread
also,	ma,
bodies	gawarwakin
too.	ma.
1759,	1759,
colors,	launukansa,
country	qasar
democracy	demokraɗiyya
tipped	tipped
exist?	wanzu?
regulator,	kayyadewa,
18EB	18EB
coach	kocin
versa &amp; quot;	versa&quot;
side	gefe
documents	takardun
Now	Yanzu
Postbus	Postbus
secrets	asirai
{Uunet	{uunet,
doctor.	likita.
fortay	fortay
mac	mac
-km	-km
///	///
Subject:	Subject:
MOTORCYCLE	kawasaki
MC05A	MC05A
a	mai
doctor?	likita?
message	saƙon
Makan	Makan
verses.	ayoyi.
&amp; gt;	yi&gt;
Interestingly	sha&#39;awa
River	River
oil	man
taking	daukar
dark,	duhu,
Finnish,	Finnish,
(Billy	(Billy
takes	daukan
heel,	diddige,
kickback	kickback
heel.	diddige.
Crusaders	Salibiyyar
General &amp; gt;	janar&gt;
number	adadin
unscrupulous	unscrupulous
distribution	rarraba
myths	camfin
(Challenged	(kalubalanci
distinctive	rarrabe
15-The	15-The
(Makan	(Makan
10--	10--
html>	gt4417a@prism.gatech.edu
two &amp; gt; &amp; gt;	biyu&gt;&gt;
Expensive	tsada
Borland	Borland
shoot	harba
but	amma
Agency)	Agency)
shooting	harbi
Agency.	Agency.
&amp; Quot; clear	&quot;bayyana
currency	kudin
rehearse	karãtun
shipping.	shipping.
responsibility	alhakin
Government	Gwamnatin
**************************************************	**************************************************
tests	gwaje-gwaje
Gregory	Gregory
-------------------------------------------------	-------------------------------------------------
positioning	sakawa
shipping)	shipping)
nitrogen	nitrogen
(Elaine	(Elaine
guru	guru
rate:	kudi:
vents	vents
mine)?	mine)?
Scale	sikelin
Wisdom	hikima
money,	kudi,
&#39;Rotation	&#39;juyawa
goodness	alherin
statement	sanarwa
President	shugaba
According to	cewar
___________________	___________________
answer	amsa
judge	hukunta
micrometeorites,	micrometeorites,
remember	ambaci
html>	lmh@shakes.caltech.edu
MS-Windows?	MS-Windows?
Thank you!	gode!
Joshuaf	Joshuaf
Why?	Me?
23:17:25	23:17:25
destruction.	halaka.
..:. &#39;	..:.&#39;
html>	Cl056@cleveland.Freenet.Edu
Thank you.	gode.
Thank you,	gode,
[Insert	[saka
Jews,	Yahudawa,
saved	ceto
visit	ziyarci
Jews.	Yahudawa.
Great	Great
debating	debating
days?	kwana?
after-off	bayan-kashe
water	ruwan
Meg	Meg
century,	ƙarni,
astronomical	astronomical
that.	cewa.
that	cewa,
NHL	NHL
sattellite	sattellite
feet.	ƙafafunsa.
metal	karfe
that:	cewa:
Toronto	Toronto
strength	karfi
Florida.	Florida.
Mariners	Mariners
experience	fuskanci
Parsli	Parsli
Guthrie	Guthrie
Chronology.	Chronology.
Christianity.	Kristanci.
mystery.	asiri.
bonuses,	kari,
Extensions)	kari)
Windows	Windows
group	rukuni
three &amp; gt;	uku&gt;
water.	ruwa.
arcs,	arcs,
bacteria	kwayoyin
cliffs	cliffs
Williams	Williams
SMARTDRV.EXE	SMARTDRV.EXE
Greg,	Greg,
office,	ofishin,
^^^^^^^^^^^^^^^^^^^^^^^^^^^^^	^^^^^^^^^^^^^^^^^^^^^^^^^^^^^
intentionally.	ganganci.
knapsack	knapsack
gun.	gun.
html>	km@cs.pitt.edu
Kevin	Kevin
Phillip)	Phillip)
Oil	Man
percentages.	percentages.
screens	fuska
Phone	Wayar
figure.	adadi.
Dayton	Dayton
A	Mai
Actually	Hakika
difficult	wuyar
Mac	Mac
neck	wuyan
holiday	hutu
Yorker,	Yorker,
sulfuric	sulfuric
months)	months)
swirling	swirling
Impedance	Impedance
written	rubuce
energy	kuzarin
html>	rls@uihepa.hep.uiuc.edu
France	Faransa
that	cewa
flight	guje
fractured.	fractured.
lying	kwance
May	May
exist.	wanzu.
count	kidaya
exist,	wanzu,
html>	ethan@cs.columbia.edu
little	kadan
NET	NET
specific	takamaiman
states	jihohin
recently	kwanan
Children	&#39;ya&#39;ya
list	list
Phone:	Waya:
(Benedikt	(Benedikt
Blue	&#39;blue
type.	irin.
only	kadai
virtual-based	rumfa-tushen
spins	spins
received	karbi
angry	fushi
hard,	wuya,
--------------------------------------------------	--------------------------------------------------
worthy	cancanci
exactly	daidai
&amp; Gt; &amp; gt; &amp; gt; &amp; gt; &amp; gt;	&gt;&gt;&gt;&gt;&gt;
shack	shack
firearm.	firearm.
NOW	NOW
1975	1975
(Re:	(Re:
firearm?	firearm?
application.	aikace.
think	zaton
1977	1977
1979	1979
Catalog	Catalog
testament &amp; quot;	wasiya&quot;
Fisher)	Fisher)
buckling	buckling
C.O.D.	C.O.D.
cell	cell
calculated	lasafta
Knowing,	Masani,
_____________________________________________________________________	_____________________________________________________________________
- &amp; Gt; &amp; gt;	-&gt;&gt;
stacks	stacks
cook,	dafa,
1990	1990
alyoung@kiwi.ucs	alyoung@kiwi.ucs
cook.	dafa.
issue,	batun,
7.00.	7,00.
486/33	486/33
Taken	Dauka
Deimos.	Deimos.
name.	sunansa.
But	Amma
political	siyasa
unrivaled.	unrivaled.
contract	kwangila
reprehensible	reprehensible
achievements	nasarorin
filled,	cika,
motherboard.	motherboard.
Karamazov	Karamazov
SMALL.	qarami.
1991	1991
composing	composing
1992	1992
most	mafiya
hearts.	zukatansu.
Ganymede,	Ganymede,
1993	1993
1994	1994
LM350K.	LM350K.
NRA	NRA
1999	1999
| &amp; Gt;	|&gt;
movement.	motsi.
proposal	tsari
How	Yaya
Misery	mũnin
security	tsaro
with.	tare.
Prophets	Annabãwa
Zeno	ZENON
be?	kasance?
Note	Note
fish	kifi
designed	tsara
skateboard	skateboard
shaft	shaft
guard	tsare
a &amp; gt;	wani&gt;
co-ordinates	co-ordinates
Alice,	Alicea,
Winds	iskõki
3:31	3:31
affected	shafa
manager,	sarrafa,
driving.	tuki.
&amp; Lt; 1993Apr22.153000.1@vms.ocom.okstate.edu&amp;gt; &amp; gt;	&lt;1993Apr22.153000.1@vms.ocom.okstate.edu&gt;&gt;
.	kasance.
Related	shafi
,	kasance,
Learn	Koyi
eliminated	shafe
actually	haƙiƙa
------------------------------------------	------------------------------------------
(360	(360
(Back)	(baya)
available	samuwa
MacRae	MacRae
professional,	sana&#39;a,
sins	zunubanmu
&#39;Doping&#39;	&#39;doping&#39;
Mix	Mix
driving?	tuki?
bombarded	bombarded
ordering	ordering
Boil	tafasa
back)	baya)
lower	sassauta
later,	baya,
back.	baya.
music	kida
Health	lafiya
gorges,	gorges,
extrapolation	extrapolation
single	guda
(NIV)	(HAU)
&amp; Lt; thomasp@ifi.uio.no&amp;gt;	&lt;thomasp@ifi.uio.no&gt;
quality?	quality?
We,	mu,
dead	matattu
ODDS	shaho
us.	mu.
out	fita,
center	hedkwatarsu
html>	carl_f_hoffman@cup.portal.com
Everyone	Kowa
html>	jodfishe@silver.ucs.indiana.edu
html>	shapiro@sofbas.enet.dec.com
run	gudu
we?	mu?
issue.	batun.
Resting	Allaha
&amp; Lt; 1993Apr16.173252.7393@asd.com&amp;gt ;,	&lt;1993Apr16.173252.7393@asd.com&gt;,
(West	(yamma
extrapolating	extrapolating
thriving	thriving
Force	Tilastawa
extinguish &amp; gt;	bice&gt;
above. &amp; gt;	sama.&gt;
worse,	muni,
dry	bushe
provided	bayar
worse.	muni.
Cresswell,	Kawaguchi,
old.	haihuwa.
after	bayan
maintenance,	tabbatarwa,
--- &amp; Gt;	....&gt;
layers	yadudduka
found	sãmu
photochemistry	photochemistry
-----------------------------	-----------------------------
(Larry	(Larry
Steve.	Steve.
we	mun
theist	theist,
hold	riƙe
little.	kadan.
html>	slegge@kean.ucs.mun.ca
taken	riƙi
found	sãme
NASA	NASA
mouse	linzamin
justifications	justifications
team,	tawagar,
team.	tawagar.
Allah,	Allah,
one,	ɗaya,
God.	Allah.
hey,	hey,
reports	rahotannin
(A	(wani
do	aikatawa
enemies	makiya
Brooklyn,	Brooklyn,
Justice	shari&#39;a
flowed	flowed
Uranian	Uranian
Ctrl-Alt-Del	Ctrl-Alt-Del
1200-1500.	1200-1500.
Av	Ɗari
female,	mace,
We	Mun
save	cece
those	wadanda
(323	(323
split	tsaga
high-speed	high-gudu
Momentary &amp; gt;	yanzu-yanzu&gt;
save	ceci
disease &amp; quot ;.	cũta&quot;.
Discussion	Tattaunawa
leaders	shugabannin
Kou)	Kou)
acid.	acid.
Ariel,	Ariel,
netters,	netters,
====================================	====================================
groove	tsagi
World	Duniya
Answer	Amsa
rent	tsage
Steven	Steven
heavens	sammai,
&amp; Lt; wnk.734824081@aquifer.geology.uiuc.edu&amp;gt ;,	&lt;wnk.734824081@aquifer.geology.uiuc.edu&gt;,
collection	tarin
minus	ɗebe
theists	theists
culmination	culmination
5.25	5,25
Nicji	Nicji,
That	Cewa
-dk	-dk
perverse	fãsiƙai
far-flung	nisa-jẽfa
confirmed	tabbatar
CHRIST&#39;S	KRISTI&#39;S
table.	tebur.
version	version
;-).	;-).
ubiquitous	ubiquitous
miles	mil
labeled	labeled
Under	Ƙarƙashin
now?	yanzu?
never	taba
battery	baturi
(818)	(818)
trap	tarko
increases	qara
batteries	batura
[	[shi
now,	yanzu,
... &amp; Quot;	...&quot;
now)	yanzu)
spot	tabo
Kor.	Kor.
now.	yanzu.
filter	tace
Maybe	kila
Earth.	Qasa.
Health &amp; gt;	lafiya&gt;
alone.	kadai.
text	rubutu
martin	martin
relevance	dacewar
write	rubuta
Magnetic	&#39;Magnetic
Gravitational	Gravitational
wrote:	rubuta:
1947	1947
1949	1949
Motorcycle	Babur
And	Sa&#39;an
paper	takardar
certainly	haƙĩƙa
Applications	Aikace-aikacen
Mr.	Mr.
kilo	kilo
written.	rubuta.
write,	rubuta,
Technology	Technology
intercession	cẽto
1959	1959
&amp; gt;	yadda&gt;
value).	darajar).
Negative	Mummunan
share	share
denser	denser
image	gunkin
Barry	Barry
jelly	jelly
INFJ	INFJ
reparented	reparented,
Bible &amp; gt;	Mai-Tsarki&gt;
===========================	===========================
paper:	takarda:
Mentality	haukan
you	kika
1969	1969
Court.	kotun.&#39;
1962	1962
1964	1964
[Jesus]	[Yesu]
Logistics	sarrafawa
(Some	(wasu
strive	jihãdi
across.	fadin.
(Ray	(Ray
Inf)	INF)
go	tafi
(310	(310
----------------- &amp; Gt; &amp; quot;	-----------------&gt;&quot;
