Files	Fayllar
one hundred	yuzdan
XR650L	XR650L
proposal	taklifni
(Erik	(Erik
&amp; Quot; cloud	&quot;bulut
535	535
development	rivojlantirish
Space	Kosmosdan
priesthood	ruhoniylikni
jet	jet
Sensitivity	jilo,
mail	pochta
Orbit	orbitalar
#	#
labor,	mehnat,
Groups:	Guruhlar:
James	James
November	noyabr
$	$
*	*
Only	Yagona
+	+
(Jon	(Jon
(	(
north-south	shimoliy-janubiy
)	)
accusors	accusors
&amp; Quot; empty	&quot;bo&#39;sh
Team	Team
.	.
RKBA	RKBA
/	/
,	,
prisoners	mahbuslar
-	-
As a result,	natijasida,
3	3
2	2
returned	qaytdi
1	1
7	7
6	6
5	5
man	odamni
4	4
:	:
9	9
8	8
&amp; Lt; 94318@hydra.gatech.EDU&amp;gt;	&lt;94318@hydra.gatech.EDU&gt;
meaning	ma&#39;no
Gauche	Gauche
=	=
spec	spec
D	D
Kickback	Kickback
Norway	Norvegiyada
the environment	muhitni
E	E
F	F
SetWUTime	SetWUTime
@	@
A	A
B	B
supports	qo&#39;llaydi
C	C
L	L
&amp; gt ;,	faoliyati&gt;,
because,	tufayli,
M	M
H	H
I	I
.	tufayli.
J	J
SHE IS	U
T	T
Educate.	tarbiyalang.
&amp; Quot; I	&quot;Men
(713)	(713)
Q	Q
S	S
R	R
(But,	(balki,
\	\
_	_
^	^
pressing	bosish
government	hukumat
X	X
catch	qo&#39;lga
1846	1846
conscious	ongli
html>	mmm@cup.portal.com
instruments	asboblarini
g	g
c	c
a	a
&amp; Lt; 1r10jcINNt1g@lynx.unm.edu&amp;gt;	&lt;1r10jcINNt1g@lynx.unm.edu&gt;
not	berilmaydi
In	yilda
squad	tarkibda
o	o
the population	aholiga
The price of	narxi
m	m
compact	ixcham
i	i
flight	uchish
w	w
v	v
she is	u
talk	so&#39;zlashish,
Experimental &amp; gt;	empirik&gt;
520	520
p	p
Steve	Stiv
~	~
agent	qanotga
|	|
x	x
achievements	yutuqlar
weight	og&#39;irligi
Wonder?	Wonder?
I liked	yoqdi
western	g&#39;arbiy
outposts	karakollardan
Melnick)	Melnick)
long,	uzoq,
kingdom	shohlik
&amp; Quot; open &amp; quot ;,	&quot;ochiq&quot;,
pressure	bosimi
regulators	muharriridan
JPEG,	JPEG,
,	qayta,
0.14	0.14
html>	ocom.okstate.edu
MAX641	MAX641
580	580
Adam	Adam
GIF	GIF
Leader?	rahbar?
583	583
earthed	tuproqli
promises	va&#39;dalarining
rate:	darajasi:
(__)	(__)
from	olishga,
excessive	haddan
&amp; Quot; temporary	&quot;vaqtinchalik
reports	hisobot
areas,	hududlarida,
free.	ochiq.
number:	raqami:
open,	ochiq,
XBEL	XBell
drawn	chiziladi
Sun,	Quyosh,
brigade	brigadasi
because of that.	tufaylidir.
559	559
regular	muntazam
regions	hududlarida
However,	birga,
loss	yo&#39;qotish
Aware of	xabardordir
Sugar	Sugar
companies	kompaniyalari
lpt1	lpt1
addiction	giyohvandlik
say,	aytaylik
will be.	o&#39;tadi.
materials	materiallar
preach.	va&#39;z.
the population	aholining
charged	zaryadlangan
memory,	xotirasida
Click	bosing
pgf@srl02.cacs.usl.edu|Like	pgf@srl02.cacs.usl.edu|Like
.	olingan.
below	ostida
pioneer,	kashshof,
Division	Division
led by	boshchiligida
as	sifatida
guys,	guys,
ocean	okean
direction	yo&#39;nalishda
close	yaqin
(Arthur	(Artur
width	kengligi
Tasco	Tasco
references	murojaatlarni
DR250ES	DR250ES
and talked.	suhbatlashdi.
difficult	murakkab
Western.	vesterman.
religion	dinim
boast	maqtana
&amp; Gt; &amp; gt;	&gt;&gt;
in	ichidagi
roots,	ildizlari,
environment	muhitda
The density	zichligi
religious	diniy
the flow	oqimining
see.	ko&#39;rishadi.
The prophet;	Payg&#39;ambar;
Detritus,	Detriot,
IDs	identifikatorlari,
Care &amp; gt;	bo&#39;limi&gt;
PATH	PATH
just	shunchaki
.	etilgan.
meaning,	ma&#39;no,
me	meni
taking into	hisobga
DEVICE	QURILMA
mysterious	sirli
Differential Equations	termoq
average	o&#39;rtacha
Palestinians	Falastinliklar
no doubt.	shubha.
vendor	sotuvchi
liquid water	suyuq-suv
heavy-looking	og&#39;ir-qarab
greenhouse	issiqxonada
between	orasida,
place	joy
clean,	tozalaydi,
the concept	tushunchasini
&amp; gt;	mumkin&gt;
back	qaytib
sense,	ma&#39;noda,
number	raqami
Offices	vakolatxonalar
clouds	bulutlar
Converter	Converter
integration	integratsiya
&amp; gt;	xil&gt;
internet:	internet:
include	kiradi
&amp; Quot; Yeast	&quot;xamirturush
explained.	bayon.
010-A	010-A
exception	mustasno
I	men,
designs	dizaynlashtirilgan
will be	qilinadi
Required.	majbur.
condemned	mahkum
4H7	4H7
philosophical	falsafiy
westwards	g&#39;arbga
old	eski
Preface	echilishi
indepth	indepth
Setup	sozlanmasi
1ff &amp; gt;	1ff&gt;
To be	Bo&#39;lishi
Current	Hozirgi
The sun	Quyoshga
door &amp; quot;	eshik&quot;
Medicine	Tibbiyot
NASA	NASAning
CIP	jip
Start)	boshlash)
property	mulk
We went	bordik
Neptune	Neptune
&amp; Quot; white	&quot;oq
raised.	ko&#39;tardi.
far.	olmas.
regarding	to&#39;g&#39;risida
Mirren	tranfer
components,	qismlariga
minutes.	daqiqa.
direction,	yo&#39;nalishi,
&amp; Quot; sense &amp; quot;	&quot;hislar&quot;
On the island,	orolida,
the period	davrning
DOUBLE_BUFFER	DOUBLE_BUFFER
500	500
&amp; Quot; alternative &amp; quot;	&quot;muqobil&quot;
cell	hujayra
--------------------------------------------	--------------------------------------------
12:26	12:26
Actually,	Aslida,
productive	unumdor
P.s.	P.s.
Edmond	Edmond
Iraq	Iroq
the effects of	ta&#39;siridan
the axis	tizmasiga
copy	nusxasini
the hosts	mezbonlar
business.	ish.
kludgy	kludgy,
Comet	cometa
expansion	kengaytirish
Neptun	Neptun,
Drum	drum
lid	qopqoq
5.7	5,7
observers	kuzatuvchilar
Stein)	Stein)
called)	chaqirdi)
5.0	5.0
sample	namuna
options	variantlari
1870	1870
the camera	mashinasini
^^^^^^^^^^^^^^^^^^^^^^^^^^^^^^^^^^^^^^^^^^^^^^^^^^	^^^^^^^^^^^^^^^^^^^^^^^^^^^^^^^^^^^^^^^^^^^^^^^^^^
763-5889	763-5889
Register	Ro&#39;yxatdan
not	berilmaydi,
August	avgust
3: &amp; gt;	3:&gt;
interesting	qiziqarli
hand	qo&#39;l
Are	olasizmi,
html>	timmbake@mcl.ucsb.edu
to	qilishga
Are.	olasizmi.
Window	Window
Kabolsuz	Kabolsuz
Pentium	Cyrix
on the contrary	aksincha
at the end of	uchida
advice	maslahat
the promise	va&#39;dasiga
Are you?	olasizmi?
the god	xudosi
Worlds	olamlar
archeology	arxeologiya
Islands	orollari
publication	nashr
16-169	16-169
In terms of	jihatidan
The database	bazasi
sun	quyosh
Almost	Deyarli
connection	ulanish
seasonal	mavsumiy
control &amp; quot;	nazorati&quot;
1ff	1ff,
to worry	tashvishlanib
thousand	mingdan
science fiction	ilmiy-fantastik
reserve	zahirasi
Etc	Etc
Explain.	tushunib.
down	pastga
Jews &amp; gt;	yahudiylar&gt;
do	qilishim
Contacts	kontaktlar
Cyric	Cyric
NUETZMAN	NUETZMAN
scourged	qamchilagan
Scriptures	Yozuvlarga
here,	erda,
conditions	sharoitida
Ira	Ero
FTP	FTP
here.	erda.
treatment	davolanish
&amp; Lt; sl3b+@andrew.cmu.edu&amp;gt;	&lt;sl3b+@andrew.cmu.edu&gt;
(Plus,	(plus,
accepted	qabul
designed	mo&#39;ljallangan
religion	e&#39;tiqod
Honda	Honda
superencipherment	superencipherment
From time to time	vaqti-vaqti
&amp; Lt; 1rbn60$gs7@usenet.INS.CWRU.Edu&amp;gt;	&lt;1rbn60$gs7@usenet.INS.CWRU.Edu&gt;
Canada	Kanada,
&amp; gt;	bo&#39;ladi&gt;
superstition	irim
separate	alohida
the life	hayotida
degeneration	nasli
time	vaqt
At the end of	tugagach
(82,178	(82,178
Human	Inson
lumpy	topaklı
nothing	vaqo
a one-	bir-biridan
(&#39;Real&#39;	(«real»
Punjabi)	Panjobcha)
Special).	maxsus).
Productivity	mahsuldorlikka
advanced	ilg&#39;or
should	kerak
rejoice.	quvonamiz.
love	muhabbat
html>	noring@netcom.com
ejected	otilishiga
688-8231	688-8231
energy,	energiyasi,
XXX	XXX
Income.	anglatdi.
flying	uchib,
comet	kometa,
flying.	uchib.
frozen.	muzlatib.
thumb	thumb
html>	hays@ssd.intel.com
heavier	og&#39;irroq
opinions.	fikrlar.
...........	...........
Someone	Kimnidir
The number of	soni
current	joriy
lower	pastki
&amp; gt;	bor&gt;
,	esa,
business	ish
surrender	taslim
The sun	Quyoshni
&amp; Quot; I	&quot;men
Tsai)	Tsai)
.	qilinadi.
Earth	Earth
there is	mavjud
comparing,	taqqoslab,
11:25	11:25
further	yanada
(604)	(604)
heel	tovonini
GMT &amp; gt ;:	GMT&gt;:
flooded	bosmoqchi
Sevim	sevinglar
burned	yondirib,
Pilate	Pilat
differences	tafovutlar
traffic	trafikni
PPM	PPM,
things	narsalarni
soil	tuproqqa
toys	o&#39;yinchoqlar
looked at,	qaradi,
closer	yaqinroq
speak	gapiradigan
weapon	qurol
touch	tegish
hard	qiyin
PowerPC	PowerPC
Right &amp; gt; &amp; gt;	o&#39;ng&gt;&gt;
(Memory	(xotira
coming from?	kelayotgan?
Treatments	Muolajalar
register	ro&#39;yxatdan
violent	zo&#39;ravon
themselves	o&#39;zlari
&amp; Lt; rauser.734062608@sfu.ca&amp;gt;	&lt;rauser.734062608@sfu.ca&gt;
Crawford)	Crawford)
Rind)	Rind)
Internet	Internet
oily	moyli
============ ECHO	============ECHO
in the evening,	kechqurun,
business	biznes
Deleted	o&#39;chirilgan
EXACTLY	AYNAN
students	talabalar
Topspeed	premade
Look.	sol.
rings	halqalar
continents	qit&#39;ada
Says	Deydi
probe	prob
Pontius	Pontiy
above	yuqorida
make	qilmoq
Thomas	Tomas
travelers	sayohatchilar
loving)	mehribon)
Stayed	Qoldi
consent	roziligi
of gold	tillo
The team	jamoasi
structural	tarkibiy
diameter,	diametri,
abyss	tubsizlik
html>	jaskew@spam.maths.adelaide.edu
unforgettable	unutilmas
Most	Eng
Venus	​​Venera
Pseudo-teachers &amp; gt;	Psevdo-o&#39;qituvchi&gt;
Clint	Clint
Photography	fotosuratlar
clear	ochiq-oydin
Technologies,	Technologies,
Tap	teging
Accord	Accord,
weight	vazn
Bisexual	biseksüel
Jordan	Jordan
waiting for.	kutayapmiz.
sector	soha
prone to	moyil
called.	ataladi.
the word	so&#39;zning
Jerusalem	Quddusda
I heard	eshitdim
Goals,	maqsadlari,
life	hayotini
Marty	Marty,
finished)	tugagan)
invalid	yaroqsiz
lamp	chiroq
The culmination	kulminatsion
energy	energiyasidan
The key to	kaliti
1.770	1.770
percieved	percieved
WHY	NEGA
(Women	(Ayollar
myth	afsona
-391	-391
?] &amp; quot;]	ning?]&quot;]
The Ottomans	Usmonlilar
encrypted	shifrlangan
cases	hollarda
merry	quvnoq
Columbia	Columbia
more	ko&#39;proq,
torn	yirtilib
Original	Original
and more.	ko&#39;proq.
dramatic	dramatik
dry	quruq
post	post,
(Baby	(chaqaloq
tug-of-war	tug-of-urush
unclear	noaniq
boat	qayiq
&amp; Amp;	&amp;
Dances	Dances
Tracking	ergashish
&amp; Lt; C5r60r.4ID@megatest.com&amp;gt;	&lt;C5r60r.4ID@megatest.com&gt;
html>	rscharfy@magnus.acs.ohio-state.edu
working	ishlaydigan,
but	lekin
&amp; Quot; the sky	&quot;osmon
service	xizmatini
heard?	eshitdi?
G20	G20
significantly	sezilarli
&#39;	«Agar
today	bugungi
flow	oqib
Serb	Serbiya
Israel	Isroilga
he said.	ta&#39;kidladi.
production	chiqarila
evidence	dalil
who	kim
wasted	behuda
software	dasturiy
.4ID	.4ID
system	tizimiga
Positions	postlar
Louis	Louis
the role of	o&#39;rnini
other	boshqa
protection &amp; quot;	himoya&quot;
manager	boshqaruvchisini
method	usuli
#	#,
If you want to	istasangiz,
meaning	ma&#39;nosini
&amp; Quot; security	&quot;xavfsizlik
crust	qobig&#39;ini
meteoroid	meteoroid
Arabs	arablar
sent.	yubordi.
algorithm	algoritmi
I	qilaman
ultraviolet	ultrabinafsha
engaged	shug&#39;ullanadi
354-1333,	354-1333,
Goodwill,	niyat,
#:	#:
401	401
400	400
So	Xo&#39;sh
whiskey	viski
Henly	henling
hour	soat
&amp; Gt;	Yuqori&gt;
pressure	bosimli
local,	mahalliy,
Cryptologia	Cryptologia
things	narsalarga
We were lucky.	omadli.
club	klub
&amp; Quot; ^^^^^^^^^^^^^^^^^^^^^^^^^^^^^^^^	&quot;^^^^^^^^^^^^^^^^^^^^^^^^^^^^^^^^
action	harakat
1610	1.610
in advance	oldindan
stubborn	qaysar
(62-mile)	(62-mil)
effect	ta&#39;sir
decorations	bezaklar
proposal	taklifi
answer	javob
useless	foydasiz
I am!	qilyapman!
group	guruhini
LOVE	SEVGINI
non-doctors	non-shifokorlar
I&#39;m	qilyapman,
closely	yaqindan
integer	integer
Reasons for	sabablari
Security	securital
again	qayta
Overall,	qaralganda,
!!	!!
I am.	qilyapman.
freedoms	erkinliklarini
sacrifice	qurbonligi
comprehension	tushunish
html>	artmel@well.sf.ca.us
(______	(______
early	erta
Crime	Jinoyatchilik
I am;	qilyapman;
benefit	foyda
body	body
************	************
Elvis	Elvis
reponse	reponse
chemical	kimyoviy
14-19	14-19
National	Milliy
cover	qoplama
(Karl	(Karl
Martin,	Martin,
are you going to do?	qilmoqchisiz?
which	qaysi
&amp; Lt; RVESTERM@vma.cc.nd.edu&amp;gt;	&lt;RVESTERM@vma.cc.nd.edu&gt;
html>	engp2008@nusvm.nus.sg
Pound)	funt)
If)	bo&#39;lsa,)
Canada	Kanada
Previous	Avvalgi
ken	ken
Tech.	Tech.
Desk,	paneli,
cloud	bulut
&amp; Quot; high	&quot;yuksak
commandments	amrlarning
app	dasturni
body.	tanasi.
correct	to&#39;g&#39;ri
the ability to	imkonini
35,789	35.789
&amp; gt;	u&gt;
The role,	o&#39;rni,
offers	taklif,
freshen	salqinlash
centuries	asrlar
waves	to&#39;lqinlar
encouraging	dalda
100 &amp; gt; &amp; gt;	100&gt;&gt;
source	manbai
remove	chiqarib
8:31	8:31
to ride	chiqishdan
the system	tizimida
Europe	Evropa
known	nomlanuvchi
sent	yubordi,
neighbors	qo&#39;shnilari
Galilean	Jalilalik
Boston	Boston
plant	o&#39;simlik
naked,	yalang&#39;och,
Sun,	Sun,
expenses	xarajatlar
emotional	hissiy
animation	animatsiya
The grace of	inoyati
In such a situation,	Bunday-va-,
the gods	xudolarga
lines.	liniyalarida.
Stassen	Stassen
I was	edim
bridge	ko&#39;prik
audio	audio
compelling	jabbor
the reasons for the	sabablarini
emulyatorlarni	emulyatorlarni
came out	chiqdi
(Usually	(odatda
467	467
the intention of	niyati
- &amp; Gt;	-&gt;
First,	birinchi,
superiority	afzallik
molten	erigan
ignored	e&#39;tiborsiz
s	ning
u.	o&#39;qib.
gold	oltin
followed by	ta&#39;qib,
read	o&#39;qib,
easily	osongina
half	yarim
which	olgan
ringlets	ringlets
The identity of	kimligi
Driver	Driver
all	hammasi
&amp; Quot; &amp; quot ;,	&quot;ko&#39;rish&quot;,
gone astray	adashgan
Selected	Tanlab
Remote	masofadagi
*	*,
logic	mantiq
to	gacha,
**	**
space	koinot
to melt	eriy
resurrection	tirilmas
Sue,	Sue,
Wai	Wai
Jupiter	Yupiter
In	yilda,
Left	Chap
out	amalga
In.	yilda.
group	guruhiga
wake up	uyg&#39;otishning
Law	Qonunni
first	birinchi
Crippling	zaiflashtirish
what	nima
(Now	(hozirga
+1	+1
++	++
supper.	supper.
the status of	mavqeini
Michael	Maykl
(A	(A
html>	phj@remus.rutgers.edu
&amp; quot;	bo&#39;ladi&quot;
*************************************	*************************************
season	mavsumda
Child-league	bola-ligada
look-	look-
provides,	ta&#39;minlaydi,
(;	(;
in practice	amalda
plexiglassso	plexiglassso
(:	(:
4,094	4.094
perturbed	tashvishlantirgandir
(?	(?
&amp; Quot; cold &amp; quot;	&quot;soğukluk&quot;
Franko	franko
(2	(2
now	hozir
CSHOW	CSHOW
jobs	o&#39;rinlarini
(1	(1
(7	(7
The purpose of	maqsadi
which	etgan
&amp; gt; &amp; gt;	narsa&gt;&gt;
()	()
(A	(a
some	ba&#39;zi
owner.	egasi.
listed	keltirilgan
Magic	Magic
(\	(\
They say,	Deydilar,
&amp; Quot; real &amp; quot; &amp; gt;	&quot;haqiqiy&quot;&gt;
Jesus,	Iso,
heavenly	samoviy
html>	ritley@uimrl7.mrl.uiuc.edu
(T	(T
professionals.	professionallar.
between parents	ota-o&#39;rtasida
grow	o&#39;sadi
(I	(I
Young-Leith)	yosh-Leith)
)	),
Cometary	Cometary
Puryear	Puryear
equatorial	ekvatorial
even	hatto
disastrous	halokatli
The joint	Qo&#39;shma
AMERICA	AMERIKA
Article	Maqolasidan
placebo	platsebo
hardcore	hardcore
practical	amaliy
..	..
html>	gonzaled@ucsu.Colorado.EDU
Altima	Altima
(Korenek@nmti.com)	(korenek@nmti.com)
rational,	oqilona,
throw.]	tashlaydi.]
increased.	oshdi.
4.6	4,6
groups	guruhda
1759	1759
Lamp	Chiroq
Desired	istagan
1,610	1,610
built	barpo
//	//
more	ko&#39;proq
commitment	majburiyatini
button	tugmasini
Europeans	evropaliklar
discretion	ixtiyori
-!	-!
Scissors	qaychi
html>	ge!severy%severy@uunet.UU.NET
office	ofisiga
In:	yilda:
Fahrenheit).	Farangeyt).
Fahrenheit),	Farangeyt),
[Gen	[Gen
die	o&#39;lasizlar
the border	chegarasida
risks	xatarlar
algorithm,	algoritm,
e-mail:	e-mail:
Since	yildan
Jews,	Yahudiylar
html>	ILV20078@UDELVM.UDEL.EDU
Gay	Gay
&amp; gt;	bo&#39;lsa&gt;
Soviet	Sovet
Cramer	Cramer
-.	-.
raster	raster
key &amp; quot;	kalit&quot;
&amp; Quot; Borshevshky &amp; quot;	&quot;Borshevshky&quot;
e-mail,	e-mail,
algorithm?	algoritm?
HCI	HCI
sad	ma&#39;yus
Kloo	Kloo
a combination of	birikmasi
several	necha
namelplate	namelplate
.	bor.
Behavior:	xatti:
)	bor)
35	35
There are,	bor,
in the office	ofisida
3:	3:
&amp; Lt; 1993Apr21.170403.22855@yang.earlham.edu&amp;gt;	&lt;1993Apr21.170403.22855@yang.earlham.edu&gt;
appearing	ko&#39;ringan
irrigation	sug&#39;orish
4.	4.
Date	sanasi
4	4,
King)	King)
42	42
There?	bor?
40	40
the concept	tushunchasiga
restriction	cheklash
stained	ligini
There are:	bor:
working	ishlayotgan
right?	o&#39;ng?
(613)	(613)
received	tushgan
religion	dinni
2:	2:
warning.	ogohlantirish.
Anti	anti
Type	turi
half of	yarmidan
sale	sotish
22	22
Severn	severy
thee	senga
23	23
befor	befor
24	24
25	25
MOUNTING	TAKOZLARI
changes	o&#39;zgarishlar
stand	tura
26	26
Spin;	Spin;
27	27
28	28
1W	1W
29	29
3	3,
3.	3.
html>	stephen.guerke@mvs.udel.edu
30	30
1m	1m
32	32
Ishii	Ishii,
31	31
period	davrida
the tide	fasllari
erosion,	eroziyasi,
linear	chiziqli
3)	3)
Where	qaerda
The brightness	nashrida
supported	qo&#39;llab-quvvatlanadigan
lack of	kamchilikka
19	19
Behaviour.	tutish.
1:	1:
I&#39;m	qilyapman
17	17
18	18
recognized	e&#39;tirof
15	15
16	16
13	13
14	14
11	11
12	12
Behavior?	tutish?
21	21
20	20
2.	2.
8.20)	8.20)
2)	2)
satellites,	yo&#39;ldoshlarini,
2%	2%
here	erda
Computer	Kompyuter
head	bosh
html>	erikb@idt.unit.no
he said.	aytdi.
he said,	aytdi,
license	litsenziya,
1.	1.
10	10
Islam	Islom
1)	1)
1	1,
look,	qarash,
1%	1%
Swartz	Swartz
5VDC	5VDC
formatting	formatlash
7:	7:
Price)	narxi)
78	78
Obviously,	Shubhasiz,
the activities of	faoliyatini
B	yotgan
prohipiting	prohipiting
Adam,	Ato,
out of	tashqarisiga
intention	niyat
shot?	uzgan?
comet	kometasi
Early	Erta
butterscotch	butterscotch
the legitimacy	qonuniyligini
The earth	Yerning
6:	6:
the words	so&#39;zlari
people	insonlar,
Lunar	Lunar
&amp; quot ;, not	olmaydilar&quot;,
per hour	soatiga
target	maqsad,
However,	Lekin,
(	(o&#39;sha
7)	7)
Doctors	Shifokorlar
!!!! &amp; Quot;	!!!!&quot;
moment	zum
70	70
almost	qariyb
72	72
76	76
The diagnosis	kasaliga
modem	modem
Illegal-Key	Noqonuniy-Key
5:	5:
grace.	inoyati.
html>	martyj@uiuc.edu
Solomita)	Solomita)
56	56
Update	Update
Sometimes,	ba&#39;zan,
55	55
The rules	qoidalar
much	ancha
the planet	sayyoraning
abducted	o&#39;g&#39;irlab
really	chindan
The water	Suvga
fault-line	xato-line
prosecution	ayblov
60	60
group	guruhni
&amp; Quot;	&quot;barcha
defined	belgilangan
burning	yonayotgan
holding	tutib,
I do not want	istamayman
^^^^^^^^^^^^^^^^^^^^^^^^^^^^^^^^^^^	^^^^^^^^^^^^^^^^^^^^^^^^^^^^^^^^^^^
4:	4:
organic	organik
back	orqa
______	______
4?	4?
temporary	vaqtincha
WW2	WW2
70,000th	70,000th
increased.	ko&#39;paydi.
5	5,
neighborhood	mahallada
range	oralig&#39;i
Clipper	Clipper
Speaking];	gapirganda];
Thing	Narsa
eyes,	ko&#39;zlarini
water	suvni
5.	5.
Torre:	Torre:
50	50
vacuum	vakuum
(508)	(508)
options	imkoniyatlari
distance	masofa
I think, though,	o&#39;ylayman-da,
Azzam)	Azzam)
his father	otasi
-gun legislation	qurol-qonunchiligi
obtained	olingan
astronomers	astronomlar
were:	edi:
;	edi;
486	486
Thanks	Thanks,
*************************************************	*************************************************
?	edi?
99.8	99,86
release	chiqarish
medical	tibbiy
482	482
time	paytda,
Stop	to&#39;xtating
,	edi,
Here	Erga
.	edi.
Do not think,	o&#39;ylamanglar,
people	xalqiga
&amp; Lt; /	&lt;/
chaos	tartibsizlik
Death,	o&#39;limi,
needs	ehtiyojlarini
Madrid	Madrid
less than	kam
telematic	telematik
organized	tashkil
Cardiovascular &amp; gt;	tomir&gt;
landing?	maydonchada?
Thanks!	Thanks!
bandit	qaroqchi
Ulker	Ulker
the prophets	payg&#39;ambarlarning
Lankford	Lankform,
::	::
Readers	O&#39;quvchilarning
10:39:15	10:39:15
Fla	Fla
the system	tizimini
December	dekabr,
cleared	tozalanadi
Click.	bosing.
clear	aniq
the examination	ekspertiza
(Greek	(yunoncha
daily	kundalik
work.	ishlamaydi.
broken	singan
The planet	Sayyoraning
:)	:)
MDs	MDs,
stars	yulduzlarni
permission	ruxsat
read	o&#39;qigan
predisposition,	moyilligiga,
)	edi)
Lankford &amp; gt;	Lankford&gt;
95	95
Mosaic	Tavrot
html>	sbp002@acad.drake.edu
kernel	yadrosi
93	93
90	90
!	edi!
Straightening	tekislash
Here	Erda
unsatisfied	qoniqmagan
pilot	uchuvchi
Information	ma&#39;lumot
&amp; Quot; tails. &amp; Quot;	&quot;dumlar.&quot;
Opportunity	Imkoniyat
function	funktsiyasi
they	​​ular
October	Oktyabr
Alt.atheism	Alt.atheism
Waiver	Voz
grained	donali
sold	sotilgan
out	chiqib
==================================================	==================================================
88	88
Mouse)	Sichqoncha)
shows	ko&#39;rsatmoqda
a safe,	xavfsiz,
Certain	Muayyan
&amp; Quot; Oh,	&quot;Oh,
December	dekabr
??	??
boy	bola
trip	safari
MacRae): &amp; gt; &amp; gt; &amp; gt;	MacRae):&gt;&gt;&gt;
building	binoning
,	kiritish,
percent	foizi
closed	yopib
Articles	maqolalar
dispute	nizo
brothers and sisters,	birodarlar,
It does not	qilmaydi
Statistics &amp; gt;	Statistika&gt;
opinion	nuqtai
?!	?!
when	qo&#39;nganda
The principles	printsiplari
to pay	buyuradi
Leong	Leong,
formats,	formatlar,
required.	qolaman.
problems,	muammolar,
Snowball	kartopu
brood	zoti
X11	X11
the water	suvga
people	xalqini
(LGV	(LGV
the ability to	imkoniga
?!?	biladimi?!?
Bure	Bure
closed	yopiq
(Ken	(Ken
the way	tarzda
problems?	muammolar?
defect	qusur
in fact,	aslida,
Erik	Erik
html>	gt4417a@prism.gatech.EDU
percent	foizga
WNI	WNI
Portable	Portable
thing	narsa
Latin	Lotin
There!	bor!
reading	o&#39;qish
findings	topilmalar
media event	media-tadbir
natural	tabiiy
will be shown.)	ko&#39;rinadi.)
Fault	yorig&#39;i
(5000	(5000
motherships	motherships
logical.	mantiqiy.
equal	teng
At	Da
Db	Db
service	xizmat
4,850	4,850
imperfect	nomukammal
Pictures	rasmlar
E.	E.
Land	Land,
reconnaissance	razvedka
anti-fungal	anti-qo&#39;ziqorin
(Korenek@nmti.com) &amp; gt; &amp; gt; &amp; gt;	(korenek@nmti.com)&gt;&gt;&gt;
to	qilish
DH	DH
(Detroit,	(Detroyt,
volcano	vulqon
published	nashr,
(That is,	(ya&#39;ni,
College	kolleji
&amp; Quot; disease	&quot;kasalliklar
known	ma&#39;lum
conditions	sharoiti
(Past &amp; gt;	(«oxirgi&gt;
Bures &amp; gt;	Bures&gt;
not	bo&#39;lmas
his head	boshini
extradition	ekstraditsiya
Muslim	musulmon
virus..It	virus..It
340	340
Now. &amp; quot ;,	endi.&quot;,
the surface	yuzasining
temp	temp
replica	nusxasidan
reports	hisobotlarida
lawsuit	da&#39;vo
manager	boshqaruvchiName
configuration	konfiguratsiya
GE	GE
Wen-Cheng	Wen-Cheng
Religious &amp; gt;	diniy&gt;
That	Shundan
yes,	ha,
So	Shunday
mapped to	eşlenen
?)	qilish?)
Land	Er
amp &amp; gt;	amp&gt;
Mouse	Sichqoncha
Asteroids	asteroitler,
G.	G.
FM	FM
the stars	yulduzlarga
Gnomes	gnomes
comfortable.	qulay.
ammonia,	ammiak,
kilometer	kilometrlik
DIFFERENTIAL	differensial
HG	HG
&amp; Lt; C5t7Gs.7v3@news.iastate.edu&amp;gt;	&lt;C5t7Gs.7v3@news.iastate.edu&gt;
Incorporated	Incorporated
states,	davlatlar,
IP:	IP:
763-2626	763-2626
used	ishlatilgan,
GP	GP
provides	beradi
GM	GM
H.	H.
the composition of	tarkibidan
(Paul	(Paul
recomendations	recomendations
oddball	oddball
and	ham
QUACK	QUACK,
rumors	mish-mish
itself_	itself_
(Martin	(Martin
From:	From:
for	davomida
the solution	hal
5:17	5:17
stayed	qoldi
jusgement	jusgement
fee	haq
Oort	Oort
every	har
Time	Vaqt
Titan	Titan
(it&#39;s not,	(emas,
press	matbuot
coming	kelayotgan
From	From,
coming	kelishida
Orbit	Falakda
A.	A.
Singapore	Singapur
====================================== &amp; Gt;	======================================&gt;
AT	AT
300	300
Home	Home
monitor	monitor
IMMMMMMMMMMMMMMMMMMMMMMMMMMMMMMMMMMMMMMMMMMMMMMMMMMMMMMMMMMM;	IMMMMMMMMMMMMMMMMMMMMMMMMMMMMMMMMMMMMMMMMMMMMMMMMMMMMMMMMMMM;
expected	kutilayotgan
the cancellation,	bekor,
channels,	kanallari,
the opposite.	qarama-qarshi.
Other	Boshqa
Thyroid	Tiroid
quality	xislat
30%	30%
Everest	Everest
III	III
piece	bo&#39;lagini
AM	AM
B.	B.
BV	BV
C:	C:
&amp; Lt; C5qsBF.IEK@ms.uky.edu&amp;gt;	&lt;C5qsBF.IEK@ms.uky.edu&gt;
anyway	baribir
&amp; Quot; &amp; quot discussed;	&quot;muhokama&quot;
inhabitant	yashovchi
valleys	vodiylar
CA	CA
fist	musht
country	mamlakati
BI	BI
banned	ta&#39;qiqlangan
automatic	avtomatik
&amp; gt;	tarzda&gt;
The apostle	havoriy
planet	sayyora
An	An
virtual root	virtual-ildiz
demonstration	namoyish
C	C,
table	stol
Al	Al
included	kiritilgan
mission	missiyasi
using?	foydalanayotgan?
3.0	3.0
responsible	javobgar
&amp; Quot; shooter &amp; quot; &amp; gt;	&quot;mergan&quot;,&gt;
3.1	3.1
(&amp; Quot; my &amp; quot;	(&quot;vasiyatini&quot;
Eastwood	Eastwood
This	Bu
keep	tutish
engaged.	shug&#39;ullanadi.
,	iborat,
.	iborat.
botir	botir
&amp; Lt; instead	&lt;o&#39;rniga
so	shunga
spreading.	yoyib.
Please.	iltimos.
Jovi	Jovian
Ganimedes	Ganimedes
Please,	iltimos,
cost,	xarajat,
Falsehood	botil
CD	CD
aimed at	qaratilgan
. &amp; quot;	ekan.&quot;
D.	D.
most	ko&#39;pchilik
!!)	!!)
per	boshiga
the treatment	uzog&#39;i
Assad	Assad
Perhaps,	Ehtimol,
!!!	!!!
Ohio	Ogayo
us	bizga
PA	zbekiston
Twin	Twin
contains	ichiga
He	zot
(Root	(root
hey	hey
(NASA	(NASA
God	Xudo
asymmetrical	assimetrik
cratered	cratered
Cardinals	Cardinals
owners	egalarining
Leonard	Leonard
MD	MD
the restriction	cheklanishiga
brave	jasur
MB	MB
He,	He,
resources	resurslarini
&amp; gt;	da&gt;
mobile	mobil
square	kvadrat
throw	tashlamoqchi
N.	N.
Volcano	Vulqon
Where &amp; gt;	qaerda&gt;
witnesses	guvohlar
Gilkes	Gilkey
&amp; Quot; X9 &amp; quot;	&quot;X9&quot;
MS	MS
Electronic	elektron
weighing	tarozida
NI	NI
3.8	3,8
3.5	3,5
rise.	tirilaman.
NA	NA
(Last	(oxirgi
html>	dlb@fanny.wash.inmet.com
faith	imoningiz
He spoke?	gapirdi?
Algeria	Jazoir
My	My
that is,	ya&#39;ni,
Electronics	Electronics,
Who?	kimsiz?
---------------------------	---------------------------
Switching &amp; gt;	Kommutatsiya&gt;
NO	NO
district,	tuman,
P.	P.
the key	kalitiga
ON	ON
storm	bo&#39;ron
OK	OK
I rang the	chaldi
citizens	fuqarolari
PowerBook?	PowerBook?
Site	Sayt
(Scooter	(Scooter
Disc	diskdan
,	nisbatan,
witness:	shohidlik:
community	hamjamiyat
&amp; Quot; magnetic	&quot;magnit
(6200	(6200
P5	P5
&amp; Quot;	&quot;..
circuits	mikrosxemalar
tips?	maslahatlar?
closed:	yopildi:
No	No
range.	oralig&#39;i.
OP	OP
html>	lei@rtsg.mot.com
OR	OR
deleted,	o&#39;chirildi,
PL	PL
On	On
Kingdom	Shohligida
(Wen-Cheng	(Wen-Cheng
Oh	Oh
return	qaytarib
Ad	Od
League	Ligasi
PB	PB
PC	PC
knowledge	bilim
dark	qorong&#39;u
History of	tarixi
emission	emissiya
Go	Go
Barringer	Barringer
will be held.	o&#39;tkaziladi.
curly	jingalak
&amp; Quot; open &amp; quot;	&quot;ochiq&quot;
obscure	qorong&#39;i
Alphanumeric	nomaqbul
&amp; Quot; Enough	&quot;Etarli
biology	biologiya
feel	his
board	taxta
ID	ID
Yes	Ha
to learn	o&#39;rganish
He	He
html>	nuet_ke@pts.mot.com
spots	dog&#39;larni
Hi	Hi
Club	Club,
Tom &amp; gt;	Tom&gt;
Lander	Lander
July	iyul,
J.	J.
IN	IN
IO	IO
are you going to do?	qilasiz?
performance	bajarish
in the field	sohasida
The surface	yuzasi
stolen	o&#39;g&#39;irlangan
IS	IS
IT	IT
html>	dh782@cleveland.Freenet.Edu
the fruits of	mevalaridan
Club.	Club.
Yes.	Ha.
Hz	Hz
Yes,	Ha,
teaches,	o&#39;rgatsa,
Network	Network
learn	bilib
The observations	kuzatuvlar
Possession)	EGALON)
JB	JB
Io	Io
&amp; Quot;),	&quot;),
died	vafot
In	In
channel	kanal
so	shuncha
Kina	kinoya
gracious &amp; gt;	marhamatli&gt;
JT	JT
means	demak
to come	kelishini
AUTOCAD	AUTOCAD
(Hamas	(Hamaza
ridiculous	kulgili
,	qo&#39;lga,
IBM	IBM
contrary	zid
&amp; Quot; Only	&quot;Faqat
html>	st1ge@Elroy.UH.EDU
Toyota	Toyota
independent	mustaqil
sleeping	uxlab,
(Joseph	(Joseph
Correct	To&#39;g&#39;ri,
emulator	emulator
L.	L.
rival	raqib
backup	zaxira
People	kishi,
sport	sport
themselves	o&#39;zlarini
class,	sinf,
low	past
bruise.	chaqasan.
IBM	IBMning
The solution	Hal
within	ichida
for some reason	negadir
The value of	qiymati
And	Ham
Brothers and sisters,	Birodarlar,
LH	LH
Every	Har
FROMTHEDEAD:	FROMTHEDEAD:
Christ. &amp; Quot;	Masihdir.&quot;
different	boshqacha
say	aytishim
VL	VL
W.	W.
Ulysses	Ulysses&#39;in,
Report	hisoboti
İşret	Isreal
rights	huquqlarini
curtain	parda
worlds	dunyolar
Tx	Tx
us	bizni
seen.	ko&#39;rganlar.
&amp; gt;	qoldi&gt;
empty	bo&#39;sh
Associate Professor	dotsent
a heterosexual	heteroseksüel
stores	saqlaydi,
Antarctica	Antarktida
Do not forget	unutmang
Thank you.	rahmat.
the victim	qurboni
face	yuz
Indiscriminately	Gelişigüzel
Disclaimer!	kechish!
Th	Th
early	erta,
fed	oziqlangan
launched	ishga
PROOFOF :::	PROOFOF:::
uneventful	olaysız
load	yuk
uses	foydalanadi
TV	TV
partners	hamkorlar
&amp; Quot;.	&quot;bilan.
html>	wnk@aquifer.geology.uiuc.edu
Holy	Muqaddas
Disclaimer?	kechish?
accommodation	turar
Charter	Charter
the key	kalitini
[Male]	[erkak]
XT	XT
Norton	Norton
Landmann	Landmann
Previous	Oldingi
second,	ikkinchisi,
confidential	maxfiy
instructions	ko&#39;rsatmalar
&amp; Quot; &amp; quot;	&quot;soat&quot;
level	darajada,
boring	zerikarli,
To Europe	Yevropaga
mercury	simob
corner)	burchak)
tale	ertak
problems	muammolarni
In the summer	yozida
corner,	burchak,
And	Va
------------------------	------------------------
Junichiro	Jun&#39;ichiro
shine	porlab
Although I am not	emasman-da,
Open	Open
to prove	isbotlash
Pathfinder &amp; gt; &amp; gt; &amp; gt;	Pathfinder&gt;&gt;&gt;
S.	S.
The project,	loyiha,
stains	qoralangan
room	xona
exit	chiqish
contact	murojaat,
Where	Qani,
Foltz)	Folta)
block.	blok.
raised	tirilmagan
Good!	yaxshi!
RA	RA
focus	qaratib
Weapon	Qurol
horns	shoxini
Down &amp; gt;	pastga&gt;
Me	Meni
alternative	muqobil
read	o&#39;qib
&amp; gt; &amp; gt;	bo&#39;lsa,&gt;&gt;
root	ildiz
&amp; Quot;	&quot;Bu
Bonds	aylantirilib
without	turib
like)	singari)
obstacles	to&#39;siqlar
If	qilinsa
R.	R.
html>	alin@nyx.cs.du.edu
fault.	xatoyim.
(1.5 miles)	(1.5-mil)
Hays)	haysi)
citizens,	fuqarolar,
well,	yaxshi,
worth. &amp; quot;	arziydi.&quot;
Topic:	Mavzu:
goal	gol
to return	qaytishini
The capacitive	kapasitif
Month	Oy
Weiss)	Vayss)
to walk	yurishni
,	qilib,
window	oynasini
crime	jinoyat
oooo	oooo
or &amp; gt;	bo&#39;lmasa&gt;
bell	qo&#39;ng&#39;iroq
studied.	o&#39;rganildi.
So	So
The ruins of	qoldiqlari
medication	dori
SS	SS
summer	yoz
for;	uchun;
in terms of	nazaridan
?	uchun?
opportunities	imkoniyatlarini
True	Chin
emphasis	urg&#39;u
to:	uchun:
I	Men,
to	uchun,
Re	Re
Intelligence,	Aql,
.	uchun.
gone	ketdi
.	joylashtirish.
SI	SI
the mercy of	rahmati
%	uchun%
in the morning,	ertalab,
-120	-120
Team	yoq
)	uchun)
RR	RR
;	kelgan;
The man	Insondir
!	uchun!
///////	///////
&amp; Quot; slow	&quot;sekin
html>	franjion@spot.colorado.edu
.	qilib.
mines	minalar
Driver &amp; gt;	Driver&gt;
found.	topildi.
lightning,	chaqmoqni
Speaking	So&#39;zga
Old	Eski
Campus	Campus
Snail	Snail
across	orqali
flower	gul
N3JXP	N3JXP
diverse	turli
lived.	yashagan.
disciple	shogird
Aloha	yoqishingiz
patients,	bemorlar,
^)	^)
the planet	sayyoramizning
(Wills	(xohlagan
one	birini
growing	o&#39;sayotgan,
Severn	Severy
memory	xotira
love,	sevib,
upper	yuqoridagi
sulphate	sulfat
original,	xos,
ancient,	qadimiy,
\\	\\
. &amp; quot ;,	uchun.&quot;,
CONFIG.SYS	CONFIG.SYS
Theme	Mavzu
=============================================	=============================================
Well,	Xo&#39;sh,
mediator	mediator
Disclaimers	Ogohlantirishlar
the brochure	risolaning
importance	ahamiyatga
arrogant	mutakabbir
east)	sharqqa)
prescribing	buyuriladi
&amp; Quot; fruit &amp; quot;	&quot;qovun&quot;
expectation	kutish
massacre	qirg&#39;in
reader	o&#39;quvchi
astronauts	astronavtlar
__	__
(Lin	(Lin
switch	switch
mouse	sichqoncha
the direction of	yo&#39;nalishini
toast.	tushdi.
Toast,	tushdi,
MouseWare	MouseWare
a journey	safarga
html>	dbernard@clesun.Central.Sun.COM
cardinal	tubdan
dispatch	jo&#39;natish,
Hutchison &amp; quot;	Hutchison&quot;
contact?	murojaat?
pattern	naqsh
laws	qonunlarini
.	`.
[2]	[2]
^^	^^
In space	Kosmosda
Almighty,	Taoloning
the gods	xudolar
3-8), &amp; gt;	3-8),&gt;
Specialized	ixtisoslashtirilgan
sister,	singlim,
-183	-183
Window &amp; gt;	oyna&gt;
priority	ustuvor
a solid-rock	mustahkam-rock
382	382
sad &amp; gt;	hafa&gt;
In the United States	AQShda
&amp; Quot; humanization &amp; quot;	&quot;insonparvarlik&quot;
&amp; Quot;	&quot;Shaxsiy
Palestine	Falastin
conservative.	konservativ.
baptism	cho&#39;mish
author	muallifi
(Skelton	(Skelton
-179	-179
appear.	ko&#39;rinmaydi.
&amp; Quot; fuzzy	&quot;loyqa
teacher	ustoz
back	orqaga
State	Davlat
blow	portlatishga
models	modellari
arcs	yoylari
tune	sozlamoq
write	yozish
naked	yalang&#39;och
(Douglas	(Douglas
375	375
At the end,	oxirida,
the head	boshga
Dazzling	qamashtiruvchi
&amp; Quot;:	&quot;:`
Pizza-colored	pizza-rangli
[A	[a
Space	Kosmosga
(For example)	(masalan),
Nanaimo,	Nanaimo,
one of the	biriga
israel	israel
360	360
living	turmush
Date	Sana
instead	o&#39;rniga
growth)	o&#39;sish)
Thousands	Minglab
Face	Yuz
Gaza	G&#39;azo
[she is	[u
HRB	HRB
study,	o&#39;rganib,
examined.	o&#39;rganib.
Sams	Sams
believers	mo&#39;minlar
[I	[I
Chris	Chris
convocation	chaqirishni
\)	\)
Model	chiqarilgan
organ	organ
&#39;You	»Siz
\;	\;
48?)	48?)
photochemical &amp; quot;	fotokimyo&quot;
study;	o&#39;rganib;
call	chaqiriq
remove	tashlash
K1Y	K1Y
&amp; Quot; Cancel	&quot;bekor
Land	Land
surprised	hayron
play.	o&#39;ynaydi.
relatively	nisbatan
ge	ge
Buyers	qiluvchilarni
Uranium	Uran
the problem,	muammo,
infections	infektsiyalari,
to	ga
poles	qutblarda
&amp; Lt; 1qksc2$2mr@fido.asd.sgi.com&amp;gt;	&lt;1qksc2$2mr@fido.asd.sgi.com&gt;
manufacturer	chiqaruvchi
satellite	yo&#39;ldosh
my	o&#39;zimning
JPL	JPL
throw	tashlaydi,
such	bunday
Paul	Paul
mph)	milya)
203	203
children	bolalarni
200	200
dictionary	lug&#39;at
20:	20:
&amp; Quot;	&quot;Va
disciples	shogirdlari
html>	SLEGGE@kean.ucs.munc.ca
&amp; Quot;	&quot;Uy
forces	kuchlari
20%	20%
the expansion of the soul)	kengaytirish-nafs)
i	i,
possible	imkon
it seemed	tuyulardi
our	bizning
said	dedi
final): &amp; gt;	oxirgi):&gt;
I did.	qildim.
files	fayllarni
Service	xizmati
station	stantsiyani
left.	qoldirgan.
Corollas	Corollas
Beta	Beta
pioneer	kashshof
interpretation	talqini
His disciples,	shogirdlariga
worthy	munosib
In:	In:
speaking).	gapirish).
.	o&#39;tgan.
&amp; Quot; ...	&quot;...
Georgia	Gruziya
Instant &amp; gt;	oniy&gt;
star	yulduz
Aili in	ailin
seven	etti
is.	sanaladi.
debate	munozaralar
21)	21)
do	do
Iftccu:	Iftccu:
In.	In.
portraits	portretlar
constantly	doim
21	21,
According to	ko&#39;ra
neighbor	qo&#39;shni
free,	bo&#39;sh,
bows	kamon
In addition,	bundan
JPB	JPB
material	ashyo
Agnosticism	Agnostitsizm
acceptable	maqbul
delusional &amp; gt;	delusional&gt;
Several	Necha
sign,	ishora,
earth	yer
Advanced	Advanced
Io	Io,
meteorites	meteoritlarning
We have.	qildik.
sign;	ishora;
land	er
Low	Past
Fraering)	Fraering)
design	dizayn
! &amp; Quot;	Bu!&quot;
&amp; quot ;.	yaxshi&quot;.
Lantz)	Lantz)
&amp; gt;	qanday&gt;
this	bu
pitcher	ko&#39;za
bf	bf
.	qilingan.
,	qilingan,
using	foydalangandan
bi	bi
The grounding.	Topraklama.
Today	Bugun
that;	deb;
pair	juft
at	da
that:	deb:
Basin	havzasi
that?	deb?
2.5	2,5
the ship	kemada
Teemu	Teemu
(My wife)	(xotinim)
.]	bosh.]
only	faqat,
,	deb,
area	maydon,
.	deb.
a computer	kompyuterga
slipper	shippak
checked)	tekshiriladi)
to mitigate	yumshatish
XT350	XT350
html>	ab245@cleveland.Freenet.Edu
History	Tarix
jelly	jele
).	edi).
real	ko&#39;chmas
creates.	yaratadi.
almost	deyarli
)	edi),
html>	geb@cs.pitt.edu
worse	yomonroq
mode	holatiga
Edit:	Tahrir:
``	``
uunet	uunet
Window	Oynasida,
Recyle	Recyle
stretcher	zambilda
&amp; Gt; &amp; gt;	Texnikasi&gt;&gt;
documentary	hujjatsiz
respect	hurmat
Safety,	qo&#39;liga,
leading	boruvchi
watch	tomosha
c:	c:
html>	franjion@spot.Colorado.EDU
Prices	narxlari,
JKN	JKN
ANY	BIROR
area	maydoni
very	juda
ed	ad
[1]	[1]
pressure	bosim
Prices.	narxlari.
no	no
document	hujjatni
sunlight	nuriga
&amp; Quot; placebo	&quot;platsebo
applications	ilovalar
Cadillac &amp; quot;	Cadillac&quot;
women&#39;s	ayollarning
The purpose of	maqsadi,
I disagree.	qo&#39;shilmayman.
of	of
laboratories	laboratoriyalari
overlapping	nizomiga
The compounds of the	aralashmalari
Question	Savolingizga
html>	schuster@panix.com
Meteor	Meteor
flag	bayroq
In: &amp; gt; &amp; gt;	In:&gt;&gt;
bright	yorqin
designs	dizaynlar
wild	yovvoyi
Space)	kosmik)
,	qo&#39;yish,
space	kosmik,
qualifying	o`yini
white	oq
More	Ko&#39;proq,
wise	dono
Instead,	o&#39;rniga,
Lippard)	Lippard)
as	etib
Observer	Observer,
little	oz
month	oy
&amp; gt;	ham&gt;
guest	mehmon,
seen.	ko&#39;rdik.
PE	pe
We have seen,	ko&#39;rdik,
pm	pm
on	ustiga,
Tickets for	chiptalar
html>	psyrobtw@ubvmsb.cc.buffalo.edu
Member	Member
not	emasligini
beside myselff	myselfe
tables	jadvallar
BBS:	BBS:
Galatians	Galatiyaliklarga
responsibility	mas&#39;uliyatni
dos;	dos;
boards	platalar
A &amp; gt;	Agar&gt;
1500	1500
company	kompaniya
me	me
Ditto.	Ditto.
Sunday	Yakshanba
Messier	Messier
priests	ruhoniylar
46904	46904
quantum	kvant
asylum	boshpana
&amp; Quot; aggressive &amp; quot;	&quot;tajovuzkor&quot;
quiet	tinch
.	chiqaradi.
rule	hukmronlik
belt	kamarini
glance &amp; quot;	qarashda&quot;
lifeless	jonsiz
dagger	xanjar
,	olib,
na	na
Men	Erkaklar
killing	o&#39;ldirish
orthodoxy	ortodoksal
I saw.	ko&#39;rdim.
Institute:	instituti:
Arizona	Arizona
dead	o&#39;liklar,
option	ni
Stores	do&#39;konlar
.	olib.
p.	p.
experience	boshdan
(Spain)	(Ispaniya)
obey	itoat
Orbiters	Orbiters
The contacts	Kontaktlarni
P.S.	P.S.
Supplied	ta&#39;minot
html>	mock@watt.support.Corp.Sun.COM
Check:	tekshirish:
the list	ro&#39;yxatda
bent	egilib
It&#39;s a pity,	Afsuski,
XQueryTree	XQueryTree
IT&#39;S NOT	EMAS
eventually	oxir-oqibatda
AUTOMATIC	AVTOMATIK
persecuted	quvg&#39;in
Bresson)	Bressler)
functions	vazifalari
the status of the	holatini
Tabib	Tabib
I am,	emasman,
I am not.	emasman.
began;	boshladi;
KU	ku
Europe	Evropadan
The resurrection	tirilishi
,	boshladi,
I am not!	emasman!
.	boshladi.
ing	ing
God	Xudosiman,
construction	qurish
Rubenfeld)	Rubenfeld)
I am not;	emasman;
Blind)	ko&#39;r)
climate	iqlim
No,	Yo&#39;q,
Regardless of	qat&#39;i
splash	pog&#39;ona
belt	kamar
===========	===========
IT&#39;S NOT.	EMAS.
Orbiter	Orbiter,
I would like to.	istayman.
I would like to,	istayman,
hi	hi
Earth	Yer
Meeting	Meeting,
replacement	o&#39;zgartirish
year	yil
You	Sizga
html>	livesey@solntze.wpd.sgi.com
loss	yo&#39;qolganda,
Xelil	Xelion
Crusaders	Salbchilar
generation	avlod
JPS &amp; gt;	JPS&gt;
____	____
May	mayda
peers	tengdoshlari
collect	to&#39;plash
doctors	shifokorlar
education	ilm
many,	ko&#39;p,
in	in
thread	ip
TranslateCoordinates &amp; gt;	TranslateCoordinates&gt;
Impedance	impedans
ask	so&#39;rab
(&amp; Gt ;,	(&gt;,
trail	iz
pictures	suratga
Fred&#39;S	Fred&#39;S
More!	ko&#39;p!
Assuming,	faraz,
html>	COEGALON@LARC.NASA.GOV
Sharma)	Sharma)
[Jesus]	[Iso]
etc,	etc,
bright.	porloq.
chain	zanjir
YYY	YYY
ethane	etan
xt	xt
spot	spot
years	yilgacha
planned	rejalashtirilgan,
name	ismi
Test	Test
planned.	rejalashtirilgan.
&amp; quot ;, am	emasman&quot;,
clash	to&#39;qnashdi
describing the	tavsiflovchi
shares	aktsiyalarning
modernization	modernizatsiya
begins	boshlanadi
Powerbook	Powerbook
Schaufenbuel	Schaufenbuel
dizziness	aylanishi
apparatus	apparat
Half-rock	yarim-rock
Calling	Calling
&amp; gt;	ortiq&gt;
bading@cs.tu-	bading@cs.tu-
vv	vv
Despair	etar
treatment. &amp; quot;	davolash.&quot;
upperleft	upperleft
that	ekanini
selected	tanlangan
while	paytda
bright	yorug
distances	masofalarga
characteristic &amp; gt;	xarakterli&gt;
(The Americans)	(amerikaliklar)
(All	(Barcha
Radio Shack	Radio-Shack-ega
Lantz	Lantz
html>	nodrog@hardy.u.washington.edu
cause	keltirishi
&amp; Lt; C4Hyou.1Iz@mentor.cc.purdue.edu&amp;gt;	&lt;C4Hyou.1Iz@mentor.cc.purdue.edu&gt;
solution	yechim
be paid	to&#39;lanadi
Posts	uz
&amp; gt move;	ko&#39;chib&gt;
home	uy
and	va
(James	(James
again	yana
resistant	chidamli
Great	Buyuk
goods	tovar
swish	o&#39;chdi
eyes	ko&#39;zlar,
St.	etdi
It describes:	ta&#39;riflaydi:
The motherboard	anakart
matrix	matrix
observed:	kuzatiladi:
Insert]	`joylashtiring]
&amp; Quot; red	&quot;qizil
often	ko&#39;pincha
lines	chiziqlar
said	bildirdi
Those who	keltirganlar
Kinsley	Kinsley
The concept of &amp; gt;	tushunchasi&gt;
up	up
viewers	tomoshabinlar
&amp; Quot;	&quot;gi
The process	jarayoni
model	modelini
sensitivity	sezuvchanlik
test	sinov
&amp; Quot;	&quot;ga
&amp; Quot; Minnesota	&quot;Minnesota
It was,	etildi,
observed.	kuzatiladi.
Tight	Zich
pick	terimiga
There,	kuzatiladi,
.	etildi.
to	to
soil	tuproq
Political	Siyosiy
c.	v.
-235	-235
Personally,	Shaxsan,
infancy	halihamon
ISA)	ISA)
(Marcus	(Marcus
te	te
bad,	yomon,
afternoon	kunduzi
opening	ochilishi
discoverer	kashfiyotchining
Planets	sayyoralar
welcome	welcome
Sky	Osmon
Equal	Teng
hypothesis,	gipotezasi,
Views	chiqildi
Chip	Yonga
hte	hte
measured,	o&#39;lchagan,
Christ,	Masih,
dead-ends	o&#39;lik-tugasa
enhancer	kuchaytirgich
Ethics &amp; quot;	axloq&quot;
ampere	amper
eyes	ko&#39;zlari
Texas	Texas
she is,	u,
court	sudga
html>	brenner@ldgo.columbia.edu
is based.	asoslanadi.
quarter	chorak
Hockey,	Xokkey,
waters	suvlari,
ago	ilgari
In your area	Hududingizda
&amp; Quot; lead &amp; quot;	&quot;taslim&quot;
collected	to&#39;plangan
run	yugurish
that?	degan?
seed	zoting
&amp; Gt; &amp; gt;	​​&gt;&gt;
spread	yoyish
LED parents	ota-LED
(I	(Men
plates	plitalari
growth	rivojlanish
east-to-west	sharqiy-to-g&#39;arbda
conditions	sharoitlarda
specific	xos
-221	-221
with	bilan
number	raqam
html>	bressler@iftccu.ca.boeing.com
Transfer &amp; gt;	transfer&gt;
Ad Hoc	xok
raw	xom
conditions,	shartlarda,
&#39;&#39;	&#39;&#39;
Church	cherkovi
dilemma	dilemma
uses.	foydalanadi.
society	jamiyat
Some of	ba&#39;zilari
are you talking about?	gapiryapsiz?
helpful	foydali
test	test
express &amp; gt;	izhor&gt;
(Stephen	(Stiven
280	280
arrivals	kelganlar
Arab	Arab
Thence	Yerdan
Brooks)	Brooks)
Khan	Xon
Individual:	Individual:
Technology	Texnologiya
the words	so&#39;zlarini
28:	28:
Boulder	Boulder
.	etdi.
If you believe that,	ishonsangiz,
&amp; Quot; Bure &amp; quot;	&quot;Bure&quot;
yonqutisi	yonqutisi
&amp; gt; &amp; gt;	ular&gt;&gt;
imagination	tasavvur
html>	engp2008@nusunix.nus.sg
when	qachon
in the past	o&#39;tmishda
yesterday	kecha
html>	winfrvk@dutiws.twi.tudelft.nl
re-post	qayta-post
&amp; Quot; ^^^^ &amp; gt;	&quot;^^^^&gt;
40-22k	40-22k
Coelho	tejamkorlik
html>	willisw@willisw.ENG.CLEMSON.edu
Systems	Systems
Shovels	eshkaklar
Interested?	g&#39;amxo&#39;rlik?
propter	propter
hitter	hitter
events	voqealar
Relationships	Munosabatlar,
Possession	Egalon
between	o&#39;rtasidagi
raised	tiriltirgan,
honor	sharafiga,
astronauts	fazogirlar
from	tortib
size	o&#39;lchamli
short &amp; gt;	qisqa&gt;
up to	qadar
injustice	adolatsizlik
Life	Hayot
Earth &amp; gt;	Yer&gt;
(I	(men
Their	Ularning
logo	logo
cities	shaharlari
talk.politics.guns	talk.politics.guns
&amp; Lt; BADING.93Apr23105229@athene.cs.tu-berlin.de&amp;gt;	&lt;BADING.93Apr23105229@athene.cs.tu-berlin.de&gt;
1971	1971-yillar
Stalin &amp; gt;	Stalin&gt;
failed.	muvaffaqiyatsiz.
developing	rivojlanayotgan
Security &amp; quot;	Xavfsizlik&quot;
.	ko&#39;rsatdi.
html>	pubinfo.jpl.nasa.gov
is rounded,	yaxlitlanadi,
&amp; Quot;	&quot;keyin
html>	caltech.edu
images	tasvirlar
240	240
Brooklyn	Bruklin
14-19 &amp; gt;	14-19&gt;
people	xalqi
flood plains	qayirida
I would like to	istardim
city)	shahar)
Five	Besh
unexpected	kutilmagan
Journal	Journal
interested	manfaatdor
equipped.	jihozlangan.
243	243
Ming)	Ming)
accuracy	aniqligi
1975	1975-yillar
gases	gazlar
forever	abadiy
they	ular,
relationships	munosabatlar
wounded	yarador
24-bit	24-bit
angle	nazarini
ISA	ISA
(Or	(Yoki
issue.	masalasidir.
increases	oshiradi
numbers	raqamlar
not	qilmagan
brands,	belgilari,
statistics	statistika
cut	kesib
sajda	sajda
help	yordam
Argo	Argo
bank,	sohillarni,
(Walter	(Walter
12.00	12.00
melted	eritilgan
land	yurtini
LMH	orangecar&#39;ait
250	250
Happening.	happed.
(Henly,	(Henling,
J23	J23
bottomless	tubsiz
cylinders	silindir
25.	25.
*****	*****
evil	yomonlik
&amp; gt;	yuqori&gt;
Telephone	Telefon
White	White
election	saylov
died,	o&#39;ldi,
yr	yr
to believe	ishonish
Thank you.	Rahmat.
Washington, DC	Vashingtonda
meaningless	ma&#39;nosiz
The representative of	vakili
or	yo
html>	berlin.de
&amp; Lt; 1r0vk6INNaft@cronkite.Central.Sun.COM&amp;gt;	&lt;1r0vk6INNaft@cronkite.Central.Sun.COM&gt;
historian	tarixchisi
Brenner	Brenner
GetGeometry	GetGeometry
Manager	boshqaruvchisi
Iaccoca	Iaccoca
walking,	yurib,
Shopper	Shopper
Matrix	Matrix
model,	namuna,
medium	o&#39;rta
system	tizimidan
Theisen	theist
This	Ushbu
lonely	yolg&#39;iz
put	qo&#39;yish
Allah)	«Alloh)
was found	topilgan
the hand	qo&#39;liga
the west	g&#39;arbdan
)	narsa)
nothing	narsa,
the lead	zimmasiga
Mitsubishi	Mitsubishi
Astronauts	Fazogirlar
**************	**************
hockey	xokkey
amatuer	amatuer
(Phil	(Phil
Pathfinder	Pathfinder
things:	narsa:
Palestine	Falastinda
time	vaqtini
to deliver	qutqarishni
simplified	soddalashtirilgan
App	App
Hard	Hard
Apr	Apr
Psalm	Zabur
Sport	Sport
do	qila
war	urush
thought	o&#39;ylagan
it would be	bo&#39;lardi
vfintd.386:	vfintd.386:
recommended	tavsiya
Stony	Stony
mine)	meniki)
civilization	sivilizatsiyasida
Latest	So&#39;nggi
Watts:	vatt:
FORUMS	qamrovli
successful	muvaffaqiyatli
toward	tomonga
exchange	almashishni,
graze	shilmoq
diagnosis,	tashxis,
heterosexual, &amp; gt ;,	heteroseksüel,&gt;,
In the minds of	Ongida
Jewish,	yahudiy,
fishing)	baliqchi)
accidents	baxtsiz
html>	hall@boi.hp.com
According to the	binoan
91%	91%
html>	pharvey@quack.kfu.com
illegal	noqonuniy
punishment	jazo
economic	iqtisodiy
height	balandligi
html>	lippard@skyblu.ccit.arizona.edu
Giants	Giants
Zbib)	Zbib)
Assuming	faraz
&amp; quot ;.	bor&quot;.
(GIF,	(GIF,
Brian	Brian
the irregularities	nosimmetrikliklar
books	kitoblarida
supply	ta&#39;minlash
Maria	Mariya
?	chiqish?
Views	Ko&#39;rishlar
Hawk	Hawk
the terms of the	shartlariga
already	allaqachon
less	kamroq
defeated	mag&#39;lub
equipped.	jihozlandi.
world	dunyoning
Air	Havo
&amp; Quot; un-authorized &amp; quot;	&quot;un-vakolatli&quot;
hile	makr
The concept	tushunchasi
parents	ota-ichiga
examined.	tekshirildi.
science	fan
»	narsa»
output	chiqishi
974	974
card.	karta.
the principles of	tamoyillariga
Ridiculous	Kulgili
catalog	katalogini
(872	(872
algorithms	algoritmlarni
Recently	Yaqinda
on arrival	borar
Search &amp; gt;	izlayotgan&gt;
Gays	Hays
at work,	ishlaydi-da,
&amp; Quot;	&quot;biz
Store	Store
using	foydalangan,
atmosphere,	atmosferasida,
banschbach	banschbach
America	Amerika
appeared,	ko&#39;rindi,
Water	Suv
appeared.	ko&#39;rindi.
systems	tizimlar
distribution	taqsimlash
indiscriminately	gelişigüzel
Sun	Sun
seen	ko&#39;rgan
(842	(842
appeared;	ko&#39;rindi;
the system	tizimida,
million	millionli
&amp; Quot; ...	&quot;....
Relations &amp; gt;	munosabatda&gt;
the same	xil
mail	mail
driven	gijgijlash
explain	tushuntirishga
Lock &amp; quot ;.	qulfi&quot;.
The results,	natijalari,
Herschel	Herschel
said.	aytadi.
Toronto,	Toronto,
Nissan	Nissan
Europa	Europa
html>	billq@ms.uky.edu
including)	jumladan,)
transmitted.	uzatiladi.
Translator	aylantirish
mean	degani
guard	soqchi
by	tomonidan
&amp; Quot;	&quot;bir
Jews,	yahudiylarning
two,	ikki,
dizziness,	aylanishi,
Machinery	mashinalari
&amp; Gt;	Bu&gt;
ordered.	buyurdi.
Shadow	Shadow
information	ma&#39;lumotlar
told	aytib
Climbing	zabt
Cephas	Kifa
two?	ikki?
both	ikkala
664-6354	664-6354
[Christians]	[nasroniylar]
principles	tamoyillariga,
the state of	shtatining
Children	Bolalar
How many	Qanchadan-qancha
&amp; Lt; wnk.734824081@aquifer.geology.uiuc.edu&amp;gt;	&lt;wnk.734824081@aquifer.geology.uiuc.edu&gt;
justification	oqlash
.	bo&#39;ladi.
region	mintaqadagi
&amp; Quot; &amp; quot;	&quot;bajarish&quot;
mutual	o&#39;zaro
If you believe	ishonsangiz
namelplate &amp; gt;	namelplate&gt;
using	yordamida
chip &amp; gt;	yonga&gt;
the name	nomini
will	bo&#39;ladi,
?	bo&#39;ladi?
Fiction	Fiction
&amp; Quot; back	&quot;orqa
society	jamiyatning
&amp; gt;	of&gt;
Faster	Tezroq
cells	hujayralari
it would be.	bo&#39;lardi.
Then	So&#39;ngra
fulfilled	bajardi
it would be,	bo&#39;lardi,
;	bo&#39;ladi;
testamentary &amp; quot;	vasiyat&quot;
at an altitude of	balandlikdagi
seven	yetti
call	atashimiz
the hospital	kasalxonada
Banks	Banklar
do not	bo&#39;lmagan
Imagine,	tasavvur,
life guard	xaloskor
time	marotaba
hold	ushlab
#From	#From
intellect	aql-idrok
the risk	xavfi
It is,	qilinmoqda,
========	========
It is.	qilinmoqda.
sending	jo&#39;natib,
Guns,	Guns,
&amp; Quot; Pink	&quot;Pushti
Statistics	Statistika
height	balandlik,
The presence	borligi
meteorite	meteorit
parts	qismlarga
rough	qo&#39;pol
Tan	Tan
Brothers	Brothers
frank@D012S658.uucp	frank@D012S658.uucp
batting	vatin
everywhere	joyda
Krsek)	Krsek)
see)	turibmiz)
INTERNET:	INTERNET:
Hutchison	Hutchison
reduce	kamaytirish
in the fields of	sohalarida
Yet	Hali
will	tushadi
Djakarta	Djakarta
graph	grafik
wearing	kiygan
depression	tushkunlik
I &amp; gt;	olaman&gt;
9:31	9:31
Norio	Noring
the project	loyihasini
&amp; Lt; 19613@pitt.UUCP&amp;gt;	&lt;19613@pitt.UUCP&gt;
Trondheim	Trondxeym
Independence	Mustaqillik
Galileo	Galiley
half)	yarim)
place	joyga
Mercury	Merkuriy
others	boshqalarning
O&#39;Dwyer)	O&#39;Dwyer)
&amp; Lt; faith	&lt;e&#39;tiqod
=========================	=========================
(Rock)	(tosh),
dunes	tepalari
formats	formatlar
to remember	eslash
outsider	begona
Hans	Hans
)	ning)
html>	uu.net
artistic	badiiy
spend.	sarflaydi.
beautiful	go&#39;zal
Sci.med	Sci.med,
Reload this Page	Malumot
&amp; Quot; Terminator &amp; quot ;,	&quot;Terminator&quot;,
opportunities	imkoniyatlarni
&amp; Quot; QUACK &amp; quot;	&quot;QUACK&quot;
94550	94550
on	ustidan
mixture	aralashma
the curve	egri
Frmwrks	Frmwrks
Have you?	ko&#39;rganmisiz?
Inning	Inning
(Romans	(Rimliklarga
external	tashqi
nations,	xalqlarga
sulfur-rich	oltingugurt-boy
(317)	(317)
Galileo	Galileo
key	kalit
Knowles &amp; quot;	Knowles&quot;
Go to	borib
the machine	mashinadan
identified.	aniqlandi.
satisfactory	qoniqarli
WAGNER	WAGNER,
plate	plastinka
Christians	nasroniylar
the atmosphere	atmosferaga
smoke	tutun
vulnerable	zaif
html>	punjabi@leland.Stanford.EDU
planets,	sayyoralar,
The difference,	farq,
conclusion	xulosasi
&amp; Quot; &amp; quot practice;	&quot;shifokorlarining&quot;
ethane-methane	etan-metan
Bicentennial	Bicentennial
from	boshlab
You	Siz
09:02:48	09:02:48
Yamakawa	Yamakawa,
May	may,
but down	but-pastga
will	o&#39;tadi
attracting	jalb
a collection	to&#39;plamini
;	ketdi;
Bright	Yorqin
supports	qo&#39;llab-quvvatlaydi,
Hell	jahannam
Hard	Qiyin
Clayton	Clayton
Europeans:	Yevropaliklar:
MOUSE	Sichqonchasi
maintain.	saqlab.
Superve	SuperVGA
.	ketdi.
save	saqlab,
includes	oladi
who	qilgan
two-astronaut	ikki-astronavt
salvation	qutilish
minority	ozchilik
Actually	Aslida
messages	xabarlar
Malaspina	Malaspina
(I think)	(menimcha)
84 years	84-yil
V-Mail:	V-Mail:
walk	yurish
to be	bo&#39;lishiga
Jacob	Yoqub
thought	o&#39;ylagani
DE	ShU
code	kodi
wings	qanotlari
tops	toplar
that	o&#39;sha
?	ketdi?
From	From
e_mali:	e_mail:
the difference	farqi
compliance with	rioya
plates. &amp; quot;	plitalari.&quot;
chips	chips
monopoly,	turmaydi,
giants	gigantlar
eight	sakkiz
Mystery	Sir
(Hockey	(xokkey
Colorado	Kolorado,
I can not.	olmayman.
the truth	haqiqatni
--------------------	--------------------
I can not,	olmayman,
The Gospel	Injilni
text	matn
This	Shu
Passengers	Yo&#39;lovchilarning
BIOS	BIOS
Is	bormi
discovery	kashfiyot
Therefore,	Demak,
,	er,
feeds:	olmoq:
talking	gaplashayotgan
polls	anketalar
(Tvtwm)	(tvtwm)
Abraham,	Ibrohimning
said	aytgan
formation	shakllanishi
(Chris	(Chris
the citizens	fuqarolarini
Law &amp; gt;	qonun&gt;
Christ	Masihning
brought.	keltirildi.
reality	haqiqatga
property	mulkiy
Prices	Narxlari
local	mahalliy
talks	muzokaralar
Freezer	og&#39;diruvchi
phase	bosqichi
not	bo&#39;lmasligi
Show	ko&#39;rsatish
to	etish
driver	drayveri
sci.med	sci.med
we rely on,	tayansak,
systematize	sistemleştirmek
(Darryl	(Darryl
General	Umuman
vfintd.386	vfintd.386
Anything	Anything
Dori	Dori
Vulnerable	Zaif
proposals	takliflarni
determination	aniqlash
Metal,	metall,
Macworld	Macworld
Bitnet	Bitnet
Denning	Denning
Washington	Vashington
somwhere	somwhere
reckless	eítiyotsizlik
timely	vaqtida
southern	janubiy
David	devide
Matthew	Matto
talent	iste&#39;dod
onboard	onboard
You	Sen
Covenant	Ahd
crushed	ezilgan
atmosphere	atmosferasining
they	ular
Chapter	bobda
Lord	Rabbimiz
).	uchun).
It&#39;s not	Emas
works	ishlari
chill	chill
wide,	keng,
and	esa
adhering to the	yopishgan
----------------------------------------------	----------------------------------------------
action	harakat,
Is it possible?	mumkinmi?
College,	kolleji,
Sale	Sotish
sys.ini	sys.ini
(O)	(Ey)
Christianity	nasroniylik
question	savolga
stations	stansiyalari
billion	milliard
my friend	do&#39;stim
Richard	Richard
TTL	TTL
Players	futbolchilar
:-)	:-)
Environment	Muhitini
you&#39;re	odamsiz
Lamp,	Chiroqqa,
Europeans,	evropaliklar,
Systems	tizimlari
Carlton	Karlton
Action:	harakat:
unpleasant	yoqimsiz
head	boshingni
tax	soliq
War	urushi
to be	bo&#39;lishini
First	Birinchi
inappropriate	noo&#39;rin
here	mana
Prompt	again
html>	oak.oakland.edu:pub/msdos/windows3/winjp210.zip
Air	Air
is	bormoqda,
the body	tanasi
&amp; gt;	dastur&gt;
In turn,	navbatida,
is.	bormoqda.
is it?	bormoqda?
Cuesta	Cuesta
seismic	seysmik
the possibility of	imkoniyati
confidence	ishonch
Switching	Kommutatsiya
practiced	namoyondalarining
C.)	C.)
today	kunda
Dodson)	Dodson)
&amp; Quot; gnostein?	&quot;gnostein?
region	mintaqada
see	ko&#39;rishingiz
Stable	Barqaror
application	ariza
People	kishi
Systems,	tizimlar,
found.	topilgan.
innumerable	son-sanoqsiz
coma	koma
roommate	xonadoshim
found,	topilgan,
the resurrection	tirilish
&amp; Quot; good &amp; quot;	&quot;yaxshi&quot;
most	eng
They	Ular
Point &amp; gt;	nuqta&gt;
&amp; Lt; 188@ky3b.UUCP&amp;gt;	&lt;188@ky3b.UUCP&gt;
BMP	BMP
TSC	TSC
Amount.	tutadi.
BMW	BMW
the sense of	hissini
visual	ingl
friends	do&#39;st
crater	krater
opportunity,	imkoniyat,
Giotto	Giotto
fracture	sinishi
strong &amp; gt;	strong&gt;
Doubtful	Shubhali
Mining!	kon!
His father	Otasi
community &amp; quot;	jamiyat&quot;
Barton)	Barton)
the thoughts	fikrlarini
level	daraja
behind	orqasida
part	qism
mine	konini
&#39;.	&#39;joylashgan.
&amp; Quot; back	&quot;orqaga
your	sening
second)	ikkinchi)
Switching	kommutatsiya
projects	loyihalarni
seed	nasling
goods	mollarni
the ability of &amp; gt;	qobiliyatini&gt;
DECAY	parchalanish
atmosphere	atmosferasi
.	ega.
&#39;93)	&#39;93)
scenery	manzara
,	ega,
clip.	tingladi.
Davis)	Davis)
Crash	Crash
tasks	vazifalarni
liquid	suyuq
Amr	Amr
March	mart
a description of	tavsifi
situation	vaziyatni
;	ega;
micrometeorites	mikrometeoritleri
C2.	C2.
Goya.	go&#39;yo.
(Especially	(ayniqsa
circulates	aylanayotgan
Impedance	empedans
Ana	Ana
Technologies	texnologiyalari
()	(),
1-301-340-4543	1-301-340-4543
().	().
that	degan
miyop	miyop,
attitude-control	munosabat-nazorat
investment	investitsiyalash
(10-105	(10-105
of Chemistry	kimyosi
candida	candida
&amp; Gt; &amp; gt ;.	&gt;&gt;.
Planets	Sayyoralar,
blocks	bloklari
&amp; Gt; &amp; gt ;,	&gt;&gt;,
devices	vositalar
eyes	ko&#39;zlarimga
fight	jang
Delaware	Delaware
email:	email:
755-8742	755-8742
rescue	qutqarishga
sadness	qayg&#39;u
planets	sayyoralarda
untold	behisob
Galant,	Galant,
as	sifatida,
physical,	jismoniy,
.	sifatida.
intentionally	qasddan
as:	sifatida:
Palestine	Falastinga
frequently	tez-tez
fundamental	fundamental
html>	jmilhoan@magnus.acs.ohio-state.edu
H	So.
total	jami
a)	agar)
if,	agar,
Prayer	Namoz
Center	Markaz
html>	gt7469a@prism.gatech.edu
witness	guvoh
1312	1312
Alt.psychology.personality	Alt.psychology.personality
True,	rost,
What	Nima
conservation	saqlash
does.	ettirmaydi.
atmosphere	atmosfera
Beacon	Buy
walks	yurishlari
the existence of	borligini
(6)	(6)
&amp; Lt; No.	&lt;No.
updated	yangilangan
appropriate	tegishli
Rifle &amp; gt;	miltiq&gt;
&amp; gt;	qilinadi&gt;
(59	(59
Adaptec	Adaptec
Euro	evro
found	qildi
slot	uyasi
salmon	salmon
Permanent	Doimiy
gif	gif
Why	nega
Arab	arab
designed	mo&#39;ljallangan,
ordered.	buyurgan.
Therefore,	sababli
(5)	(5)
Rights	huquqlar
Law	Qonun
Umbria	Umbriel,
ganimedes	ganimedes
support,	qo&#39;llab-quvvatlash,
months	oylar
Asteroids	Asteroids
Page)	Page)
oil	neft
guarding	qo&#39;riqlab
Barton	Barton
the core	yadrosidagi
let.	qilsinlar.
(4)	(4)
This is	Bu,
&amp; Quot; orbit	&quot;orbitasida
Landmann &amp; gt;	Landmann&gt;
connectors	ulagichlar
Systems,	tizimlari,
prompt,	irodasi,
S	Ning
comets	kometalar
panic	vahima
&amp; Quot;	&quot;Evropa
nuclear	yadro
normal	normal,
Syndrome) &amp; gt;	sindromi)&gt;
My	Mening
If	Agar
all?	barcha?
dogma	dogma
SUV	SUV
it seems?	ko&#39;rinadi?
Physical	Jismoniy
(3)	(3)
Bonds	Obligatsiyalar
Fixed	etilgan
will be shown.	ko&#39;rinadi.
support	qo&#39;llab-quvvatlashi
variaty	variaty
All)	barcha)
Capture	Capture
[26]	[26]
Told	Aytib
all.	barcha.
For example,	masalan,
(27	(27
enemies	dushmanlarini
Silt	zambil
it seems)	ko&#39;rinadi)
(24	(24
Inbox	qutisi
only	faqat
moves	aylanayotib,
orbits.	aylanayotib.
encoded	kodlangan
For	Uchun
daily	kungi
break	sindirish
Day,	kuni,
in the minds of	ongida
(2)	(2)
does not	kelmading,
Miranda,	Miranda,
======================	======================
On the other hand,	tomondan,
82:	82:
(1)	(1)
eye	ko&#39;zga
leaving	qoldirib,
connected to	ulangan
Preserved	saqlanib
============================================	============================================
(745	(745
renewal	yangilash
Bible &amp; gt;	Bibliya&gt;
[23]	[23]
LaStrange)	LaStrange)
Spirit	Ruh
-day club	kun-klub
the use of	ishlatish,
cars	avtomobillari
harbor	yuramanmi
Comparative	qiyosiy
Do not mix.	aralashtirmang.
bravery	jasorat
substances	moddalar
goaltender	goaltender
exploitation	ekspluatatsiya
their	ularning
optical	optik
historians,	tarixchilar,
[24]	[24]
unique	nodir
[25]	[25]
in front of	oldida,
Rings	Halqalarni
Automated	Avtomatlashtirilgan
closed.	yopiladi.
&amp; Quot; Pavel	&quot;Pavel
Diffie-Hellman	Diffie-Xellman
(Yuk	(Yuk
html>	I3150101@dbstu1.rz.tu-bs.de
7 surface	7-sirt
html>	jh6r@andrew.cmu.edu
(Bake	(Bake
formed	shakllantirildi
maneuverability	manevra
gas	gaz
please	iltimos
MAY	MUMKIN
ask	so&#39;rab,
.	qiling.
Sam	Sam
use	foydalanishingiz
import	import
I remember,	eslayman,
Cramer	Cramer,
elliptic	elliptik
Franjione)	Franjione)
Cramer)	Cramer)
Triantafyllopoulos	Triantafyllopoulos
the concentration of	quyilib
(?)	(?)
&#39;Objective	«ob&#39;ektiv
ring	ring
please!	qiling!
the forecast	prognozi
plutoneon	plutoneon,
&amp; gt;	boshladi&gt;
slaughtered	so&#39;yilgan
to pay	to&#39;laydi
corrupt	buzilgan
How	qanchalik
None UUCP	UUCP:!
numbers	raqamlari
&amp; Quot; objective	&quot;ob&#39;ektiv
Consumption	Iste&#39;mol
GAY	gay
General	Umumiy
poster	poster
the predecessor	salafiy
&amp; Lt; id.XNFZ.VJ8@nmti.com&amp;gt;	&lt;id.XNFZ.VJ8@nmti.com&gt;
&amp; Quot; q &amp; quot;	&quot;q&quot;
sentence	gap
the neighborhood	mahalla
eye	ko&#39;zni
=====================================	=====================================
9,846	9,846
posted	posted
option	variant
were	qilindi
I did!	edim!
identify,	aniqlash,
hobbiest	hobbiest
his	o&#39;zining
Deposit	Depozit
neon	neon
grant	bermoq
point-of-view	kelin-of-ko&#39;rinishida
honor	sharaf
&amp; Quot; the atmosphere	&quot;atmosfera
pale	xira
(Richard	(Richard
oxygen	kislorod
html>	c23st@kocrsv01.delcoelect.com
permanent	doimiy
6X9	6x9
As	Sifatida
&amp; Quot; Human	&quot;Inson
San	San
&#39;Kim	«Kim
what.	nima.
(Scott	(Scott
what,	nima,
you want	kerakli
performance	ishlash
primary	boshlang&#39;ich
Canadiens	Canadiens
Forgot your password?)	unutdingizmi?)
During the	paytida,
We were.	edik.
toast	tushdi
surrounded	o&#39;rab
Very	Juda
&amp; gt;	shuningdek&gt;
Kinsey	Kinsey
chips	chiplari
xterm	xterm
what?	nima?
transmission	uzatish
DES	DES
Finland	Finlyandiya,
Standard	standart
753-3245,	753-3245,
to be	bo&#39;lishimiz
2400	2400
supports	qo&#39;llab-quvvatlasa,
Rosa	Rosa
Rockville,	Rockville,
As far as	O&#39;qisak,
hit)	urdi)
League	ligasida
heard?	eshitilgan?
as	qilib
rule	qoida
(93	(93
like,	o&#39;xshash,
corrections	tuzatishlar
place	o&#39;rinda
I did.	edim.
html>	cj195@cleveland.Freenet.Edu
comets	kuyrukluyıldızların
stylizied	stylizied
According to	qaraganda,
remind	eslatib
police	politsiya
faith	imon
separation	ayrilish
uunet.	uunet.
placed	joylashtirilgan
(88	(88
window	oynasida
Remember	yodda
ESPN	ESPN
the atmosphere	atmosferada
temperature,	harorati,
Check in	betob
cooperation	hamkorlikda
201	​​201
(128.149.6.2)	(128.149.6.2)
issue	masalaga
Rowland	Rowland,
Small	Kichik
WEISS	Vayss
Northern	Shimoliy
&amp; Lt; 1r1i7mINN4n4@cronkite.cisco.com&amp;gt;	&lt;1r1i7mINN4n4@cronkite.cisco.com&gt;
Do not.	olmang.
exclusive	eksklyuziv
html>	korenek@nmti.com
I thought.	o&#39;ylardim.
current &amp; quot ;.	amaldagi&quot;.
conditions	sharoitlar
installation	o&#39;rnatish
Arabs	arablaridan
Hadi	Hadi
Jews,	yahudiylarga
brown	jigarrang
Huygens	Gyuygens
24:46	24:46
sometimes	ba&#39;zan
Mapping	xaritalash
hope	umid
Yeasts	achitqilari
-thirds	uchdan
Harumph.	Harumph.
stable	barqaror
story	hikoya
activities	faoliyati
Spin	Spin
behavior &amp; quot;	xulq&quot;
html>	vacsc0qe@VAX.CSUN.EDU:
Nelson)	Nelson)
countries	davlatlar
Astronomers	Astronomlar
&amp; gt;	kelgan&gt;
A &amp; gt;	A&gt;
Zbib	Zbib
lives	yashaydi
exactness	ro&#39;parasiga
,	paydo,
Value	qilardi
are	etilmoqda
(This	(Bu
VanHeyningen	VanHeyningen
Maybe	Balki
memorial	yodgorlik
Thin	yupqa
ammonia	ammiak
revealed.	nozil.
locked	qulflangan
cameras	kameralar
Think	o&#39;ylab
SKS	SKS
means	anglatadi
practice	amaliyot
all	hammasini
If the	qilsa
html>	leonard@aix3090b.uky.edu
2300	2300
Culture	Madaniyat
of you	sizlardan
leaders	rahbarlar
returned	qaytgan
&amp; Quot; arms	&quot;qurol
fine,	nozik,
Ammonia	Ammiak
driver	haydovchi
the display	displeyda
00ecgillespi@leo.bsuvc.bsu.edu&amp;gt;	00ecgillespi@leo.bsuvc.bsu.edu&gt;
them	ulardan
suddenly	birdan
End	End,
I	qilaman,
beguiled.	ketkazdi.
decay	parchalanishi
potential	potentsial
The legislation	Qonunchilikni
second	ikkinchi
Citizen	Citizen
Rifles	o&#39;qotar
415-	415-
,	olgan,
parented	parented
SRESURRECTION :::	«SRESURRECTION:::
motherboard	anakartı
the list	ro&#39;yxatiga
Africa	Afrika
main	asosiy
&amp; quot;	olib&quot;
cannon	to&#39;p
We are	Biz
orange	to&#39;q
Westwards	G&#39;arbga
feelings	his-tuyg&#39;ularini
lived	yashagan
Kirk.	Kirk.
&amp; Lt; jh6r+@andrew.cmu.edu&amp;gt;	&lt;jh6r+@andrew.cmu.edu&gt;
United States	AQSh
Weapons:	qurol:
infusions	infüzyonları
I &amp; gt;	mening&gt;
Men	erkaklar
shops	do&#39;konlari
staff	xodimlari
I am.	qilaman.
weapons	qurol,
One	Bir
United	United
!	beradi!
Robert	Robert
kilometer	kilometr
But	Lekin
hitter)	hitter)
Jordan	Iordaniya
friends	do&#39;stlarim
searching	izlab
SER	SER
SET	SET
material	moddiy
Re:	Re:
20th century	20-asrning
perturbations	chetlashish
,	beradi,
searching	araştırdıktan
Re?	Re?
.	beradi.
Public	Public
Red	Red
Wants	qilmoqda
Your	Sizning
provides:	beradi:
or	yoki
Circumstances	holatlar
sailors	dengizchilar
activity	faoliyat,
If the	qilsa,
posters	plakatlar
changed	o&#39;zgargan,
people	odamlarning
&amp; Quot; Jonathan	&quot;Jonathan
html&gt;	html>
Flash	flash
thought	fikr
SPL	SPL
The role of	o&#39;rni
funded	moliyalashtirilgan
thin	ingichka
foo	foo
will	bo&#39;ladigan
classes	sinflari
as a result.	natijasidir.
COD	COD
---------------------	---------------------
swirl	girdap
approach.	yondashuv.
On the desktop,	stoli,
approach	yondashuv,
thoughts?	fikr?
POBox	POBox
won	kiritdi
Launched	Ishga
Illustrated	Illustrated
his son,	o&#39;g&#39;li
persons	shaxslar
At least	Kamida
issue	masalaning
The essence	mohiyati
baseball	beysbol
me	meni,
Jews	yahudiylarni
Ron	Ron
criteria.	mezonlari.
me	menga
We are interested in.	manfaatdormiz.
Lung)	O&#39;pka)
today	bugun
Now	Endi
stars	yulduzli
items	buyumlar
Crawford	Crawford
hand	qo&#39;lini
Prices	narxda,
defined	belgilab
within the framework of	doirasida
Talk,	munozara,
better)	yaxshiroq)
complex.	murakkab.
the list	ro&#39;yxatida
Lebannon	Lebannon
joy	quvonch
PowerBook	PowerBook
IMHO	IMHO,
HIGHER	OLIY
John,	Yuhanno,
CE,	Milodiy
high	baland
Historically,	Tarixan,
(Re:	(qayta:
year	yilning
or &amp; gt; &amp; gt ;,	bo&#39;lmasa&gt;&gt;,
transmission	uzatish,
export	eksport
New York,	Nyu-Yorker,
Jesus&#39;	Isoning
outgoing,	boruvchi,
struggle	kurash
Spot	Spot
are shown	ko&#39;rsatilgan
changed	o&#39;zgardi
Jew	Yahudiy
rings,	uzuk,
discomfort	noqulayliklarni
(5.25	(5,25
trace	asar
in winter	qishda
(J.	(J.
eccentricity	eksantrikliği
&#39;	»,
274-5357	274-5357
.	».
&amp; Lt; 1993Apr21.234159.1206@ualr.edu&amp;gt;	&lt;1993Apr21.234159.1206@ualr.edu&gt;
face	duch
only	yagona
seen	ko&#39;rmagan
&amp; Quot; Dracula &amp; quot;	&quot;Drakula&quot;
[Standard	[standart
area	maydon
wood	yog&#39;och
...]	...]]
Mass	Ommaviy
point,	nuqtasi,
prayer &amp; gt;	ibodat&gt;
(Edward	(Edward
week	hafta
basically	asosan
Regards,	Regards,
thick	qalin
Book	Kitobda,
discussion	muhokama
approximately	taxminan
scanner.	skaner.
geyser	geyzer
apply)	qo&#39;llaniladi)
Bring	keltirib
(Who	(kim
Matsui	Matsuo,
ask	so&#39;rash
Hockey	Xokkey
differences	farqlar
? &amp; quot;	oshiriladi?&quot;
close-up	yaqin-up
citizenship	fuqarolik
15-snake	15-ilon
Indonesia	Indoneziya
Department	departamentining
someone &amp; gt;	kimdir&gt;
All	Barcha
Columbia &amp; gt;	Columbia&gt;
Personnel	Xodimlar
sickle	o&#39;roq
decrypt	parolini
Bos	Bos
90%	90%
Request	So&#39;rov
video	video,
then,	keyin,
Montreal,	Monreal,
Or	Yoki
you do	qilayotgan
alternately	galma
hospitality	mehmondo&#39;stlik
facing	qaragan
files	fayllari
People	Odamlar
mission	missiya
young	yosh
unlucky	omadsiz
OpenLook	OpenLook
Such	Bunday
said.	aytiladi.
Vehical	Vehical
the effect of:	ta&#39;siri:
html>	sharma@tiger.vill.edu
intellectuals	ziyolilar
centuries,	asrlar,
the activities of	faoliyatida
&amp; gt;	ta&#39;sir&gt;
SPIE	trayektoriya
gravity	tortish
animals	hayvonlar
&amp; Lt; C5w5CB.Ct4@rahul.net&amp;gt;	&lt;C5w5CB.Ct4@rahul.net&gt;
video	video
(&amp; Lt; o &amp; gt;	(&lt;o&gt;
tourists	sayyohni
tail	quyruq
^^^^^^^^^^^^^^^^^^^^^^^^^^	^^^^^^^^^^^^^^^^^^^^^^^^^^
Can not find it.	topmadik.
(John	(John
.	ko&#39;rsatgan.
criminals	jinoyatchilar
sufficient.	qondiradi.
In addition,	Bundan
73	73,
He &amp; gt;	He&gt;
Friedman	Friedman
the key	kaliti,
the rule	hukmronligi
sent to	yuboriladi
a:	bir:
smaller,	kichikroq,
council	kengash
a	bir,
named	nomidagi
Station	Station
27.6	27.6
Thanx	Thanx
morals	axloqini
Salvation	Najotga
event	voqea
the crust	qobig&#39;ining
Log in	jurnallar
(But	(lekin
the Government of	hukumatining
Plans	rejalari
I am not &amp; quot;	emasman&quot;
profession	hunar
Lampoon_	Lampoon_
Asteroid	Asteroid
Selannes	Selannes
)	taqdim),
I&#39;d like.	izlayapman.
his brother,	ukasi
OLIVEIRA	OLIVEIRA
the use of	foydalanishni
One of the	biri
water and ice	suv-muz
and dived	sho&#39;ng&#39;idi
410-34-1	410-34-1
Software	Software
yogurt	yogurt
dynamic	dinamik
to pay	to&#39;lash
Hitter	Hitter
raised	ko&#39;tardi
on the floor	kata
pole	qutb
Speed	Tezligi
[It has been	[Bo&#39;ldi
The Board of	kengashi
Order	Buyurtma
&amp; Quot; Uran	&quot;Uran
700	700
703	703
force	kuchga
Relying on	tayanib
And	Va,
the server	serverda
Microsoft	Microsoft
Maplewood	Maplewood
created.	yaratilgan.
the elements	elementlarning
Kennedy	Kennedi
event	voqea,
DX)	DX)
visit	tashrif
from	dan
rest	dam
image	tasvirni
gas	gazni
&amp; Quot; optical	&quot;optik
I think)	o&#39;ylayman),
Cup	Cup
round	dumaloq
I &amp; gt;	I&gt;
Lee)	Lee)
Homosexuality	besoqolbozlik
ABI	ABI,
part of	tarkibiga
Nanaimo	Nanaimo
.	soni.
&amp; Lt; o &amp; gt;)	&lt;o&gt;)
&amp; Quot;	&quot;imkonini
area	maydoni,
Kennedy	Kennedy
temporary	vaqtinchalik
html>	cl056@cleveland.Freenet.Edu
(Spiros	(Spiros
seats	o&#39;rinli,
kulupush	kallapo&#39;sh
7.5	7,5
who believes	ishongan
.	ko&#39;rgan.
pitch	maydonga
profession	kasb
Moroccans	Moroccans
house	uyimni
,	ko&#39;rib,
Am I?	emasmanmi?
html>	&lt;1APR199313404295@skyblu.ccit.arizona.edu
1200	1200
200uf	200uf
Giant &amp; quot;	devi&quot;
vitamin	vitamin
drivers	haydovchilar
redraws	redraws
to speak	gapira
(61302	(61302
Ave	Ave.
Pseudo-medical	Psevdo-tibbiy
aircraft	samolyot
Accordingly,	ravishda,
the anger	g&#39;azabini
Henry	Henry
called	atalmish
prayer.	ibodat.
Whitten	Whitten
Explain	Tushuntirib
worship	ibodat,
mutters	ming&#39;irlaydi
html>	zbib@bnr.ca
html>	betel@camelot.bradley.edu
treatments	muolajalar
expanding	kengaymoqda
separate	ayrim
and.	va.
&amp; Lt ;,	&lt;,
The volume	hajmi
and,	va,
(IMHO)	(IMHO)
in the past,	o&#39;tmishda,
the words	so&#39;zlar
increased.	oshirildi.
McCord	McCord,
and!	va!
them	ularga
DOSKEY	DOSKEY
(My	(mening
layer	qatlam
home	home
MS-Windows	MS-Windows
Rocket &amp; quot;	raketa&quot;
Pentium	Pentium
was used	foydalanilgan
_outside_	_outside_
(Medicare	(Medicare
(National)	(Milliy)
Terror &amp; gt;	dahshat&gt;
html>	rauser@fraser.sfu.ca
the processes	jarayonlarini
wants	istaydi,
The experimental	empirik
HMMMMMMMMMMMMMMMMMMMMMMMMMMMMMMMMMMMMMMMMMMMMMMMMMMMMMMMMMMM	HMMMMMMMMMMMMMMMMMMMMMMMMMMMMMMMMMMMMMMMMMMMMMMMMMMMMMMMMMMM
File	Fayl
at	o&#39;zida,
Correction:	Tuzatish:
they	ularda
That	Deb
increased?	oshirildi?
laws	qonunlari
angry	badjahl
(Several)	(severy)
).	bor).
I think.	o&#39;ylayman.
I think)	o&#39;ylayman)
_him_	​​_him_
Ethics,	axloqiy,
next?	keyingi?
I think,	o&#39;ylayman,
Hiram	Xiram
Oberon	Oberon
homo	homo
.....	.....
Van	Van
flame	alanga
&amp; Lt; 2958804@QUCDN.QueensU.CA&amp;gt;	&lt;2958804@QUCDN.QueensU.CA&gt;
friction	ishqalanish
Office:	Office:
Rollaway	yig&#39;ilib
regional,	viloyat,
Wai-Ming	Wai-Ming
the world	dunyoda
without breaking	buzmasdan
icons.	ifodalaydi.
welcome.	olqishlaymiz.
licensed	litsenziyaga
cast	tashlashdi
I mean.	tutyapman.
lock	qulf
feature	xususiyati
esen	esgan
&amp; Quot; However,	&quot;Lekin,
sinusitis	sinüzit
neighbor	qo&#39;shnisidan
apology	uzr
Mags &amp; gt;	Mags&gt;
Terrorism)	Terrorizmga)
html>	gt7469a@prism.gatech.EDU
Frank	Frank
guess?	taxmin?
Prohibition	taqiqlash,
622121	622121
energy	energiya
Prices	narxlari
&amp; Lt; I	&lt;Men
places	joylardan
Program	Dastur
We,	biz,
In January,	yanvar,
science	fanining
beware	hazir
1978	1978,
differences	farqlarni
fans	muxlislari
picture	manzarani
estimated	taxmin,
effective	samarali
That is,	Ya&#39;ni,
fun	hazil
Kreiller)	Kreiling)
sent	yuborilishi
From	Dan
chart	sxema
aside from	chetda
Regio	Regio
&amp; Quot; Arab? &amp; Quot;	&quot;arab?&quot;
Automation,	uya
strong	kuchli
teaching.	o&#39;rgatish.
cratered.	cratered.
orbiters	orbiters
I think	hisoblayman
fans	muxlislar
html>	goolsbey@cs.utexas.edu
subject to	tortiladi
information	ma&#39;lumotni
750	750
Ford	Ford
except	tashqari
car	avtomobil
Aerospace	tipi
Faehl	Faehl
)	oladi)
,	oladi,
.	oladi.
base	tayanch
celebration	nishonlash
bodies	organlarning
VLB	VLB
32-bit	32-bit
Earth-sized	Earth-o&#39;lchamli
August	Avgust
iterated	bo&#39;lyapti
html>	king@reasoning.com
not.	emasligini.
road	yo&#39;l
world	dunyoni
486DX-33	486DX-33
no	yo&#39;q
4.0-4.3	4.0-4.3
systemic	tizimli
parameters.	parametrlarni.
flow	oqimi,
noise	shovqin
to drift	uzoqlasha
Cleopatra	Cleopatra
issued	beriladigan
Expenses.	ketadi.
They &amp; gt;	Ular&gt;
going	ketadi,
&amp; gt;	o&#39;tish&gt;
order	buyurtma
green	yashil
Mars	Mars,
Steve	Steve
VLX	VLX
break	tanaffus
R &amp; gt;	R&gt;
DLC	DLC
View	ko&#39;rish
processes	jarayonlarni
html>	blaisec@sr.hp.com
the schema	diagramma
VMS	VMS
Douglas	Duglas
accused of.	ayblashadi.
Sufficient	Etarli
Um,	Um,
Fahrenheit)	Farangeyt)
Pluto	Plutondan
window	darcha
&amp; gt; &amp; gt;	ekan&gt;&gt;
her	unga
Mock)	Mocker)
DMA	DMA
criticism	tanqid
MUTE	o`chirilishi
charge	zaryad
At that point,	nuqtada,
sermon	va&#39;z
Algorithm	Algoritm
Sorry,	uzr,
Landscape	manzarasi
(Hal	(Hal
Mitsubishi	Mitsubushi
speaking,	gapirib,
(Well	(Ham
----	----
chip,	yonga,
resurrected	tirilgan
write	yozish,
&amp; gt;	to&#39;liq&gt;
far	uzoq
(To be	(bo&#39;lishi
Jesus &amp; gt;	Iso&gt;
______________________________________________	______________________________________________
life	hayot
there.)	bor.)
improves.	yaxshilaydi.
In addition,	Tashqari,
&amp; Lt; May.12.04.27.47.1993.9935@athos.rutgers.edu&amp;gt;	&lt;May.12.04.27.47.1993.9935@athos.rutgers.edu&gt;
Her	Uni
When	berganda
opportunity	imkoniyat
Do you see?	ko&#39;ryapsizmi?
html>	ron.roth@rose.com
the environment	atrof-muhit
form	shakllantiradi,
Try	ko&#39;ring
the accuracy of	to&#39;g&#39;riligi
Teodor	Teodor
The second-order	ikkinchi-tartibi
is used	ishlatiladi
performed	bajarilgan
landed	qo&#39;ndi
orbit:	orbitasi:
&amp; Quot; Stephen	&quot;Stiven
pain	og&#39;riq
look	nazar
&amp; Quot; Borland	&quot;Borland
5500	5500
composition	tarkibi
Electric	Elektr
I thought	o&#39;yladim
Agriculture	xo&#39;jaligi
7.00	7.00
environment,	atrof-muhit,
(317)743-1394	(317)743-1394
fifth	beshinchi
ring	uzuk
The patient-physician	Kasal-tabib
Xelil	xelion
juliet	juliet
to live	yashashni
ideological	g&#39;oyaviy
140-165	140-165
knowledgeable	bilimdon
People	Kishi
the paper	qog&#39;ozga
state	davlatni
entrenching	kavlash
,	bo&#39;lishini,
(	(qayta
the window	derazadan
public-key	ijtimoiy-kalit
html>	batman@cisco.com
correction,	tuzatish,
(-290	(-290
such as	kabi
System	tizimi,
(Aaron	(Aaron
is there.	bor-ku.
easy	oson
(-298	(-298
log in	tizimga
(For example,	(masalan,
life	umr
Deportes	Deportes
system	tizimda
forms	shakllari
(Example)	(masalan)
walking	yurgan
staff.	mutaxassis.
The apparent	zohiriy
Diffie-Hellman	Diffie-Hellman
worlds	dunyolar,
Palestinians	Falastinliklar,
8.6	8,6
deserts,	sahrolarda,
the position of	lavozimidan
million	million
discover,	kashf,
extrapolation	ekstrapolyatsiya
life	hayotdirman
8.1	8.1
her	uni
dispute	munozara
Heads of	rahbarlari
The inventor	ixtirochi
Rosenau)	Rosenau)
That is,	Ya&#39;ni
President	Prezident
example.	misoldir.
actions	harakatlar
Modeling	modellashtirish
Select.	tanlang.
around	atrofida
observation	kuzatish
The reason	sababi
security	xavfsizlik
teams	jamoalarini
_____________	_____________
rivers	daryolar
We believe that.	ishonamiz.
Apollo	Apollon
in the form of	shaklidagi
(The Bible	(Bibliya
.	qolgan.
(NRSV)	(NRSV)
bush	butaning
Mr.	janob,
connected?	ulangan?
(Isaac	(Ishoq
Mouth	Mouting
8.1	8,1
ORIGINAL	ORIGINAL
HOW	QANDAY
The father	Otaning
connected)	ulangan)
html>	alane@microsoft.com
homosexuality	gomoseksualizm
hit &amp; gt;	hit&gt;
afronted	afronted
radio	radio
August	avgust,
attack	hujumga
closed	yopildi
Asteroids	asteroids
Critical &amp; gt;	keskin&gt;
orbits	orbitalari
radar	radar
Subsitute	DEVICEHIGH
measures	chora
Springs	Springs,
European	evropalik
scientists	olimlar
None UUNET	UUNET:!
&amp; Quot; Jews	&quot;Yahudiy
conditions	shartlar
The amount of	miqdori
NRA-certified	JPB-sertifikatlangan
the end	oxiri
Clr	Clr
heat	issiqlik
Earth	Yernikiga
flights	reyslar
blame	ayblashga
issues	masalalar
Stein	Stein
Howdy!	Howdy!
9.12:	9.128:
fusing	sintezlashga
Gretzky	Gretzky
pistol	to&#39;pponcha
slowdown.	pastlab.
then	unda
says	deydi
Her	Unga
DOS	DOS
window	deraza
islands	orollar
(Leonard	(Leonard
accusations	ayblovlarni
experience	tajriba
wronged	zulm
&amp; Lt; 1qvb5aINNmoi@darkstar.UCSC.EDU&amp;gt ;,	&lt;1qvb5aINNmoi@darkstar.UCSC.EDU&gt;,
event	tadbir
program	dastur
thanks	thanks,
(	(har
assets,	mavjudotlar
serial	seriya
time	vaqti
&#39;Temporary	«vaqtinchalik
propaganda	tashviqot
Microsoft	microsoft
The sender)	Jo&#39;natuvchiga)
established.	belgilangan.
are you going?	ketyapsan?
Egypt	Misr
Dept.	Deptt.
You &amp; gt;	Siz&gt;
the contents of the	tarkibini
David	Dovudni
Suffering	azob-uqubatlarga
to suffer	chekishi
,	belgilangan,
point	nuqta
on	bo&#39;yicha
Research &amp; quot;	tadqiqot&quot;
Christ &amp; gt;	Masih&gt;
(Michael	(Michael
heard.	eshitildi.
limited	cheklangan
countries	mamlakatlarda
will	boradi
care	g&#39;amxo&#39;rlik
territories	hududlar
utzoo!	utzoo!
remains.	qoladi.
remains,	qoladi,
Throwing	uchirish
guess)?	taxmin)?
expected	kutilmoqda,
Germany	Germaniya
,	ko&#39;rsatib,
perfect	mukammal
Illusions	illyuziya
I	qilamanki,
FAQ	FAQ
clinical	klinik
&amp; gt;	deb&gt;
.	turadi.
html>	sguerke@brahms.udel.edu
feathers	patlarni
html>	koutd@hiramb.hiram.edu
hut	kulba
lift-off	lift-off
CLEAR	CLEAR
new.	yangi.
new,	yangi,
faith	imoni
formed.	shakllantirdi.
V9R	V9R
denied	inkor
dead	o&#39;liklar
the benefit	manfaati
Saran	tuzoqqa
As.	kelsak.
Relations	aloqalar
center	markaziga
States	Shtatlarida
passengers	yo&#39;lovchilarning
three	uch
Stalin	Stalin
smart	aqlli
the sea	dengizda
. &amp; quot ;.	qanday.&quot;.
animal	hayvon
order	tartib
streams	oqimlarni
expedition	ekspeditsiya,
event	hodisa
AAS-92-186,	AAS-92-186,
both of	ikkovlari
time.	vaqt.
mountainous	tog&#39;li
not	bo&#39;lmadi,
Was	berdimi
The images	tasvirlari
Stronger,	Kuchliroq,
(Clear)	(aniq)
23-25).	23-25).
research	tadqiqot
sounds	tovushlar
mean?	degani?
quality	sifatli
korenek)	korenek)
committ	committ
sounds.	tovushlar.
prevent,	to&#39;sqinlik,
1/1000	1/1000,
birthday,	tug&#39;ilgan,
people	odamlar,
September	sentyabr
was born.	tug&#39;ilgan.
region	mintaqani
statement	bayonot
&amp; Lt; Rauser.734062608@sfu.ca&amp;gt;	&lt;Rauser.734062608@sfu.ca&gt;
he said,	deydi,
Order,	tartibi,
Back to	qaytish
Isaac	Ishoqning
in the center	markazida
means	degani,
on the road	yo&#39;lda
cutting	qirqish
Aili):	ailin):
he said.	deydi.
the rules	qoidalarini
lmouse	lmouse
evidence of character	dalil-belgilar
He says:	deydi:
time	vaqt,
mean.	degani.
time)	vaqt)
Six	Olti
(2,147	(2.147
(Independent	(Mustaqil
live	tirik
,	sabab,
hot	issiq
shame	uyat
Belin	kamari
package	paketini
Commission	komissiyasining
6.4	6,4
Using	foydalanib
have	ega
Martians	marsliklarni
the provisions of	qoidalariga
church	cherkov
Path	yo&#39;lga
99.9	99.9
(29.95)	(29.95)
being.	kelinmoqda.
The slowdown in	pastlab
It seems,	tuyuladi,
mind	aqlga
He stooped down	engashib
it seems.	tuyuladi.
the words	so&#39;zlarning
suit	kostyum
In 1972, the	1972-yilda,
Remember,	eslab,
However,	qaramay,
Banks)	Banklar)
Parallel	Parallel
If	bo&#39;lsangiz
html>	nelson_p@apollo.hp.com
see	ko&#39;rishni
People &amp; gt;	odamlar&gt;
(932	(932
Dorothy	Dorothy
.indiana.edu	.indiana.edu
candidate	nomzod
The law of	Qonuniga
after	so&#39;ng
use	foydalana
talk	gapirish
of yore	ota-
was	edi
game	o&#39;yin,
tremulous	zumga
ends	qutblari
always &amp; gt;	doim&gt;
6-7	6-7
funds	mablag&#39;lar
&amp; Quot; Konstantinov &amp; quot;	&quot;Konstantinov&quot;
saved.	saqlanadi.
&amp; Quot; blue	&quot;ko&#39;k
Pinturicchio	degandi
the range	oralig&#39;ida
truth	haqiqat
Radio	Radio
you&#39;ve	topganingizni
complexion	komplekson
factor	omili
Traces of	izlari
abrupt	keskin
the birth	tug&#39;ilganidan
qualifying	saralash
The law	Qonunning
I say. &amp; quot;	aytaman.&quot;
according to	muvofiq
enemy	dushman
THEWITNESS	THEWITNESS
Quorum	Quorum
the good news	xushxabarni
missions	missiyalar
POSTITION	POSTITION
calls	chaqiradi
&amp; Lt; _Atheism	&lt;_Atheism
false.	yolg&#39;on.
window)	oyna)
&amp; gt;	albatta&gt;
currents,	oqimlari,
waiiiiiit	waiiiiiit,
brothers	birodarlarga
However,	Biroq,
dedicated &amp; gt; &amp; gt;	bag&#39;ishlangan&gt;&gt;
Impedance	Empedans
You can!	mumkin!
atmosphere,	atmosferasi,
objects	ob&#39;ektlar
,	bo&#39;lgani,
)	mumkin)
especially	ayniqsa
Shostack	Shostack
to justify	oqlashga
&amp; Lt; ...	&lt;...
.	mumkin.
You can	mumkin,
The results of the	natijalari
You can:	mumkin:
Orientation	orientatsiya
Hughes	Hughes
Bakaev	Baqoevning
space	kosmik
(West	(g&#39;arbdan
You can?	mumkin?
used) &amp; gt;	qo&#39;llaniladi)&gt;
294-8153	294-8153
Johnson	Jonson
dialogue	muloqot
You can;	mumkin;
Ask	so&#39;ra
Montes	Montes,
information	ma&#39;lumotlarni
(900	(900
measurement	o&#39;lchash
In	ravishda
man	insonning
Three	Uch
belt,	kamar,
men,	erkaklarga
1200-1500	1200-1500
Holy	Ilohiy
geb@cadre.dsl.pitt.edu&amp;gt;	geb@cadre.dsl.pitt.edu&gt;
Homosexuality	Gomoseksualizm
I did not see	ko&#39;rmadim
6 :.	6:.
&amp; Quot;	&quot;qattiq
Stuffed &amp; gt;	tavba&gt;
Dodson	Dodson
building.	barpo.
VDC	VDC
McDONNELL	McDONNELL
Europeans	evropaliklarga
5X9	5X9
Windows,	Windows,
The exemption	istisnolar
held	o&#39;tdi
storms	bo&#39;ronlari
(Back)	(orqaga)
Landers	Landers
Mask,	niqoblangan,
gravel-sized	shag&#39;al-o&#39;lchamli
acid	kislota
Gary	Gary
basins	tog&#39;orani
children	bolalar
&amp; Quot; &amp; quot;	&quot;Foydalanuvchi&quot;
html>	vax839@tid.es
(Sanjeev	(Sanjeev
radar-mapping	radar-xaritalash
atom	atom
Bonds	Bonds
,	qabul,
html>	MLINDROOS@FINABO.ABO.FI
)	qabul)
land	quruqliklar
VGA	VGA
&amp; Quot; Our	&quot;Bizning
640	640
special	maxsus
determined	aniqlanadi
months	oylar,
)	bo&#39;lishi)
points,	sirlaridan,
armada	armada
Graphics	Graphics
documents	hujjatlarni
revolution	inqilob
donkey	eshak
Baptist	Baptist
Internal	Ichki
illuminate.	yoritib.
(JT)	(JT)
&amp; gt;	siz&gt;
award	mukofot
San Jose,	San-Xose,
Cliffs	uçurumlar
flame.	otash.
it seems	ko&#39;rinadi
justice	adolat
circles	doiralar
night	tun
Mercury,	Mercury,
encryption	shifrlash
good	yaxshi
sounds,	tovushlar,
full.	to&#39;la.
hears.	eshitsa.
gravity	gravity
Retrieved	olindi
is not.	bo&#39;lmaydi.
Marty	Marty
space	makon
not	bo&#39;lmaydi,
Atkinson	Atkinson
Voice:	Voice:
(JPL	(JPL
Drawing &amp; quot;	chizish&quot;
cooled,	soğutulur
-term	muddatli
486DLC 33	486DLC-33
not:	bo&#39;lmaydi:
numbers	sonlar
ships	kemalar
Brian,	Brian,
level	darajasida
correction	tuzatish
months	oylari
lights	chiroqlari
VHS	VHS
except)	mustasno),
peer	peer
to be;	bo&#39;lishi;
Learn	oling,
Houston	Houston
Round	Round
unknown	noma&#39;lum
Orange	Apelsin
650	650
.	oling.
.	bo&#39;lishi.
equipped	jihozlangan
the mission of	missiyasining
,	bo&#39;lishi,
FBI	FBI
record	o&#39;tishingiz
disappointment	umidsizlik
Zoology	Zoologiya
lava	lava
June	iyunda
quibble-	quibble-
more?	ko&#39;proq?
shot	otib
traditions	urf-odatlari
The main temperature	asosiy-haroratga
We know that.	bilamiz.
bombing	bombardimon
the beginning	boshidan
grain	don
servers	serverlardan
will	bo&#39;ladi
html>	km@ky3b.pgh.pa.us
.	oldi.
Information	Axborot
touched,	tegdi,
Sanjeev	Sanjeev
countries	mamlakatlaridan
dos	dos
we know?	bilamiz?
crown	tojni
extraterrestrial	dünyadışı
back,	qaytib,
infectious	yuqumli
nickel	nikel
throw	tashlaydi
Pelton	pelting
events	hodisalarni
&amp; Quot; objective &amp; quot;	&quot;ob&#39;ektiv&quot;
there is&quot;	mavjud»
rock,	rock,
(-366	(-366
dpi	dpi
html>	Nunnally@acs.Harding.edu
Students)	shogirdlari)
waving	silkitib
period	davr
kilo	kilogramm
third	uchinchi
American	American
screen	ekranda
windows	windows
Probably	Ehtimol
statistical	statistik
Art)	Bading)
Kids &amp; gt;	bolalar&gt;
probably	ehtimol
Siemon)	Siemon)
prophecies	bashoratlar
DoD	DoD
ask	so&#39;raymiz
unalterably	unalterably
iron	temir
ink	siyoh
disease	kasallik,
by.	tomonidan.
400dpi)	400dpi)
by	tomonidan,
Mishap	Aksiga
ninth	to&#39;qqizinchi
fine,	ingichka,
Logitech	Logitech
find	topish,
northeners	northeners
find.	topish.
contract	shartnoma
stations	stantsiyalari
space	fazoda,
FAX;	FAX;
Luke	Luqo
authority	hokimiyatga
In order to	maqsadida,
BUT,	LEKIN,
to know	bilish
straw	somon
keys.	kalitlari.
channels	kanallar
(Edmonton,	(Edmonton,
them	ularni
spiral	spiral
crash	blokirovku
.	o&#39;tdi.
On	Bo&#39;yicha
Specification	xususiyatiga
(Dave	(Dave
lost	yo&#39;qolgan
Information	Information
records	yozuvlarni
Contracts,	tanitadi,
yamaha	yamaha
auroras	auroras
I do not want!	istamayman!
&amp; gt; &amp; gt;	hisoblanadi&gt;&gt;
Brand)	Brenn)
helium	geliy
Tim	Tim
broadcast	efirga
Brenn	Brenn,
preparations,	tayyorgarlik,
used	ishlatiladigan
Anonymous	Anonim
information	ma&#39;lumotga
256k	256k
Witness over	shohiddir
previous	avvalgilaridan
loose	qimirlagan
signals	signallarining
giving	berib
to be	bo&#39;lishni
optilink	optilink
If the	ketsa,
html>	newsdesk@jplpost.jpl.nasa.gov
the clouds	bulutlarni
timer	taymerni
glow	qiziy
approach	yondashuv
&amp; Quot;	&quot;ma&#39;lumotlar
&amp; Lt; 1993Apr7.221357.12533@lamont.ldgo.columbia.edu&amp;gt;	&lt;1993Apr7.221357.12533@lamont.ldgo.columbia.edu&gt;
writers	yozuvchilar
there is;	mavjud;
Word	So&#39;z
funny	qiziq
&amp; Quot; &amp; quot;	&quot;foydalanuvchi&quot;
held;	o&#39;tdi;
red	qizil
mouse	sichqon
Step by step	asta-sekin
&amp; Quot; real &amp; quot;	&quot;real&quot;
gorges,	daralarda,
html>	stephen@orchid.UCSC.EDU
warm,	samimiy,
later	o&#39;tib
(Dostoevsky)	(Dostoevskiy)
limited	cheklangan,
open	ochiq
soft	yumshoq
sleep	uyqu
awareness	xabardorligini
Help	Yordamingiz
(Ie	(ya&#39;ni
1.00)	1.00)
skateboarding	kaykay
Dwarf;	mitti;
Bono,	Bono,
in the field,	sohasida,
active	faol,
Wanderers	Wanderers
(Negative	(salbiy
I got	oldim
We received	oldik
&amp; Gt; &amp; gt; &amp; gt;	&gt;&gt;&gt;
full	to&#39;liq
negative!	salbiy!
a statement	bayonotida
before	oldin
&#39;I	«Men
proof	isbot
poses.	tug&#39;diradi.
mountain	tog
wing	qanoti
originally	dastlab
-----------------	-----------------
pseudo-doctrine	psevdo-ta&#39;limotning
10:34	10:34
converted to	aylanadi
reports	hisobotlarni
completion	tugatish
doing	qilyapsiz,
impulse	turtki
Cassini	Cassini
lit	charog&#39;on
dedicated to	bag&#39;ishlanib
We,	Biz,
roof	tom
to whom	kishisiga
Since then,	beri,
Privacy &amp; quot ;,	maxfiylik&quot;,
Nuri	nuri
narrow	tor
Nereid	nereid
Male	Erkak
citizenship,	fuqaroligini
there is.	mavjud.
point	ochko
(Version	(Version
&amp; Gt;	&gt;
connection	aloqasi
reputable	e&#39;tiborli
Questions:	Savollar:
someone	kimgadir
(Henry	(Genri
10 &amp; quot;	10&quot;
Superficial	Yuzasining
remember	eslang
html>	schauf@iastate.edu
anti-trust	anti-ishonch
months	oylarda
promises	va&#39;dalar
World	Dunyo
Dividers	bo&#39;luvchi
Nevertheless,	Shunga
is	bo&#39;lgani
4/26/93	4/26/93
100K	100K
I think	o&#39;ylayman
Explorer &amp; gt;	Explorer&gt;
&amp; Gt; &amp; gt; &amp; gt; &amp; gt;	&gt;&gt;&gt;&gt;
Campus)	Campus)
Venusian	Venusian
Roof	Tom
being.	etilmoqda.
Luck	Omad
the existence of	mavjudligini
Lei)	Lei)
Christ	Masih
lie	yolg&#39;on
dangerous	xavfli
Comparisons?	taqqoslashlar?
2	2-ning
form	shaklda
100	100,
housing,	yashaydi,
Last	Oxirgi
put.	tushirildi.
1000	1000
Conservation	Saqlash
to plead	bahslasha
book,	kitob,
people	qavmiga
tool	vositasi
der	der
Alpha	Alpha
I do not like.	yoqtirmayman.
tube	kolba
home	uyda
In my opinion,	Menimcha,
dale	dale
)	dan)
from	dan,
functionality	funksiyalarini
Advice	Maslahat
Stolen	bila
html>	&lt;31MAR199321091163@juliet.caltech.edu
that	deb
)	bo&#39;lgan)
entered	kirdi
&#39;Club	»klubi
.	bo&#39;lgan.
marriage	nikoh
&amp; Lt; p00261@psilink.com&amp;gt;	&lt;p00261@psilink.com&gt;
that is,	bo&#39;lgan,
Luis	Luis
not &#39;	bo&#39;lmaydi»,
lower	quyi
right	huquqini
Smashed	çökerttiğini
Deviants	Deviants
personal	shaxsiy
XRaiseWindow	XRaiseWindow
7.3	7,3
it seemed.	tuyulardi.
orbits	orbitalarida
?	bo&#39;lgan?
Statistics	e&#39;lonlar
Preferences.	afzal.
shortcuts	yorliq
this	ushbu
homosexual	gomoseksual
USA	USA
representative.	vakili.
Hope	Umid
Representative,	vakili,
I did not	bermadi
11-15	11-15
behind	ortda
Yemen	Yamanda
One of the	Biri
excess	ortiq
sleeping	uxlab
wasteful	isrof
payment	to&#39;lov
contradictory	ziddiyatli
village	qishloq
stretch	esnetmeyi
stars	yulduzlar
approaching	yaqinlashib,
meteors	meteoritlar
Gilkes,	gilkey,
Comets	Kometalar
Dr.	Dr.
nickel-iron	nikel-temir
Proteus	protey
cheap	arzon
If	bo&#39;lsa,
&amp; Quot; dual	&quot;dual
&amp; Lt; defined	&lt;belgilab
Prompt	xohishi
LaStrange	LaStrange
If)	bo&#39;lsa)
young	yigit
////	////
default	default
fast	tez
and derivatives	sanab
html>	henry@zoo.toronto.edu
angry	g&#39;azablangan
stood.	turdi.
Lindroos	Lindroos
5 minutes	5-daqiqa
criminal	jinoyatchi
If?	bo&#39;lsa?
joule	joule
molecules	molekulalar
&amp; gt;	barcha&gt;
3511	3511,
Hair &amp; quot;	sochli&quot;
DOS;	DOS;
Fang	Fang
1024	1024
DOS6	DOS6
religion	din
WINDOWS;	WINDOWS;
traditional	an&#39;anaviy
remains	qoladi
dir	dir
Support	Support
Huh?	Huh?
Finney	Finney
if:	bo&#39;lsa:
Read	withs
theoretician	nazariyotchi
a person	shaxsni
shape	shaklga
devices	asboblar
&amp; quot;	qiluvchi&quot;
(High	(yuqori
Meteorites	Meteoritlarning
battery	batareya
Hui)	Hui)
significant	mazmunli
domain:	domen:
Focus	Lucifer,
ridicule	masxara
Wide	Keng
does not	olmaydi
entered	kirib
officials	mulozimlari
The results of	natijasi
who knows?	biladi?
real	haqiqiy
Dos	Dos
engaged	shug&#39;ullangan
ready	tayyor
mass	massasi
Who knows,	biladi,
Book	Kitob
scar	chandiq
buried	dafn
If you?	ekansiz?
years	yillar,
We will.	chiqamiz.
not &amp; gt;	olmaydi&gt;
the skin	terisini
Stop &amp; gt;	to&#39;xtatish&gt;
looking.	qidiraman.
plastic	plastik
John.	Jon.
Then,	O&#39;shandan
messages	xabarlarni
annual	yillik
the problem	muammoni
Understanding	anglashuv
what	narsaga
Economic	Iqtisodiy
neccities	neccities
Meteoroid	Meteoroid
altimeter	altimeter
component;	topgan;
myself	o&#39;zimni
OFF	OFF
&amp; Quot; Refresh? &amp; Quot;	&quot;Qayta-bildirdi?&quot;
Utility	Utility
Third	Uchinchi
construction	qurilish
paper	qog&#39;oz
put	qo&#39;yishdi
,	topgan,
meteors	göktaşları
Three-Way	Uch-Way
.	topgan.
traded	kotirovka
people	kishilar,
(Some	(ba&#39;zi
Buffalo	Buffalo
investigation	tadqiq
During the	chog&#39;ida
trillion	trillion
*************************	*************************
,	doirasida,
(Ron	(Ron
Magazine	Magazine
[PED]	[PED]
&amp; gt;	biri,&gt;
persecution	ta&#39;qib
(Steve	(Steve
Bloom,	Bloom,
Pseudo-teachers	Psevdo-o&#39;qituvchi
developed	chiqilgan
dawn	tong
no	hech
noise.	shovqin.
(Tobias	(Tobias
patients	bemorlar
I looked.	qaradim.
(Kirk	(Kirk
New	Yangi
clear	aniq,
therefore,	shuning
allocated	ajratilgan,
in all,	butun,
GOURMET	GOURMET
No	Yo&#39;q
Lee	​​Lee
rem	rem
against	qarshi
TIFF	TIFF,
writes: &amp; gt;	yozadi:&gt;
a dozen	o&#39;ndan
-428-0800	-428-0800
Catalog	KATALOG
simultaneously.	uzata.
the objectives of	maqsadlarini
(KJV)	(O&#39;ZMK)
John	John
Spencer)	Spencer)
astronauts	kosmonavtlar
Design]	dizayn]
Religion,	e&#39;tiqod,
Dave	Dave
the dead	o&#39;limdan
you	sizga
Europeans	yevropaliklardan
to find	topa
south	janubida
alive,	tirilmaydi,
Christians	xristianlar
earthquake	zilzila
-486-9975	-486-9975
ask.	so&#39;rang.
Offers	takliflar
Secondly,	Ikkinchidan,
belief.	e&#39;tiqod.
OK	OK,
He did not say?	demadi?
Arabs	arablarni
Department	boshqarmasi
Limitations	cheklashlar
OK.	OK.
factor	omili,
AMPS	AMPS
(Erkin	(Erkin
soul,	jon,
&amp; Quot; difficult &amp; quot;	&quot;qiyin&quot;
system	tizimining
such as-*	kabi-*
equipment	texnikasi
temperature	harorat
as	bo&#39;lib
(Bro	(Bro
around	atrofidagi
html>	rind@enterprise.bih.harvard.edu
Bure &amp; gt;	Bure,&gt;
&amp; Gt; &amp; gt; &amp; gt;	...&gt;&gt;&gt;
medium	muhit
layers	qatlamlari
Alan	Alan
&#39;	foydalanish»,
called.	deyiladi.
important	muhim
On the contrary,	aksincha,
Unlike &amp; gt;	o&#39;laroq&gt;
measured.	o&#39;lchanadi.
5X9 &amp; gt; &amp; gt;	5X9&gt;&gt;
because	axir
followed	ergashdilar
No	Hech
as-hot	as-issiq
Systems &amp; gt;	Systems&gt;
New	New
&amp; Quot; ^^^^^^	&quot;^^^^^^»
reasonable	oqilona
Cards &amp; gt;	karta,&gt;
ends	tugaydi
take	olmoq
&amp; Quot; homosexuals	&quot;gomoseksual
brought	keltirdik
rejected	rad
source	manba
&amp; Quot; cycle	&quot;aylanish
Switch	Switch
^^^^^^^^^^^^^^^^^^^^^^^^^^^	^^^^^^^^^^^^^^^^^^^^^^^^^^^
how	qanday
it has been:	bo&#39;ldi:
partial	qisman
it has been;	bo&#39;ldi;
Leifson)	Leifson)
future	kelajakda
entirely	butunlay
Human-Crewed	Inson-Mürettebatlı
it has been.	bo&#39;ldi.
Jewish &amp; gt;	yahudiy&gt;
approved	tasdiqlangan
it has been,	bo&#39;ldi,
Fellow	Yo&#39;ldoshlar
the characteristics of	xususiyatlarini
possible	iloji
The book	Kitobni
Faculty of	fakulteti
Typically,	Odatda,
next	keyingi
rom	rom
stars	yulduzlardan
giving	berib,
door	eshik
dominant	dominant
Workshop	Dastgoh
Sun	Quyosh
on the surface	yuzasida
expression	ifoda
Will	Will
Numbers &amp; gt;	raqamlari&gt;
role	rol
coated &amp; quot;	qoplangan&quot;
the presence of	huzurida
WNCI	WNCI
harsh	qattiqqo&#39;l
coin	tanga
sun	​​quyosh
parties	partiyalar
Do not confuse	aralashtirmang
(22,23	(22,238
the surface	yuzasiga
The works	asarlar
dir.	dir.
You think?	demoqchimisiz?
processes	jarayonlar
Again	Yana
Europeans	Ovropada
SKIING	SKIING
person	shaxs
.	taqdim.
&amp; Lt; mvanheyn@cs.indiana.edu&amp;gt;	&lt;mvanheyn@cs.indiana.edu&gt;
Whether	Whethe
Wizzard)	Wizzard)
you	sizlarning
balance	muvozanatga
teaches,	o&#39;rgatadi,
Which	Qaysi
UNIX	UNIX
Joel	Joel
years	yillar
&amp; Quot; secret &amp; quot;	&quot;sirlarini&quot;
html>	nagle@netcom.com
Ground	Ground
disk	disk
start	boshlanish
Explorer	Explorer
spirochetal	spirochetal
to build? &amp; quot;	qurishga?&quot;
NiCad	NiCad
If	bo&#39;lsa
Ottawa,	Ottava,
show	namoyon
packages	paketlar
Utopia	Utopia
below	quyida
the occasion	munosabati
you	sizni
palastenians	palastenians
Venus	Venera
ulysses.att..com	ulysses.att..com
Europa	Europa,
algorithm	algoritm
(Illegal	(Noqonuniy
&amp; Quot; SO &amp; quot;	&quot;SO&quot;
France	Frantsiya
covered	qoplangan
fields	bolgan
90% &amp; quot;	90%&quot;
&amp; Lt; 1qkoel$5fr@horus.ap.mchp.sni.de&amp;gt;	&lt;1qkoel$5fr@horus.ap.mchp.sni.de&gt;
is the proof?	isbotidir?
Columbia,	Columbia,
***************	***************
check	nazorat
entered	kirib,
part)	qismi)
previous	avvalgi
writes &amp; gt ;:	yozadi&gt;:
switched on	yoqilganda
Questions:	savolim:
part	qismi,
&amp; Quot; the Earth-Moon	&quot;Yer-Moon
crush	ezib
screen	ekran
visible	ko&#39;rinadigan
gaining.	qozonmoqda.
&amp; Quot;	&quot;Yangi
&amp; Quot; &amp; gt;	&quot;oldin&gt;
colleagues	hamkasblari
,	o&#39;tish,
installed	o&#39;rnatilgan
satisfies	qondiradi
adapter	adapter
survival.	omon.
Sciences	fanlari
1980	1980,
-rigth	-rigth
famous	mashhur
Bzzt!	Bzzt!
right	huquqi
destiny!	taqdir!
Timmons)	Timmons)
Timmons	Timmons,
Visual	Visual
they say;	derlar;
I do not want.	istamayman.
5-11,	5-11,
I do not want	istamayman,
following	quyidagi
Stephen	Stiven
tails	dumlari
html>	hrubin@pop.stat.purdue.edu
sufficient	etarli
Many	Ko&#39;p
the senses	hislar
Salah)	Salah)
principles	tamoyillari
arena	arenasi
Japan	Yaponiya
the camera.	suratga.
(Leong	(Leong
html>	martyj@mrcnext.cso.uiuc.edu
system	sistemasidagi
.	chiqilgan.
the church	jamoatini
cones.	konusning.
to go	o&#39;tishi
sons	o&#39;g&#39;illari
&amp; Lt; 1qnb9tINN7ff@rave.larc.nasa.gov&amp;gt;	&lt;1qnb9tINN7ff@rave.larc.nasa.gov&gt;
issues	masalalari
accuire	accuire
ergonomic	ergonomik
January	Yanvar
97.9	97,9
GSX-145	GSX-145
hurt	ozor
thousands	minglab
The observations	Kuzatuvlar
legal	qonuniy
oceans,	okeanlar,
COM1	COM1
My father	Otamning
Police	policha
Volcanic	vulkanlar
statements	bayonotlar
September	sentyabr,
Center	markazi,
Today	Bugungi
&amp; gt;	maqsadida&gt;
free	ozod
? &amp; quot;	yordam?&quot;
&amp; Quot; |	&quot;|
explosions	portlashlari
RESP.	RESP.
Mives	Mives
Control	Control
Husbands	erlar
trade	savdo
html>	cfaehl@vesta.unm.edu
hint	ishora
US &amp; quot;	AQSh&quot;
case	holatda
King;	shohi;
ideas	g&#39;oyalar
Enteritis	Enteritis
central	markaziy
html>	brian@gab.unt.edu
for sale	sotuvga
Place	joyi
valleys	vodiylari
prosperity.	gullab-yashnagan.
Canucks	Canucks
(Sam	(Sam
documents	hujjatlarida
combination	birikish
The motherboard	Anakart
living	yashayotgan
international	xalqaro
to distinguish	ajrata
loved	sevib
Livermore,	Livermore,
&amp; Lt; atheism	&lt;ateizm
Redelfs)	Redelfs)
html>	nstassen@magnus.acs.ohio-state.edu
to showcase the	vitr
to hear	eshitishni
ran	yugurib
god.	xudosi.
harmoniously	barkamol
enjoining	buyurish
followed.	ergashdilar.
god;	xudosi;
&amp; Quot;	&quot;
the will of the	irodasini
lots	uchastkalar
him	undan
The function	funktsiya
sun4nl	sun4nl
built.	qurilgan.
the oceans	okeanlarning
built,	qurilgan,
values	qadriyatlar
secretly	yashirin
elders,	oqsoqollar,
General &amp; gt;	umumiy&gt;
impute	imputs
HISTORY:	TARIX:
approval	tasdiq
love	sevgi
Electronics	Electronics
burned	yondirib
Shipment	etaklaydigan
the idea	fikrini
see	ko&#39;rmayapman,
I can not see.	ko&#39;rmayapman.
murder,	o&#39;ldirilishi,
This &amp; gt;	Ushbu&gt;
Powered	Powered
painted	bo&#39;yalgan
activity	faolligini
The Bible	Kitobda
the country	mamlakatni
(Or	(yoki
&amp; gt;	ta&#39;minlash&gt;
Astronomy	Astronomiya
For Sale	sotuvda
chip	chip
sins,	gunohlari
boil	qaynaydi,
krater	kraterlardan
fast-action	tez-harakat
Those who	keltirganlar,
snake,	ilon,
==========	==========
(Carl	(Carl
(DES	(DES
&amp; Quot;	&quot;edi
Law,	qonuni,
photoelectric	fotoelektr
BEFORE	OLDIN
Wagner,	Wagner,
taught	o&#39;rgatgan
Plains &amp; quot;)	Plains&quot;)
Coon)	Coons)
indifferent	befarq
article	maqolada
In the 17th century,	17-asrda,
that	ekan
Kars &amp; gt;	-Karl&gt;
chains,	zanjirlar,
your	sizning
the depths	qa&#39;riga
(Ncsc8!	(ncsc8!
Optical	Optik
object,	ob&#39;ekt,
html>	fang@en.ecn.purdue.edu
virginity,	bokiralik,
&amp; Quot; our	&quot;bizning
Sharma	Sharma
(Japan	(Yaponiya
rise.	tiriladi.
won	yutib
Waits	kutadi
Are there any?	mavjudmi?
appears	paydo
worth	arziydi
Decoration	bezatish
apartment.	doira.
user	foydalanuvchi
neighbors	qo&#39;shnilar
the work of the mill &amp; gt;	ish-of--tegirmon&gt;
&amp; Quot; Key	&quot;Klaviatura
conspiracy]	fitna]
documents	hujjatlar
Research	tadqiqotlar
circuit,	pallasida
stone	tosh
explain.	izohlash.
The god	Xudosi
spec&#39;d	spec&#39;d
pin	pimi
meet &amp; gt;	kutib&gt;
everything	narsani
live	yashashi
spread out	yoyib
camera	kamera
bisexual	biseksual
comp.sys.ibm.pc.hardware:	comp.sys.ibm.pc.hardware:
line	line
&amp; gt; &amp; gt;	o&#39;yin,&gt;&gt;
wants	istaganini
creative,	ijodimiz,
standing	turgan
contact	aloqada
Our	Bizning
saved	najot
year	yil,
reason &amp; gt;	negadir&gt;
pro-gun	pro-kun
(Bryan	(Bryan
HAWK	HAWK
medicine	tibbiyot
(Kevin	(Kevin
parents	ota-deb
thanks	minnatdorchilik
SCSI	SCSI
students,	talabalar,
it has been	bo&#39;ldi
design	dizayni
Do you want to?	xohlaysizmi?
Redeemer	Xaloskorimiz
Darryl	Darryl
disclosure	oshkor
On behalf of &amp; gt;	nomidan&gt;
doctors	shifokorlarga
rose from the	tirildi
shell	qobig&#39;i
the device	qurilmaning
Carlos	Karlos
doctors	shifokorlari,
regions	viloyatlariga
year	yili
cyanide,	siyanür
teaches. &amp; quot;	o&#39;rgatadi.&quot;
a little	biroz
&amp; Lt; &amp; lt;	&lt;&lt;
===	===
Collisions	to&#39;qnashuvning
someone	birov
Thomas	Thomas
Lyme	lyme
&amp; quot mind;	parvo&quot;
ethnic	etnik
returned.	qaytdi.
a	biror
RS-6903	RS-6903
Cheers	Cheers
GENIE:	GENIE:
roads	yo&#39;llar
translation	tarjima
place	joy,
82%	82%,
Potvin	Potvin,
Gosh..I	Gosh..I
html>	J.David.W.Reeves@dartmouth.edu
telescope	teleskop
corrupt	buzuq
Pioneer	Pioneer
html>	aep@world.std.com
AIR	HAVO
prescribed.	buyuriladi.
studied	o&#39;rganib
(1430	(1430
Ranger	Ranger,
incident	hodisadan
bench	zaxiradan
Canada	Kanadaliklar
&amp; Quot;	&quot;eng
agnostics	agnostik
&#39;A&#39;	«a»
Bentz	Bentz
man	odam
plains	tekisliklarni
published	chop
tafsir	tafsir
&amp; Lt;	&lt;
observed.	kuzatildi.
portion	bo&#39;lak
NATO	natonal
clean	toza
Suzuki	Suzuki
rule	qoidani
Spencer	Spencer
would	bo&#39;lar
Offers	Takliflar
bring.	keltirur.
supported	qo&#39;llab-quvvatlanadigan,
Planitia	Planitia
supported)	qo&#39;llab-quvvatlanadigan)
executive	ijro
the boundaries	chegaralarini
When,	yetganida,
!! &amp; Quot;	!!&quot;
Nor	Nor
things	narsalar
&amp; quot; &amp; gt;	oshiradi&quot;&gt;
question	savol
Winslow	Winslow,
boil,	qaynatiladi,
16804	16804
Good	Yaxshi
the body	tanasini
Perfect	Perfect
deserted	xilvat
AMPS	AMPS,
described.	tasvirlangan.
Venusian	​​Venusian
percent	foizini
(JPS)	(JPS)
How,	qanday,
consisting of	topgan
Wow!	QOYIL!
conception	g&#39;oya
try	sinash
monitoring	monitoring
lots!	uchastkalar!
covered.	qoplangan.
the public	jamoatchilik
_in	_in
waste	chiqindilarini
Management:	boshqaruvidan:
difficulty	qiyinchilik
Of	Of,
division	bo&#39;linish
Aspects	jihatlari
you	siz
(______________________________________)	(______________________________________)
Mining and girls	Tog&#39;-qizlar
heritage	meros
in the summer,	yozda,
who	bo&#39;lganlarga,
women	ayollar
PIN	PIN
over	ustida
10/82	10/82
Plateau	platosining
&amp; gt ;,	qilish&gt;,
dust,	tuproqdan
He looked at	qaradi
distinguishes	ajratadigan
Uranium,	Uran,
showed	ko&#39;rsatdi
&amp; gt;	narsa&gt;
Facts	Dalillar
html>	ekdfc@ttacs1.ttu.edu
this	shu
Book-lovers	Kitob-sevishganlar
(10,000	(10000
mystery	sir
basins	havzalari
countries	mamlakatlari
culture	madaniyat
4Runner &amp; gt;	4Runner&gt;
Oh,	Oh,
to solve	yechishga
machine	mashina
night:	kechishlari-uni:
able	qodir
Does &amp; gt;	undamayaptimikin&gt;
deep	chuqur
moons	yo&#39;ldoshlari
Now,	Endi,
cracks	yoriqlar
lost.	yo&#39;qotgan.
England	Angliya
Phone:	Telefon:
Callisto	Callisto
league	ligada
twitched	payini
referring to	tutayotgan
Space	Space
6/91	6/91
group	guruh
Canada	Canada,
Yemen	Yaman
upon	ustiga
(Jews)	(yahudiylar)
Christianity,	nasroniylik,
the earth-moon-sun	yer-oy-quyosh
00ECGILLESPIE	00ECGILLESPIE
fanatics	aqidaparastlar
leaves	yaproqlar
know.	bilurlar.
-14	-14
the world	dunyodagi
Straps &amp; quot ;.	keltirgani&quot;.
attention	diqqat
test	sinov,
Scharfy)	Scharfy)
wind	shamoli
sex	sex
All	barcha
hear.	eshitamiz.
lesbian	lezbiyen
&amp; Gt;	Barcha&gt;
2230	2230
imitation	taqlid
PMS	PMS
shown	ko&#39;rsatildi
rocks	qoyalar
&amp; Quot; licensed	&quot;litsenziyaga
Services	Services
boil	qaynatiladi
I did not see.	ko&#39;rmadim.
(Right	(o&#39;ng
&amp; gt;	buyon&gt;
(Computer	(Computer
crypto	kripto
I did not see,	ko&#39;rmadim,
and threw it into the long-	uzoq-uloqtirdi
Franjione	Franjione
HOMOSEXUAL-	HOMOSEXUAL-
&#39;Facts&#39;	«dalillar»
Kaufman)	Kaufman)
Telecope	Telecope
together	birga
&amp; Quot; &amp; quot;	&quot;qabul&quot;
In principle,	me&#39;yor
few,	necha,
ascription	surilsa,
Edwin	Edwin
What &amp; gt;	nima&gt;
you	sen
flood	sel
whole	butun
colors	rangdagi
line	chiziq
collided.	to&#39;qnashib.
mph)	milya),
that	ekanligini,
at least	bo&#39;lmaganda
if	agar
persons	shaxslarni
implied,	shama,
AMI	àmì
foreign	chet
swollen,	shishgan,
prison	qamoqda
Ludwick &amp; quot;	Ludwick&quot;
The roots of	ildizi
Jewelry &amp; gt;	jamoa&gt;
something	nimadir
&amp; quot;	qiling&quot;
Kentucky	Kentukki
Christians	masihiylar
knowledge	bilimga
(Andrew	(Andrew
implied;	shama;
(3,010	(3,010
Dual	Dual
(-184	(-184
photocell	fotosel
amino	amino
harvest	hosil
Where)	qaerda)
Look	sol
&amp; Gt;	Deb&gt;
evidence	dalil,
place	joyida
payable	to&#39;lanadigan
chronological	xronologik
plane	tekisligiga
license	litsenziya
Clark	Klark
---	---
pure	sof
Use	foydalaning
say	aytish
Ryan	Ryan
people	kishilar
Where	qaerda,
(&amp; Quot; Gold	(&quot;Oltin
Hoffman	Hoffman
Theme	themon
I think	menimcha
sex)	sex)
korean	korean,
.	qilgan.
,	qilgan,
&amp; gt;	bo&#39;yicha&gt;
Two	Ikki
Core &amp; gt;	majbur&gt;
Shopping	Xarid
Celsius	Selsiy
;	qilgan;
Santa	Santa
Size:	Hajmi:
to understand	tushunishga
Manuals	qo&#39;llanmalar
sunset	botganidan
&amp; Quot; Lyme	&quot;Lyme
Stanza	Stanza
criminal	jinoiy
behavior	axloq
Legality	êonuniyligi
commercial	tijorat
study,	o&#39;rganish,
a &amp; gt;	a&gt;
Level	Daraja
stained.	ligini.
of patients	bemorlarning
produces	chiqaradi
rumors	mish-mishlarni
Multiprobe	Multiprobe
--clh]	--clh]
left	chap
&amp; Lt; C5r60r	&lt;C5r60r
COM &amp; gt;	MAQOMOTI&gt;
___	___
rumors	mish-mishlarga
Applications	dasturlar
yourself	o&#39;zingizni
movement	harakatini
It does not.	qilmaydi.
It does not,	qilmaydi,
alternatively,	muqobil,
International	Xalqaro
1993	1993,
as well as	qatorda
floppy	floppi
premature	bevaqt
League,	Ligasi-da,
Stars &amp; quot;	Stars&quot;
Altima	Altimas
acts	hujjatlariga
Read on.	bering.
Candida	Candida
Thanks	Thanks
Read	bering,
Theos	Theos
all	hammangiz
charging	zaryadlash
&amp; Quot; &amp; quot;	&quot;Ular&quot;
cryptoanalysis	cryptoanalysis
&amp; Quot; Geiger	&quot;Geiger
system	tizimidagi
indication	ko&#39;rsatilib
Corp.	Corp.
sweep	supurib,
DPJ	ligalari
Read on!	bering!
html>	adam@das.harvard.edu
Wendy	radioed
William	William
curious.	qiziquvchan.
simmer	pishirib
Motherboard	Motherboard
Jupiter	Yupiterning
issues	muammolar
Lauria)	Lauria)
real	real
a one-	bir-biriga
stare	qotib
Justification:	dalil:
watch	kuzatib
possession	egalik
articals	articals
website	ayting
html>	daviss@sweetpea.jsc.nasa.gov
, and	qilinib,
show	ko&#39;rsatib
The use of	foydalanish
from the	kelgan
revealed	nozil
19947	19947
sensitive	nozik
forsale	forsale
Altima	Altima,
Though	Biroq
Baptism &amp; gt;	cho&#39;mish&gt;
^^^^^	^^^^^
Georgetown,	Jorjtaun,
-scale	ko&#39;lamli
Controllers	Kontrollerlar
Packages &amp; quot;	paketlar&quot;
Gen3:	Gen3:
&#39;S	&#39;s
PCX	PCX
doctors	shifokorlar,
names	nomlari
(Air)	(havo)
teams	jamoalar,
Floppy..BURN	Floppy..BURN
surprised.	hayron.
a requiem	xotirlash
warranty	kafolat
equator	ekvator
wills	xohlagan
isolator &amp; quot;	isolator&quot;
Out	Out
better	yaxshiroqdir
&amp; gt; &amp; gt;	oshiriladi&gt;&gt;
There	There
completed.	yakunlandi.
to sit	o&#39;tirib
Straw	strawman
27611@athos.rutgers.edu	27611@athos.rutgers.edu,
killed	halok
The world	Dunyodagi
96.5	96,5
html>	folta@zen.holonet.net
Colorado	Kolorado
issue	masala»
Skelton	Skelton
leg	oyoq
the joint	hamkorlikdagi
receive	olishingiz
The teams	jamoalari
-oOOO	-oOOO
html>	astein@nysernet.org
deal	shug&#39;ullanish
worthy	loyiq,
The lack of	etishmasligi
POWDER	KUKUNI
,	qildi,
.	qildi.
God	xudo
^^^^^^^^^^^^^^^^^^^^^^^^^^^^^^^^^^^^^^^^^^^^^	^^^^^^^^^^^^^^^^^^^^^^^^^^^^^^^^^^^^^^^^^^^^^
the resurrection	tirilishiga
The son	O&#39;g&#39;li
side	tomoniga
things	narsalardan
html>	sharma@monet.vill.edu
clutter	dağınıklığı
Kolodny	Kolodny
(Dick	(Dick
ring	halqa
Galilean	jalilalik
BMP,	BMP,
html>	sguerke@ravel.udel.edu
default	ko&#39;rsatuv
mirror	oyna
corrected	tuzatilgan
OTOH,	OTOH,
Oliveira	Oliveira
On behalf of the	nomidan
Hollows	chuqurliklarda
turned	aylantirilayotgan
GMT	GMT,
html>	kfrank@magnus.acs.ohio-state.edu
team	terma
expeditions	ekspeditsiyalar
among	orasida
Since the	buyon
9600	9600
life	hayotda
thermo	termo
question,	savol,
automated	avtomatlashtirilgan
inspection	tekshirish
message	xabarni
expense	hisobiga,
html>	hans@xelion.nl
characteristic	xarakterli
support	qo&#39;llab-quvvatlash
other	boshqa,
Fallout	Fallout
User	Foydalanuvchi
edges	hoshiyali
I have	qildim
condition,	holatini,
bedroom	yotoqxona
one who	kimsadan
history	tarixini
SMARTDRV	SMARTDRV
Williams,	Williams,
a soft-spoken	yumshoq-og&#39;zaki
Son	O&#39;g&#39;il
sea	dengiz
side	tomonida
Categories	kategoriyalari
The tradition of	odati
means	ma&#39;noni
second	soniya
issue:	masala:
Jinnimisiz_?	Jinnimisiz_?
&amp; Quot; target	&quot;maqsad
military	harbiy
&amp; Quot; proof-texting &amp; quot;	&quot;dalil-manifatura&quot;
court	sud
League	ligasi
between	orasiga
plan	reja
Frank)	Frank)
Accelerator	Accelerator
water	suv
past	o&#39;tgan
Used	Ishlatilgan
kind of	turdagi
Accord	Accord
the first	dastlabki
force	kuch
logical	mantiqiy
In order to	maqsadida
html>	holsend@mhd.moorhead.msus.edu
Define	belgilang
made	yasalgan
the sky.	osmon.
victory	g&#39;alabaga
cyphers	cyphers
(Robert	(Robert
&amp; quot ;, witness	shahodat&quot;,
dookie	dookie
Sharing	almashish
Deceiver	ketkazguvchi
,	oshirmoq,
whose	kimning
FORSALE	FORSALE
etc,	hokazo,
Callisto	Callisto,
KALDILDI	Kaldis,
to leave	ketmaslik
section	bo&#39;limida
Press-Democrat	Press-demokrat,
Answer	Javob
hit	urdi
etc.)	hokazo)
schedule	grafigini
article	maqolada,
great	buyuk
Satellite,	yo&#39;ldosh,
Slot	Slot
change	o&#39;zgarishi
===========================================	===========================================
WP51	WP51
did you?	bordingizlar?
wind	shamol
netters	fırlatıcısı
the resurrection	tirilishini
the moon	oyga
&amp; Lt; 1993Apr22.153959.12328@ucsu.Colorado.EDU&amp;gt;	&lt;1993Apr22.153959.12328@ucsu.Colorado.EDU&gt;
thee	sendan
10000	10000
found.	topilmadi.
changed	o&#39;zgartirilgan
(125	(125
The meaning of	ma&#39;nosi
ax	bolta
recognized	tan
for example).	aytaylik).
)	qadar)
(JPL)	(JPL)
Darn	Darn
so,	qadar,
Dark	Dark
(1500	(1500
fictitious	soxta
light	engil
cleaning	tozalash
For example,	Masalan
behavior	xulq
created	yaratgan
The former	Avvalgilar
the heavens	osmonlaru
also	shuningdek
Mother	Ona
Lawrence	Lawrence
&amp; gt;	faqat&gt;
One	One
free	bepul
I do not know,	bilmayman,
I do not know.	bilmayman.
handed	uzatdi
family	oila
to know	bilmoqchi
democratic	demokratik
deck	kemaning
megatest.com &amp; gt;	megatest.com&gt;
See	qarang
attack	hujum
insurance.	sug&#39;urta.
increasing	o&#39;sayotgan
&amp; Lt; C5DxBs.5ov@panix.com&amp;gt;	&lt;C5DxBs.5ov@panix.com&gt;
****	****
(12v	(12v
eventually	oxir-oqibat
Somebody	Kimdir
liscenced	liscenced
&amp; Lt; 1r9j33$4g8@hsdndev.harvard.edu&amp;gt;	&lt;1r9j33$4g8@hsdndev.harvard.edu&gt;
PS:	PS:
Rent	berish
practitioners	amaliyotchilar
The probe	prob,
State	shtati
world	dunyo
the transistor?	tranzistor?
not	olmaydi,
look	qarash
suddenly	to&#39;satdan
Pseudo	Psevdo
Encryption	kriptografiya
(175	(175
html>	NUNNALLY@acs.harding.edu
[...	[...
solid	qattiq
using.	foydalanib.
Meanwhile,	Hozircha,
angles.	yuritadigan.
somebody	kimdir
html>	psyrobtw@ubvms.cc.buffalo.edu
Using	foydalanib,
appearance	ko&#39;rinishini
said,	aytib,
(RvKampen)	(RvKampen)
!!!!	!!!!
not.	olmaydi.
I did not hear	eshitmadim
window	window
Dayton,	shtatining,
Phil	Phil
people	insonlar
ignition	chaqnash
As a result of	natijasida
combined	kombinatsiyalangan
the purpose of	maqsadini
... &amp; Gt; &amp; gt; &amp; gt; &amp; gt;	....&gt;&gt;&gt;&gt;
rare	kamdan-kam
disk	diskda
referred to	nomlanadi
U &amp; gt;	U&gt;
Dana	Dana
html>	banschbach@vms.ocom.okstate.edu
Willis)	Willis)
driver	drayverini
days	kundan
Americans:	Amerikaliklar:
October,	oktyabr,
PTO	PTO
area,	sohada,
The discrepancy	nomuvofiqlik
large	yirik
logically	mantiqan
As mentioned,	aytilganidek,
(Tim	(Tim
(Pluto	(Plutondan
Center	markazi
plotting	hiylalari
^^^^^^^^^^^^^^^^^^ &amp; Gt;	^^^^^^^^^^^^^^^^^^&gt;
in history	tarixida
the size of the	hajmini
interest	qiziqish
anhumâ	anhuma
Now,	Keling,
that&#39;s,	yotipti,
servers	serverlarida
Christian &amp; gt;	masihiylar&gt;
nitrogen	azot
phosphorus)	fosfor)
cautious	ehtiyotkor
installation,	o&#39;rnatish,
that&#39;s it!	yotipti!
14-19?	14-19?
radar	radar,
View	View,
I do not see	ko&#39;rmayapman
torment	azob
&amp; Quot; surface	&quot;yuzasida
that&#39;s)	yotipti)
signs	oyat
Point	Point
Here,	Mana,
interest	foiz
sins	gunohlarimiz
html>	toml@boulder.parcplace.com
kenyee	kenyee
eastward	sharqqa
We are	biz
bit	bit
Mice	sichqonchani
20-39	20-39
one	bir
the pointer	markerni
investments	qo&#39;yilmaydigan
(Gregh@niagara.dcrt.nih.gov)	(gregh@niagara.dcrt.nih.gov)
protection.	himoya.
protection	himoya,
9.25	9.256
....	....
The definition of	ta&#39;riflarni
Does it?	qiladimi?
samples	namunalari
&amp; gt;	qilingan&gt;
exeption	exeption
orbit	orbitasida
...:	...:
interview	intervyusida
Munnar)	Munns)
(39.95)	(39.95)
prepares.	tayyorlaydi.
...?	...?
Television and Radio	Teleradiokompaniyasi
&amp; gt;	uning&gt;
,	qoldi,
later	keyinchalik
&amp; gt;	ostida&gt;
.	qoldi.
particles	zarralar
(Tom	(Tom
(Oo)	(Assalamu)
Italy	Italiya
others	boshqalarga
adjustable	sozlanishi
Concern	Xavotir
go	ketishiga
Witness:	shohiddir:
perceptions	hislarni
style	uslubi
Comments?	Fikr?
ethical	axloqiy
better &amp; gt;	yaxshiroq&gt;
Barman)	Bormon)
exchange rate	kurs
Dover	urib
Allen	Allen
Goolsbey)	Goolsbey)
Tampa,	Tampa,
degree	gradus
chapter	bob
Personal	Shaxsiy
(486-33DX	(486-33DX
flows	oqimlari
-Arlo	-Arlo
Florida	Florida
Novices	yangilar
Car	Avtomobil
Interested in	qiziqtiradigan
justified &amp; gt;	oqlanadi&gt;
Surprising	Ajablanarli
(No	(no
officially	rasman
bicycle	velosiped
(1100	(1100
known.	tanilgan.
maybe	balki
health	sog&#39;lig&#39;ini
particles	zarrachalar
classical	klassik
prepared	tayyorlangan
Cache	kesh
QUACK	QUACK
...)	...)
technical	texnik
Jozef	Jozef
back door	orqa-eshik
Engineering	muhandislik
The earth	Yerdagi
successive	izchil
damage)	zarar)
heavy	og&#39;ir
burned	yoqib,
Second	Ikkinchi
Cuesta)	Cuesta)
chemistry	kimyo
(Frank	(Frank
&amp; Lt; C4vG3F.Kx3@apollo.hp.com&amp;gt;	&lt;C4vG3F.Kx3@apollo.hp.com&gt;
thing.	narsadir.
Earlier,	Avvalroq
voltage	kuchlanish
loving	mehribon
Deimos	Deimos
that	qiladigan
scourge	qamchilash
Cypher	Cypher
supply	ta&#39;minoti
&amp; Quot; non-different &amp; quot;	&quot;non-turli&quot;
&amp; Lt; 93095@hydra.gatech.EDU&amp;gt;	&lt;93095@hydra.gatech.EDU&gt;
Hiroki	Xiroki
Although,	bo&#39;lsa-da,
lightning	chaqmoq
though.	bo&#39;lsa-da.
agreements	bitimlar
I can.	olaman.
heterosexual,	heteroseksüel,
Attracting	Jalb
html>	caldwell8102@mtroyal.ab.ca:
There are	bor
html>	whitsebd@nextwork.rose-hulman.edu
Hite	HITEN
rich	boy
html>	Rauser@sfu.ca
talip	talip
bolt	murvat
Turn	yoqing
the distance	masofada
chocolate	shokolad
corner	burchakda
4runner	4Runner
now	hozirda
pace	suratini
chip-set	chip-majmui
sense	ma&#39;noda
transformers	transformatorlar
(This	(bu
given	bergan
wide	keng
Delaware	Delaver
Planet	Sayyora
&amp; Lt; 1993Apr21.032427.22464@leland.Stanford.EDU&amp;gt;	&lt;1993Apr21.032427.22464@leland.Stanford.EDU&gt;
the occupation	ishg&#39;ol
Christians	masihiylarni
writing	yozishni
evening	kechqurun
computergenerated	computergenerated
day)	kun)
The planet	Sayyoramiz
Rental	Ijaraga
_your_	_your_
&amp; Quot; Robert	&quot;Robert
like.	o&#39;xshaydi.
innocent	begunoh
It	Bunga
the pieces	bo&#39;laklari
Cure	Davolash
concern	tashvish
tops.	toplar.
geology	geologiya
lights	chiroqlar
.	foydalanish.
meaning	ma&#39;noga
(Bentz.e.puryear)	(bentz.e.puryear)
We believe in	iymon
&amp; Quot; &amp; quot fulfilled;	&quot;bajo&quot;
to fly.	uchadi.
(Portable):	(Portable):
Tendon	Pay
the amount of	miqdorda
expensive,	qimmat,
expensive.	qimmat.
foreign	xorijiy
Stereo	Stereo
use:	foydalanish:
works	ishlaydi
If the &amp; gt;	qilsa&gt;
Wells	Wells
price	narx
Voyager	Voyager
miscommunication	miscommunication
Hebrews	Ibroniylarga
official	rasmiy
life	hayoti,
***	***
html>	gchin@Eng.Sun.Com
Although it seemed,	tuyulardi-da,
right &amp; quot;	o&#39;ng&quot;
Personally,	Shaxsan
strong &amp; gt;	puxta&gt;
flybys	flybys
Like .....	yoqdi.....
Rick.	Rick.
APPRECITATED	APPRECITATED
circuits,	davrlari
:	qiladi:
House	House
(Claudio	(Klaudio
comet	kometa
&amp; gt;	harakat&gt;
?	qiladi?
Utah	yutadi,
neighbors	qo&#39;shnilarining
mission	missiyaning
the distance	masofaga
current	hozirgi
Mr.	janob
spit,	tupurib,
believe.	iymon.
&amp; gt;	tomonidan&gt;
,	qiladi,
.	qiladi.
now	hozirga
Radioactive	Radioaktiv
HIMEM.SYS	HIMEM.SYS
named	ismli
The knowledge of	ilmi
all	hammamiz
&amp; gt;	kabi&gt;
life	hayotga
article	maqolasida
to crack	yorilish
Reckless	orêasida
discs	disklar
&amp; Quot; satellites	&quot;yo&#39;ldoshlarini
will be displayed.	ko&#39;rsatiladi.
Masses	Massalari
arrogant	mutakabbirlik
The dawn	tonggi
nuclear	yadroviy
Now &amp; gt;	endi&gt;
The descendants	avlodlari
Chrysler	Chryse
Christian&#39;s	Masihiyning
ship	kema
radioisotopes	radyoizotopların
I would like to.	istardim.
telephone	telefon
demand	talab
Legge	Legge
day	kuni
80111	80111
The term of	muddati
Conversions	davrlarini
Verbatim	Verbatim
&amp; Quot; healthy &amp; quot;	&quot;salomatlik&quot;
words	aytganda
meeting	uchrashuv
social	ijtimoiy
scientific	ilmiy
Paul	Pavlus
Since	beri
primarily,	navbatda,
rules,	qoidalari,
difficult).	qiyin).
Can you	bera
writes	yozadi
pop	pop
______________________________________	______________________________________
sounded	yangradi
&amp; Quot; Christian &#39;	&quot;Christian»,
Allah,	Allohning
orbit	orbitaga
mountainous	tog&#39;li,
site	saytidan
arrogance	takabburlik
on the basis of	asosida,
Mobile	Uyali
regulations	qoidalarga
landscape	landshaft
trials	sinovlarni
Simple &amp; gt;	oddiy&gt;
built	qurilgan
Claudio	Klaudio
will	qiladi
RAM	RAM
Computer	Computer
Testament,	Ahdda,
The definition of	ta&#39;rifi
practice	amaliyotini
The secret of	siri
space	kosmosda
Gas,	gaz,
it	buni
or &amp; gt;	yoki&gt;
61153	61153
surface	sirt
to come	kelib
(Family	(Oila
Day of Resurrection	qiyomat
Shapiro	Shapiro
god	iloh
&amp; gt;	uchun&gt;
Mexico,	Meksika,
exactly	aynan
used	ishlatilgan
resources	resurslarni
reasons	sabablar
Atheism	Ateizm
any	biron-bir
space	kosmosga
sinner	gunohkor
:	keladi:
.	chiqildi.
pulse	urish
function.	vazifasi.
Chips	Chips
Nunnally	Nunnally
without	turib,
.	keladi.
five	besh
you	sizlar
,	keladi,
Miss	miss,
prices	narxlar
as well as,	shuningdek,
(But	(balki
investment	sarmoya
583 &amp; gt;	583.&gt;
crews	ekipajlari
left.	qoldirganmiz.
&amp; Quot; light	&quot;charog&#39;on
all	hamma
hype	hype
particles,	zarralar,
the company?	kompaniya?
800m	800mA
In short,	aytganda,
cause	sabab
agnostic	agnostitsizm
And 2	2-va
he said.	dedi.
62.4	62,4
observed	kuzatildi
periods	davrlarida
(	(eng
falls	tushadi,
he said,	dedi,
arrived	keldi
oceans	okeanlar
&amp; Quot; human &amp; quot;	&quot;gumanitar&quot;
Examples	misollar
said?	dedi?
covered.	qoplandi.
methane	metan
plays	tutadi
Ethics &amp; gt;	axloq&gt;
&amp; Quot; D &amp; quot;	&quot;ilmiy&quot;
six-	six-
mainstream	mainstream
example	misol
Faulting	yoppasiga
driving?	haydash?
Allah	Alloh
others	boshqalar
Windows	Derazali
keyboard	klaviatura
Compare?	solishtiring?
Ganymede	Ganymede
contrary	zid,
bitnet	bitnet
rang.	yangradi.
swarm	to&#39;dasi
7.329	7,329
Sabres	Sabres
html>	dans@uxa.cso.uiuc.edu
(They	(ular
&amp; gt;	hech&gt;
people	kishilarning
-------------------	-------------------
report	xabar
,	ruxsat,
Study &amp; quot;	Study&quot;
.	ruxsat.
Wake up	Uyg&#39;onish
distrust	ishonchsizlik
(Cargo	(yuk
The main window	Ota-window
cigarette	sigareta
________)	________)
We &amp; gt;	Biz&gt;
the treatment	davolashda
*******************	*******************
tight	zich
model	modelga
Warehouse	QXI
mechanic	mexanika
Company	Company
down.	pastga.
put.	qo&#39;yildi.
Enter the	kiriting
a	bir-bir
In the process	jarayonida
Ionosphere	İyonosfer,
(Microsoft	(Microsoft
you	siz,
Haley	dumli
Wings	Wings
play	o&#39;yin
Nitrogen	Azot
ultrahigh-resolution	ultrahigh-qaror
is mapped	eşleştirilir
X3153	X3153
headaches	og&#39;riqlari
WINDOWS	WINDOWS
Goons	goon
The surface	Sirt
&amp; Lt; ekdfc.14.0@ttacs1.ttu.edu&amp;gt;	&lt;ekdfc.14.0@ttacs1.ttu.edu&gt;
electronics	electronics
thick	qalin,
&amp; Quot; &amp; quot;	&quot;bosh&quot;
(Dual	(dual
the development	chiqilishi
&amp; Lt; Fenton@Kaleida.Com&amp;gt;	&lt;Fenton@Kaleida.Com&gt;
Chin)	Chin)
canyons,	kanyonlar,
Bos)	Bos)
intercede	shafoat
error)	xato)
gosh	gosh
,	berilgan,
.	berilgan.
&amp; quot;	oshiradi&quot;
Hate	Xotami,
Finland	Finlyandiya
version	versiyasini
Similar	O&#39;xshash
Avenue	Avenue
three,	uch,
relations	munosabatlarni
account.	hisobga.
Money	Pul
three.	uch.
This	bu,
Arabic	Arabic
(SF	(SF
(Re	(Re
Ishtar	Ishtar
Treaty	shartnomasi
Symmetrical	nosimmetrik
usual	odatiy
say	ayta
(No	(No
It&#39;s not,	Emas,
changed.	o&#39;zgardi.
money	pul
shooting	tortishish
(P.	(P.
&amp; gt;	so&#39;nggi&gt;
Spiros	Spiros
enter	kiritish
Foundation	Foundation
B2: &amp; gt;	B2:&gt;
dedicated.	bag&#39;ishlangan.
The grounding	Topraklama
romantic	romantik
Neptun	Neptun
1Meg	1Meg
Low &amp; gt;	past&gt;
started	boshlangan
Questions	savollar
space	makon,
to be	atalishga
mark	belgisi
shame.	sharmandalik.
bus	avtobus
close	yaqin,
GAP)	gap)
Titania	Titania
Audio	Audio
386DX-40	386DX-40
objects	moslamalarni
owners	egalari
&amp; Quot; &amp; quot ;,	&quot;ular&quot;,
Raus)	Rauser)
opinions	fikrlar
others	boshqalarni
networks	tarmoqlari
payment.	to&#39;lash.
Ten	O&#39;n
facts	dalillar
usually	odatda
Semiconductor	Semiconductor
payment)	to&#39;lash)
Java	Java
geological	geologik
implementation	tatbiq
orbit	orbitasi
ordinates	koordinatalar
to pay?	to&#39;lash?
Medical	Medical
)	oshiriladi)
equity.)	xolislik.)
Tell me.	ayt.
held	o&#39;tkaziladi
.	oshiriladi.
Additional	Qo&#39;shimcha
Own	O&#39;z
&amp; Lt; 1993Apr20.102756.1709@mala.bc.ca&amp;gt;	&lt;1993Apr20.102756.1709@mala.bc.ca&gt;
&amp; Quot; break	&quot;break
html>	bc744@cleveland.Freenet.Edu
particles	zarralari
?	oshiriladi?
Cirella)	Cirelli)
Alberto	Albertan,
MNCs	millatli
books	kitoblar
emigrate!	hijrat!
pitchers &amp; gt;	ko&#39;zalar&gt;
At first glance,	qarashda,
Creating	tuzish
class	sinf
(And	(Va
certification	tasdiqlash
the dead	o&#39;liklarning
Gospel,	Injil,
ordered	buyurgan
&#39;Interpretation&#39;	«talqin»
session	sessiyasi
energy	energetika
Bible	Bible
calling	da&#39;vat
Technology,	Texnologiya,
&amp; Quot;	&quot;Siz
enabled	yoqilgan
rose.	ko&#39;tarildi.
tails	dumlar
now	​​hozir
(Amy	(Emi
the word	so&#39;zni
users	foydalanuvchilar
Galant	Galant
says	deyilgan
happy	baxtli
(New)	(yangi)
sales &amp; gt;	sotish&gt;
quantity	miqdor
Welles	Welles
convenience	qulaylik
facilitate	engillashtirish
title-	title-
comment	izoh
html>	jhardono@nickel.ucs.indiana.edu
excessive	ortiqcha
On the other hand	tomondan
Among the	qatorida
woman	ayol
planet-wide	sayyora-keng
encryption &amp; quot; &amp; gt;	shifrlash&quot;&gt;
it&#39;s not	emas
html>	gchin@ssf.Eng.Sun.COM
ARMM &amp; quot;	ARMM&quot;
Christian	nasroniy
(Homosexuals	(gomoseksual
Homosexual	Gomoseksual
ROM	ROM
website.	ayting.
brother	aka
(6,118	(6.118
Yamaha	Yamaha
website)	ayting)
website,	ayting,
Verse	Verse
Do not.	qilmang.
tape	tarmoqli
Versa	Versa
income	daromad
&amp; gt; &amp; gt;	bo&#39;lsangiz&gt;&gt;
oyat-	oyat-
William	Uilyam
the public	ommaga
(And,	(va,
pragmatic	pragmatik
AUTOEXEC.BAT	AUTOEXEC.BAT
telescopes	teleskoplar
God	Xudoga
simple	oddiy
Chicago	Chikagodagi
Email	Email
immediate	bevosita
Finney)	Finney)
variable	o&#39;zgaruvchilar
*****************	*****************
will be shown. &amp; quot;	ko&#39;rinadi.&quot;
thoughts	fikrim
Space	Kosmik
&amp; quot;	aloqa&quot;
treatment.	muomala.
border	chegarani
changed.	o&#39;zgartirilgan.
started	boshlangan,
8300	8300
weight,	og&#39;irlik
party	tomon
-or-	-or-
In	mo&#39;ljallangan-yilda
Thanks &amp; gt;	rahmat&gt;
supply	yetkaza
to teach	o&#39;rgatish
In the past,	O&#39;tmishda
Europe	Evropa,
html>	engp2008@nusunix1.nus.sg
to swing	belanchak
liberal	erkin
Jacob,	Yoqubning
the holes	teshiklari
planet	sayyoraga
November	noyabr,
Scientific	Ilmiy
&amp; Quot; done &amp; quot;	&quot;bajarildi&quot;
2000	2000
In advance	Oldindan
rusty-red	zanglagan-qizil
versions	versiyalari
12-14)	12-14)
thermocouples	termokupl
Research	tadqiqotlar,
\ &amp; Gt;	\&gt;
crater-Pocket	krater-pocked
normal	normal
That	O&#39;sha
level	darajasi
Check.	tekshiring.
Alabama	Alabama
dark	quyuq
based on	asoslangan
buried,	ko&#39;mildi
The law	Qonundan
Month	Oyning
Back)	qaytish)
hundreds of	yuzlab
^^^^^^^^^^^^^^^^^^^^^^^^^^^^^^	^^^^^^^^^^^^^^^^^^^^^^^^^^^^^^
Lyme	Lyme
University of	Universiteti
volts	sarma
here	yerda
groove	groove
using	foydalangan
lessons	saboq
forged	to&#39;qib
such	ana
travel	sayohat
dedication	jonbozlik
professional &amp; gt;	professional&gt;
Dual-Sport	Dual-Sport
Hitter	Hitter,
goods	mol,
Return	Return
Repo	Repo
Villanova	Villanova
Orson	Orson
Sanctions	sanktsiya
prophets	payg&#39;ambarlar
amp	amp
amr	amr
Let	qilaylik,
is;	hisoblanadi;
Computers	Kompyuterlar
is:	hisoblanadi:
gravity	gravitatsiya
desktop	stoli
Check	tekshirib
Sometimes	Ba&#39;zan
---------------------------------	---------------------------------
how much	qancha
financial	moliyaviy
mask,	fosh,
bore	tug&#39;ib
God,	Xudo,
sugar	shakar
Click here	Yerni
the boat	qayiqda
(DOS	(DOS
P7625)	P7625)
yellow	sariq
or?	yoki?
God:	Xudo:
the accuracy of the	to&#39;g&#39;riligiga
spiritual	ma&#39;naviy
single &amp; gt;	yolg&#39;iz&gt;
the idea	fikrni
Is it:	bormi:
loyalty	sadoqati
Is it?	bormi?
conditions	sharoitlari
be placed	joylashtiriladi
planned	rejalangan
Slowly	«sekin
Worlds	olamlarning
;-)	;-)
+31	+31
know	biladimi
is	hisoblanadi,
S.)	S.)
They	Ular,
is.	hisoblanadi.
reflection	aks
&amp; Quot; Scooter &amp; quot;	&quot;Scooter,&quot;
random	tasodifiy
state	davlat
united	birlashgan
Pluto	Pluto
(Other	(boshqa
carbon	uglerod
away	uzoqda
around	atrofga
&amp; gt;	bilan&gt;
;	hosil;
activity	faolligi
=============================	=============================
,	nazar,
to swell	kuchaya
sacrifice	qurbonlik
the signs	oyatlarni
sentenced to	mahrum
surface	sirtini
functional	funktsional
417-4101	417-4101
create	yaratish
Randall	Randall
hate	nafrat
like.	yoqadi.
Let.	bo&#39;lsin.
html>	willisw@coe-nw.clemson.edu
groups	guruhlar,
planet	sayyoramizdagi
Micronics	Micronics
the sound	tovushi
printer	printerni
Let!	bo&#39;lsin!
fall	tushib
Schuster)	Schuster)
address	murojaat
Worldwide,	bo&#39;ylab,
Williams	Uilyams
crystals	kristallari
&amp; Lt; 1993Apr21.182606.6798@ra.royalroads.ca&amp;gt;	&lt;1993Apr21.182606.6798@ra.royalroads.ca&gt;
volume,	hajmi,
large,	yirik,
DR350S	DR350S
work.	ishlaydi.
Neighbors	Qo&#39;shnilari
&amp; Quot;	&quot;U
Designated	ichiladi
anyone	kimga
**********	**********
things	qilinishi
work?	ishlaydi?
haystack	g&#39;aram
part.	qismidir.
Machine	Mashina
RIP	RIP
enough	yetarli
for example.	aytaylik.
half-ice,	yarim-muz,
&amp; Quot ;?	&quot;?
&amp; gt;	ko&#39;p&gt;
male	erkak
cooled	sovutiladi
Women,	ayol,
(Hebrews	(Ibroniylarga
Gods	Gods
actually	aslida
&amp; Quot ;,	&quot;,
The sun	Quyoshning
&amp; Quot ;.	&quot;.
Meanwhile,	orada
ride	haydash
html>	m-it2691@cs.nyu.edu
The container	idish
stand.	turibsizlar.
Solana;	solaman;
planted	ekilgan
cast	tashlashdi,
html>	dlb@hudson.wash.inmet.com
used,	ishlatiladi,
is used.	ishlatiladi.
The teams	jamoalar
I will	solaman,
the will of the	irodasiga
Henry	Genri
argon,	argon,
glad	xursand
Shines.	porlaydi.
Superve	SUPERVGA
&amp; Quot; plate &amp; quot;	&quot;Plastinka&quot;
ions	ionlar
the opposite.	teskarisini.
community	jamoa
rethorical	rethorical
Askew	Askew
mentioned	zikr
similar	o&#39;xshash
wrist	bilagini
.	chiqarish.
production	chiqarish,
^^^^ &amp; Gt;	^^^^&gt;
April	aprel,
gravitational	gravitatsion
the masses	ommasi
quacks	quacks
Meteorology	meteorologiya
German	nemis
planet	sayyorada
level	darajali
nucleus	yadrosining
.	o&#39;sha.
Whitsell	Whitsell
northern	shimoliy
acetylene,	asetilen,
Toolbar	paneli
?	etmoqda?
The ground	Yerga
High	Yuqori
have been	qilingan
internal	ichki
increase	oshirish
not	qilmasliklaridandir
region	mintaqasini,
613)	613)
.	etmoqda.
,	etmoqda,
&amp; Lt; 1537	&lt;15378
probes	zondlar
Costner	Costner
.	mos.
Near-storm	Near-bo&#39;ron
mantle	mantiya
methods	uslublarini
html>	hambidge@bms.com
the world	dunyodan
women	ayollarga
18:33	18:33
Compared to,	solishtirganda,
blood	qon
html>	DBD@ICF.HRB.COM
(Clayton	(Clayton
Technology	texnologiyasi,
theists)	theists)
Release	reliz
Guerke	Guerke,
Thrusters	İticiler
Guerke)	Guerke)
Only	Faqat
generations	avlodlar
Chill.	Chill.
huge	ulkan
theists,	theists,
Send	yuborish
Project	Project
B433EI2	B433EI2
because?	chunki?
Atheist &amp; quot;	ateist&quot;
level	darajaga
Cape	Cape
Americans).	amerikaliklar).
(Perhaps	(ehtimol
the truth.	haq.
11:26)	11:26),
Karl	Karl
because,	chunki,
ideas	g&#39;oyalarni
deleted	o&#39;chirildi
3-8)	3-8),
two	ikki
Surveyor	Surveyor
Here	Yerda
(Herman	(Herman
html>	ai843@yfn.ysu.edu
html>	thomasp@ifi.uio.no
Four	To&#39;rt
anekdot	anekdot
nine	to&#39;qqiz
the world	dunyoda,
Others	Boshqalar
LATONIA)	LATONIA)
confirmed	tasdiqlagan,
environment	muhitini
New York	Nyu-York
Quebec &amp; gt;	Quebec,&gt;
No)	yo&#39;q)
No,	yo&#39;q,
ourselves	o&#39;zimizni
no.	yo&#39;q.
Allah	Allohga
letter	harf
Manager	Managerda
hard	hard
(Peter	(Peter
mixed	aralash
(21,648	(21,648
Stone)	Stone)
clutch	ogohlik
wise)	dono)
Action	Harakat
Quit.	chiqinglar.
Under the	ostida,
-cut control	kesib-nazorat
Feeback	burchakli
DELCO	DELCO
23-26,	23-26,
About	haqida,
Christian	masihiy
Havas,	xavas,
halo	halo
The length of the	uzunligi
play-off	pley-off
Those lucky	egasidirģ
yet	hali
themselves,	o&#39;zlarini,
Christian	Christian
Far	Uzoq
html>	alung@megatest.com
Planets	Sayyoralar
lit	yoritilgan
capable of.	qodir.
battery	batareyani
,	ham,
apostles,	havoriylariga,
FJ1200	FJ1200
.	ham.
The moon	Oyga
Diplomacy	diplomatiya
(Hat,	(shapka,
will be	oshiriladi
?	haqida?
Detroit	Detroyt
small,	kichik,
)	ham)
take	olishi
Agency	agentligi
Small)	kichik)
many	ko&#39;plab
Title	Sarlavha
.	haqida.
Road	yo&#39;li
(Dan	(Dan
Thorson	Thorson
Ratings:	Reyting:
wrong	noto&#39;g&#39;ri,
poll	so&#39;rovnoma
necessary.	zarur.
Pharasees	Pharasees
,	yo&#39;l,
Month	Oyda
improvement	takomillashtirish
a conversation	suhbatlashdi
signal	signal
wrong	noto&#39;g&#39;ri
Missile	Raketa
late	kech
--------------------------	--------------------------
Corolla	Corolla
Addiction.	qo&#39;shadi.
Flooring,	Taxta,
sand	qum
Belt,	kamarning
Addiction	qo&#39;shadi,
readers	kitobxonlar
progress	taraqqiyot
Nagle	Nagle
objects	ob&#39;ektlarni
and parents	ota-va
Moon	Moon
verses	oyatlarda
==========================================	==========================================
ideas	g&#39;oyalarini
understand	tushunib
article	maqola
Raus	Rauser
fair	adolatli
crumbling	çökmekte
level	darajada
(2,544	(2.544
&amp; gt;	olgan&gt;
related	bog&#39;liq
.	ekan.
find	topish
Therefore,	ekan,
photo	foto
appreciate	qadriga
Russia,	Rossiya,
HAMZA	HAMZA
)	yo&#39;l)
interpretation.	talqini.
heated	qizg&#39;in
Coord.	Coord.
# &amp; Gt;	#&gt;
drama	drama
Phillip)	Filip)
I knew	bilgan
means	vositalarini
Ulysses	Ulysses
California	Kaliforniya
The idea of	g&#39;oyasini
itraconazole	itrakonazol
plan	reja,
415-688-8231	415-688-8231
&amp; Gt;	Turli&gt;
Que	Que
removed	tashlangan
Nobuaki	Nobuaki
20Meg	20Meg
Nowadys	Nowadys
Later	Keyinchalik
Brooks	Brooks
Rendezvous	Rendezvous
Getting	topsangiz,
term	muddat
later,	o&#39;tib,
Pioneers	Pioneers
Eve	Momo
original	asl
exposed	fosh
students,	shogirdidan,
--------	--------
donut	donut
spare	ehtiyot
classes	darslari
JESUSCHRIST	JESUSCHRIST
fraud	firibgarlik
transform	o&#39;zgartirishda
Apriori	Apriori
Views:	olish:
to pay.	buyuradi.
Believers &amp; gt;	mo&#39;minlarga&gt;
others	boshqalar,
result	natija
cover	qopqog&#39;ini
not	emasmiz,
cancer	saraton
Maxwell	Maksvell
Kokomo	Kokomo,
Affairs	ishlar
women	ayollarni
Fire,	do&#39;zaxdan
,	olish,
drip	tomchi
Area	Maydoni
orbit	orbitasini
humanitarian	gumanitar
referrals	refering
worship	ibodat
dedicated to	bag&#39;ishlangan
Central &amp; gt;	markaziy&gt;
intelligence	aql
production	ishlab
images	tasvirlarni
discovered.	aniqlashdi.
connectors:	shgichlar:
perpetuate	abadiylashtirish
School	Maktab,
(Der	(der
Cary	Cary
I did not.	bermadi.
wake up	uyg&#39;onish
The moon	Oyni
heard	eshitildi
level	bosqichga
cure	davolash
Men	erkaklar,
escalation	avj
Askew	Askew,
Seminar	Seminar
Reasons	reasonning
coercion	majburlash
Proper	Proper
dressing	qobiq
read	o&#39;qish,
unclumped	unclumped
(1,170	(1,170
Reading)	o&#39;qish)
Freq.	Freq.
Arabs	Arablar
etc.	hokazo
Diseases	kasalliklar
Palmer	Palmer
(By the way,	(Darvoqe,
to discourage	qaytarmoqchi
Nunnally)	Nunnally)
&amp; Lt; empty	&lt;bo&#39;sh
century	asr
prophesy	bashorat
rays	nurlarini
by the	nazarda
issue	masala
&amp; Quot;	&quot;haqida
stage	bosqichda
Occupation	mashg&#39;ulotlari
Alyosha	Alyosha
meetings &amp; gt;	majlislarida&gt;
Remember	eslab
record	yozib
given	ato
(And	(va
air	havo
VL-bus	VL-avtobus
It	Buning
Plus	Plus
Askew)	Askew)
heard	eshitib
Lankford	Lankford
Start	tushirish
buy-back	buy-orqa
RSEVERY	RSEVERY
(Only	(faqat
go away	yo&#39;qol
learn.	o&#39;rganamiz.
Carl	Carl
University of	universiteti
turmoil	parokandalik
Card	Card
remember	eslay
Security &amp; quot;	xavfsizligi&quot;
subject to,	tortiladi,
serious	jiddiy
Rule	Qoida
speed	tezligi
Within	Ichida
Justification_	Justification_,
&amp; gt; &amp; gt ;,	yana&gt;&gt;,
nature	tabiatda
session	sessiya
html>	pgf@srl03.cacs.usl.edu
Home-cooked	Uy-pishirmoq
document	hujjat
discoveries	kashfiyotlar
The role of	roli
slow	sekin
Is it?	emasmi?
God &amp; quot ;,	Xudosi&quot;,
before	oldin,
Asteroid	asteroit
ago.	oldin.
homosexal	homosexal
[386Enh]	[386Enh]
sent	yuborilgan
converts	o&#39;zgartiradi
Do you believe that?	ishonasizmi?
Jesus	Iso
&amp; gt;	kim&gt;
native	native
,	etadi,
Waiting for	kutaman
announcement	e&#39;lon
Go to	o&#39;tish
.	etadi.
myself.	o&#39;zimni.
I.	oldim.
.	bog&#39;liq.
AT)	AT)
(Non-Dead)	(non-Duo)
heard?	eshitmagan?
the contract.	shartnoma.
_____	_____
Almighty.	Qodir.
to get	olish
suspicion	gumon
ruling	hukmron
designers	dizaynerlari
prevention	oldini
written	yozilgan,
right	huquqdan
asteroid	asteroid
luck	omad
conspiracy	fitna
Jesus	Isoni
[Hebrews	[Ibroniylarga
reverse	teskari
Now &amp; gt;	Hozir&gt;
Communications	Communications
Hemisphere	yarimsharda
applications	dasturlarda
(&amp; Gt;	(va&gt;
.	bo&#39;lmagan.
040	040
women as well as men.	yog&#39;dirilgan.
20X-60X60mm	20X-60X60mm,
Thieves,	qaroqchi,
hetero	hetero
University:	universiteti:
focus	o&#39;ylash
Atheists	ateistlar
that.	qilayotganini.
AIAA	AIAA
window	derazasiga
dynamics,	dinamikasi,
boiling	qaynoq
Is	emasmi
_______________________	_______________________
deleted	o&#39;chirilishi
nitrogen,	azot,
Phobos	Phobos
updated.	yangilanadi.
Factories	fabrikalar
&amp; Lt; C5xxq0.18M@cs.columbia.edu&amp;gt;	&lt;C5xxq0.18M@cs.columbia.edu&gt;
the other side	narigi
As DH	DH-kabi
Comet	Comet
version.	versiyasi.
===============	===============
literature	adabiyotlarda
raised	ko&#39;tarib,
Galileo,	Galiley,
cold,	sovuq,
N-8-1	N-8-1
Pyramid}	piramida}
someone	kimdir,
Panoramic	Panoramic
Mongols	mo&#39;g&#39;ullar
the body	tananing
bodies	organlari
river	daryo
Baseball	Baseball
You can	mumkin
The Madyan	Madyanga
.	boshlaydi.
Answer: &amp; gt;	javob:&gt;
on the horizon	ufqda
WinJPEG	WinJPEG
Magellan	Magellan,
Okay,	Okay,
colony	koloniya
appearance	ko&#39;rinishi,
comics	komikslar
&amp; Quot; &amp; gt;	&quot;&gt;
000	000
[Christians]	[masihiylar]
System	tizimi
poles	qutblar
Newspaper	gazetasi
(UNT-CAS	(UNT-CAS
-day license	kun-litsenziya
atmosphere	atmosferasida
S5R3.2	S5R3.2
was issued.	chiqardi.
Frozen	muzlatilgan
Humphreys	Humphreys
concept.	tushunchasi.
mine	meniki
3.1	3.1,
atheists	xudosizlar
mass	omma
Freedom of	erkinligi
upgradeable	yükseltilebilir
exposed	duchor
The man,	Odam,
The reason for &amp; quot;	sababi&quot;
color	rang
&amp; Quot; doping	&quot;velopoygachi»
that is,	ya&#39;ni
Jerusalem	Quddus
Learn	oling
(Nick	(Nik
etiologic	etyolojik
shows	ko&#39;rsatadi,
non-aggressive,	​​non-tajovuzkor,
132.252	132,252
Against	Qarshi
Active	Active
pressure	bosimini
html>	toml@boulder.ParcPlace.COM
Herman,	Herman,
Craig	Kreyg
Cars:	kabellar:
.	ko&#39;rsatadi.
Mars,	mars,
height	balandlik
Main	Asosiy
previous	oldingi
^^^^^^	^^^^^^
experience.	tajriba.
I&#39;m not	emasman
comments	fikr-mulohazalaringizni
ahead	oldinga
missions	missiyalari
Mercury,	Merkuriy,
title	nomga
gapirdingizmi!	gapirdingizmi!
Resources	resurslari
Telescope	Teleskop
devil	shayton
I&#39;ll	olaman
healers	tabiblarga
Mars	​​Mars
Maftunkorliliga	Maftunkorliliga
Are you a &amp; gt;	olasizmi,&gt;
dreams)	tushlar)
Felix	Felix
The share	ulushi
Heterosexual	Heterosexuel
READ	o&#39;qi
Buyer	qiluvchi
During the	paytida
a vague	tevaragida
chipset	chipset
Symbolisme &amp; gt;	symbolisms&gt;
victory	g&#39;alaba
Bake	Bake
&amp; gt ;, claim	da&#39;vo&gt;,
Newton	Newton
(Bill	(Bill
Collins &amp; gt; &amp; gt;	aslida&gt;&gt;
I say	aytaman
Reasons:	sabablari:
window	oynaning
but,	lekin,
impact	zarba
World	jahon
efforts	urinishlariga
Mouse;	Sichqonchasi;
harm	zarar
| &amp; Gt; &amp; gt;	|&gt;&gt;
Land-out-of-business	yer-out-of-biznes
park	mashinalar
cryptographic	kriptografik
Marly	marly
belts	belbog&#39;larini
law	qonun
TIFF	TIFF
wrote	yozgan
disaster	musibat
living in	istiqomat
Timmons	Timmons
Attempts	urinishlar
geographical	geografik
&amp; gt;	ikki&gt;
country	mamlakat
Fisher	Fisher
instead of &amp; gt;	o&#39;rniga&gt;
the name	nomi
administration	ma&#39;muriyatining
6/92	6/92,
Tart	olishda
find	topishingiz
district	tuman
forms,	shakllari,
applications	dasturlarga
a &amp; gt;	katta&gt;
Germany,	Germaniya,
html>	mlee@post.RoyalRoads.ca
grave	qabr
right	o&#39;ng
15 &amp; gt;	15-siz&gt;
html>	v124p7kk@ubvmsc.cc.buffalo.edu
work	ishlarni
neccacery	neccacery
(Yusuf	(Yusuf
give	berishi
Placebo	Placebo
Is.	emasmi.
Red	Qizil
____________________________________________	____________________________________________
1992/93	1992/93
.	chiqdi.
on	bo&#39;yicha,
did not	qilmadi
density	zichlikka
without	bo&#39;lmasdan
ARRIVE	KELDI
AAS	AAS
Jet	Jet
locked,	qulflangan,
Inc.	Inc.
the education of	tarbiyasida
locked.	qulflangan.
&amp; Quot; jargonese &amp; quot;)	&quot;jargonese&quot;)
Yee)	Yee)
You can not.	olmaysiz.
Inc	Inc,
observed.	kuzatganman.
four	to&#39;rttaga
of the call	qo&#39;ng&#39;iroqning
Triantafyllopoulos)	Triantafyllopoulos)
away,	uzoqlashib,
WITH	BO&#39;LGAN
(Myslef	(myslef
The Originator	yo&#39;qdan
firearm	qurolga
health,	salomatligini
participated in	qatnashdi
Safety	Safety
Mitchum)	Mitchum)
touch	teginish
Accordingly,	nazardan,
,	berdi,
.	berdi.
molecules	molekulalari
identified.	aniqlangan.
numbers	raqamlarini
Around	Atrofida
advertisement	reklama
The main-belt	asosiy-kamar
Weather	ob-havo
Englewood,	Englewood,
patient	bemor
filled	to&#39;lgan
&amp; Quot; dynamic &amp; quot ;.	&quot;dinamik&quot;.
two	ikkita
inorganic	noorganik
ANTI-TRUST	ANTI-Trust
KES	KES
fire	olov
&amp; Quot;	&quot;uzoq
small &amp; quot;	mitti&quot;
returned	qaytganida,
chosen	tanlagan
Of course,	Albatta,
(Craft)	(CRAF)
himself	o&#39;zi
players?	futbolchilar?
agree	rozi
interpretations	talqinlar
(Mike	(Mayk
knifes	knifes
lucky	omadli
(Hans	(Hans
html>	jaskew@spam.maths.adelaide.edu.au
tents	chodirlarda
Aerials	antennalar
Pasadena,	Pasadena,
become	aylanib
zones	hududlari
Jay	Jay
Vancouver	Vancouver
magnet	magnit
Sciences	fanlar
Faehl)	Faehl)
fruit,	meva,
both	ikkisi
beam	nur
my	mening
Man	Odam
beliefs	e&#39;tiqodlari
consumption	iste&#39;mol
excels	sig&#39;maydigan
extending	cho&#39;zilgan
buyer	xaridorning
criticism	tanqidga
popup	oynani
game	o&#39;yinni
(Mark	(Mark
(Matt.	(Mat.
intermediate	vositachi
Jews,	Yahudiylar,
using	yordamida,
&amp; Quot; electroglow. &amp; Quot;	&quot;electroglow.&quot;
mental	ruhiy
Adams	Adams
tectonic	tektonik
(Cyanide	(sianid
heterogeneity	heterojenlik
Masters	Masters,
Lore	Lore
In the end,	Oxir-oqibat,
Therefore,	Shuning
(Preferences	(afzal
^)	^),
the star	yulduzning
ADC	ADC
then	so&#39;ngra
(303)488-6120	(303)488-6120
451-0815,	451-0815,
(_______________________)	(_______________________)
left?	chap?
Euro-Pulse)	Evro-urish)
&amp; gt;	chunki&gt;
right!	to&#39;g&#39;ri!
(Ethan	(Ethan
Christ	Masihga
(Matt	(Matt
you want	qilmoqchi
Thank you	rahmat
guess	taxmin
separately	alohida-alohida
fungal	fungal
entered.	kirdi.
Viking	Viking
bands.	kengliklarida.
Nagle)	Nagle)
large	katta
&amp; Quot; name	&quot;ism
apple	olma
observed.	kuzatilmoqda.
Atractii	atraction
synthesis	sintez
will be resurrected	tiriladi
laetril	laetril
scan	scan
Info	Info
radiation	radiatsiya
dust	chang
come	keladi
MacRae)	MacRae)
Look	Look
&amp; Lt; 1993Apr17.125545.22457@rose.com&amp;gt;	&lt;1993Apr17.125545.22457@rose.com&gt;
Institute &amp; gt;	instituti&gt;
(Keith	(Keyt
murder	qotillik
AIR	AIR
^^^^^^^^^^^^^^^^^^^^^^^	^^^^^^^^^^^^^^^^^^^^^^^
Speaking	gapirganda
We &amp; gt;	biz&gt;
Lease	beraman
Horus	Horus
appeared	ko&#39;rindi
ruthless	shafqatsiz
participate in	ishtirok
pitiful	bechora
Joseph	Joseph
html>	xx155@yfn.ysu.edu
title	nom
bread	non
status	ahvoli
&amp; Quot;	&quot;savdo
sexual	jinsiy
Microsystems	Microsystems
problem	muammo
How much	Qancha
.	ko&#39;ring.
(Rick	(Rick
(437	(437
,	ko&#39;ring,
&amp; Quot; &amp; quot;	&quot;biz&quot;
color	rangi
recognition	tanish
Bloomberg,	Bloomberg,
no,	hech,
certain	​​muayyan
Fax:	Faks:
Management	Management
match	o&#39;yinda
parody	parodiya
window	oynada
&amp; Quot; Ring	&quot;uzuk,
part	qismini
******************	******************
[Great	[ajoyib
Morals	axloqi
fuel	yoqilg&#39;i
on the way	yo&#39;lida,
100 &amp; gt;	100&gt;
.	chiqadi.
Corinthians	Korinfliklarga
Ethics]	axloq]
(Brian	(Brian
&amp; Quot; God &amp; quot;	&quot;Xudo&quot;
thousand	ming
but,	ammo,
Please	Iltimos
The earth	Erning
803-654-8817	803-654-8817
issues	masalalarni
hair	sochlari
British	British
observer	kuzatuvchi
-man crew,	inson-Mürettebatlı
latest	so&#39;nggi
Pages	sahifalar
Men &amp; gt;	erkaklar&gt;
periods	davrlar
Decision:	qaror:
perturbations	karışıklığından
files	fayllar
battle	jangda
»	»bilan
go to	borish
suitcase	chamadonni
After	qilgach,
keys	kalitlari
&amp; Quot; relative. &amp; Quot;	&quot;nisbiy.&quot;
Seller	Sotuvchining
States	Shtatlari
to add	kiritishingiz
in upbringing	tarbiyalashda
34.839	34,839
icy	muzli
sci.crypt	sci.crypt
amount,	miqdorda,
has confirmed.	tasdiqladi.
six	olti
population	aholi
Almost	Qariyb
address	manziliga
&amp; Quot;	&quot;yuz
difficult	​​murakkab
John	Jon
(447	(447
the east	sharqdan
ineffective	samarasiz
Joe	Joe
-club	-club
Agressive	Agressive
cases	hollarda,
Do not	qilmang
dioxide	dioksid
ribbon	tasma
[LDS]	[LDS]
40Meg	40Meg
samples	namunalarini
education	ta&#39;lim
distributor	distributorga
molesters	molesters
Emulator	Emulator
Ruins.	qoldiqlari.
News	Yangiliklar
Ruins,	qoldiqlari,
has become	aylandi
spending	o&#39;tkazgandan
Let.	chiqaylik.
(You	(siz
to	qilishingiz
Ju)	Ju)
means.	anglatadi.
Sweden	Shvetsiya
15:	15:
English	ingliz
shortcomings	kamchiliklarni
dignity	qadr-qimmatini
Harvey)	Harvey)
encryption &amp; gt;	shifrlash&gt;
Barista	tinchlikda
150	150
15	15,
mean?	anglatadi?
Stanley	Stanley
devices	qurilmalar
humanity	insoniyat
struggles	kurashsagina
Norway	Norvegiya
The device,	qurilma,
Christian	xristian
placement	joylashtirish
Apple	Apple
sent	yuborgan
primitive	ibtidoiy
Wizzard	Wizzard
ohm	ohm
162	162
sound	ovozli
(215)645-6463	(215)645-6463
general	umuman
pixels	piksel
virgin	bokira
Table	Jadvalga
said: &amp; quot;	dedi:&quot;
sold.	sotilgan.
Acts of the Apostles	Havoriylar
hers	kegani
think	o&#39;ylaysiz
Information)	ma&#39;lumot)
176	176
ok,	ok,
Search &amp; gt;	qidiruv&gt;
calling	chaqirib,
170	170
that	ekanligini
_hard_	_hard_
Christians,	masihiylar,
was made	tuzildi
sent.	yuboriladi.
obscuring	örtülmemesidir
gods,	xudolarsiz,
very	nihoyatda
Some	Ba&#39;zi
I hate).	nafratlanaman.)
the ball	to&#39;pi
justification	oqlanishni
Silence	Sukunatga
Me	Menga
date	sana
necessary	zarur
surrounded	o&#39;rab,
X-Window	X-Window
(Brian@gab.unt.edu)	(Brian@gab.unt.edu)
life	hayoti
surface,	yuzasiga,
glaciers	muzliklarning
[&amp; Quot; Jesus	[&quot;Isoning
&amp; Quot; or	&quot;yoki
remarkable	ajoyib
Christians?	masihiylar?
&amp; Quot;	&quot;Bir
satellites	yo&#39;ldoshlarini
character	xarakterdagi
preaching	va&#39;zgo&#39;ylik
(David	(David
21-22	21-22
ten	o&#39;n
material &amp; gt; &amp; gt;	moddiy&gt;&gt;
(Post	(post
&amp; Quot; We	&quot;Biz
impossible	imkonsiz
leak	oqish
own	o&#39;z
wrap	wrap,
Karamazov	Karamazovlar
pole	pole
Your name	ismingiz
patients	bemorlarga
Nori)	Noring)
20850	20850
risk	xavf
diseases	kasalliklarni
html>	cramer@optilink.COM
The star	Yulduzning
122	122
Shack	Shack
such as.	kabi.
Mags	Mags
Jew	yahudiy
effect &amp; quot;	ta&#39;siri&quot;
It is important.	muhimdir.
life.	hayot.
stored	saqlanayotgan
&amp; Lt; 1993Apr16.173252.7393@asd.com&amp;gt;	&lt;1993Apr16.173252.7393@asd.com&gt;
Group	guruhi
such as,	kabi,
Arab,	arab,
Alternative &amp; gt;	muqobil&gt;
120	120
such as)	kabi)
Saturn,	Saturn,
Salah)	namozda)
Quinn)	Quinn)
Peter &amp; gt;	Butrus&gt;
mixer	mikser
remaining	qolgan
The prophets	Payg&#39;ambarlarni
Calculation	Hisoblash
explain	tushuntirib
Fridman	Fridman
(408)	(408)
Then,	Keyinchalik,
Orbiter	Orbiter
Camarena	Camary
to	imkoniyatiga
13	13,
located	joylashgan
ones	bo&#39;lganlar
Email	Mail
journeys	safarlarimiz
reforming	isloh
The lack of	yo&#39;qligi
Israel	Isroil
------------------------------	------------------------------
&amp; Lt; timmbake@mcl.ucsb.edu&amp;gt; &amp; gt; &amp; gt;	&lt;timmbake@mcl.ucsb.edu&gt;&gt;&gt;
consideration	ko&#39;rib
error	xato
Approximately	Taxminan
149	149
14:	14:
********	********
&amp; Quot; Jesus	&quot;Isoni
92.8	92.8
lines	liniyalari
program	dasturi
bearings	yotoqlari
orbit	orbitasida,
off	off
group,	guruh,
140	140
ailment	xastaligidan
As a result of	oqibatida
hold	turing
opens	ochiladi
France,	Frantsiya,
Johnson &amp; gt;	Jonson,&gt;
brake	tormoz
Torre	Torre
Europe	Yevropa
I do not think.	o&#39;ylamayman.
secure	xavfsiz
Christian	Masihiy
&amp; gt;	qaysi&gt;
sons,	o&#39;g&#39;illari,
Disease	Kasallik
whether	yo&#39;qligini
proud	faxrlanib,
The device	qurilma
Motorcycles	Mototsikllar
Within	nazardan
failed.	olmadi.
Summary	Xulosa
Offset	ofset
Ancient	Qadimgi
html>	wagner@mala.bc.ca
&amp; Quot; Your	&quot;Sizning
program.	dastur.
Sulfur	Oltingugurt
Closing of	yopilishi
(Norio	(Noring
speaking	gapirayotganim
begin	boshlaydi
If the	etsa,
&amp; Quot; encryption	&quot;Shifrlash
so	shunday
dead	o&#39;lgan
The window	oynasi
&amp; gt;	edi&gt;
indica &amp; gt;	indicting&gt;
points	nuqtalari
given	berilgan
dollar	dollar
(	(shunday
intentions	niyatlarini
LA	LA,
Craft	CRAF
readiing	readiing
change,	o&#39;zgaradi,
flow	oqimi
app	ilovasidan
OBO	obo
Control	nazorati
I am happy.	xursandman.
In the book	kitobida
(Almost)	(deyarli)
black	qora
vascular,	tomir,
clicks	tıklatırsa
achievements	yutuqlari
19	19,
herd	poda
html>	mouse@thunder.mcrcim.mcgill.edu
Fraering	Fraering
representative offices	vakolatxonalari
(Oh,	(Oh,
VESA	VESA
minute	daqiqa
The members of the	a&#39;zolari
RA &amp; gt;	RA&gt;
bacterial	bakterial
pitching	pitching
Christ	Masihni
but!	balki!
supports	qo&#39;llab-quvvatlaydi
Antique	Qadimiy
Jupiter,	Yupiter,
hierarchical	ierarxik
19:	19:
valleys	vodiylarda
He will.	berur.
Majority	Aksariyat
himself	o&#39;zini
but,	balki,
ended	tugadi
a reserve	zahirasini
investigation	tergov
Halley	Halley
Healers	Tabiblar
That	Deb,
free,	bemalol,
professional	professional
tools	vositalari
prophet	payg&#39;ambar
&amp; Lt; C51nLs.7As@boi.hp.com&amp;gt;	&lt;C51nLs.7As@boi.hp.com&gt;
trillionth	trillionth
27.2.	27.2.
&amp; Quot; Magic &amp; quot; &amp; gt; &amp; gt;	&quot;Magic&quot;&gt;&gt;
surgical,	jarrohlik,
at the top	yuqorisida
Bidders	talabgor
(CAL).	(Tinglash).
read	o&#39;qildi
LEAVE	chiqishidan
Mercury	Mercury
Boyd	Boyd
positive	ijobiy
it&#39;s not.	emas.
it&#39;s not,	emas,
VE7GDA	VE7GDA
flyby	rishiz
---------------	---------------
&amp; Quot; shovels	&quot;eshkaklar
canceled	bekor
Asteroids	asteroitler
it&#39;s not)	emas)
LDS	LDS
NOT	BO&#39;LMAGAN
Hell &amp; gt;	Jahannam&gt;
started	boshlagan
The launch of	tushirilishi
stopped.	to&#39;xtadi.
LED	LED
reasoning	mulohaza
artificial	sun&#39;iy
Eastern	qismida
it&#39;s not?	emas?
night	tunda
stay	turish
instant	oniy
it&#39;s not;	emas;
regions &amp; quot;	viloyatlariga&quot;
&amp; Quot; subjective &amp; quot;	&quot;sub&#39;ektiv&quot;
html>	Lvc@cbnews.cb.att.com
~~~	~~~
people	xalq
Ethnic	Millatiga
the use of	ishlatish
spending	sarf
mixture.	aralashmasidir.
straight away	to&#39;g&#39;ridan-to&#39;g&#39;ri
protection	himoya
&amp; gt;	olish&gt;
Ken	Ken
series	qator
increases.	oshiradi.
sent.	yuborilgan.
enter:	kiriting:
Venus,	Venera,
Matt	Matt
because	chunki
hidden.	yashiringan.
astronomer	astronomi
little	oz,
Coach	murabbiyi
the difference	farqni
appearance	ko&#39;rinishi
gravitacional	gravitacional
&amp; Lt; 1993Apr4.221228.17577@bsu-ucs&amp;gt;	&lt;1993Apr4.221228.17577@bsu-ucs&gt;
Traceable	kuzatilishi
&amp; gt;	ovoz&gt;
full	to&#39;laqonli
softly	ohista
sentence	gapning
the people	odamlarga
(Liscened	(liscened
Now	endi
examination	ko&#39;rikdan
play.	o&#39;ynaymiz.
Especially	Ayniqsa
Good luck!	tilaymiz!
month	oy,
speed	tezlikda
DA &amp; gt;	ULARNING&gt;
number	raqamini
development	rivojlanishi
Structural &amp; gt;	tizimli&gt;
Storm	Bo&#39;ron
(Gordon	(Gordon
(510)	(510)
Salon &amp; gt;	o&#39;tib&gt;
he asked.	so&#39;radi.
&amp; Quot; disease	&quot;kasallik
Rechargeable	Rechargeable
Scandinavians	Scandinavians
astronomer,	astronom,
part	qismi
It should be noted that,	kerakki,
shepherding	cho&#39;ponlik
flying	uchib
True,	rost»,
Unlike	farqli
&amp; Quot; stimulus &amp; quot;	&quot;rag&#39;batlantirish&quot;
stay!	qolish!
html>	astein@israel.nysernet.org
physical	jismoniy
How	Qanday
expensive	qimmat
doctor	shifokorga
Technic &amp; gt;	Texnikaning&gt;
compliance with	muvofiqligini
one of the	biridan
The orbit	orbita
guest	mehmon
100,000	100,000
former	sobiq
ask	so&#39;rashi
upset	xafa
When	Qachon
eye	ko&#39;z
unauthorized	ruxsatsiz
Express	Express
himself	o&#39;ziga
Do not forget.	unutmang.
such as	singari
Infiniti	Infiniti
Christ	​​Masih
Orbit	aylanishlar
else	o&#39;zga
Arar.	izlaydi.
Russia	Rossiya
comet	kuyruklu
techniques	metodlarni
Who	Kim
wolves	bo&#39;rilar
fixed	sobit
did.	qilmadi.
html>	scott@asd.com
(Astronomical	(astronomik
I did not	qilmadi,
insurance	sug&#39;urta
Article	Maqolada
Article	Maqola
Performance	ishlashi
new	yangi
(John	(Yuhanno
above	tepasida
1-26	1-26
Kipling	Kipling
crazy	aqldan
&amp; Quot; Sports &amp; quot;	&quot;sport&quot;
March	mart,
It was	etildi
Where	Qaerda
blue	ko&#39;k
survive	omon
html>	starowl@rahul.net
BAND	tasmasi
many	ko&#39;p
meanings	ma&#39;nolari
before	avval
paradox	paradoks
chronic	surunkali
Claims)	so&#39;rash)
the need to	zarurligini
short	qisqa
I myself	o&#39;zim
which	bo&#39;lgan
Q4,	4-savol,
market	bozor
one	​​bir
acceptable	ma&#39;qul
drop	qatra
peg	qozig&#39;ini
The relative	nisbiy
records	yozuvlar
people	odamlarni
..:.:	..:.:
(Alan	(Alan
flow	oqib,
Gordon	Gordon
Due to	tufayli
Commonly,	hodisaga
lunar	qamariy
Mike	Mayk
at	o&#39;zida
variable	o&#39;zgaruvchan
reparented	reparented
reliable	ishonchli
It was,	qilindi,
.	qilindi.
Benedict	Benedikt
plates	plitalarning
After	Keyin
PB170	PB170
people	xalqining
times	marta
accompaniment	hamrohlik
(April	(aprel
Infinity	Infinity
M.)	M.)
rodents	kemiruvchilar
out	out
Man,	Man,
(	(tez
&#39;God	«Xudo
June	iyun
Send.	yuboring.
vanity,	betayin
collision	to&#39;qnashuv
Turbulence	Jo&#39;sh
better	yaxshiroq
one-half	bir-yarim
Foltz	Folta
word	so&#39;z
(A	(bir
high.	yuqori.
bag	xalta
white	oq,
great	katta,
experience	tajribasiga
sweep	supurib
sick	kasalman
great.	katta.
High,	yuqori,
found.	topdik.
thyroid	qalqonsimon
(We	(biz
html>	bep1@cbnewsg.cb.att.com
Silicate	silikat
strange	g&#39;alati
confidence	ishonchni
despite	qaramasdan
King	Shoh
move	ko&#39;chib
&amp; Lt; lsj4ruINNl7o@saltillo.cs.utexas.edu&amp;gt;	&lt;lsj4ruINNl7o@saltillo.cs.utexas.edu&gt;
his	uning
heathen	majusiy
Reeves)	Reeves)
&#39;.	&#39;edi.
to the	oldiga
1-2	1-2
10	10,
Kor	Kor
features	xususiyatlari
from above	yuqoridan
settings	sozlash
Roth)	Erog&#39;lu)
(Malcolm	(Malcolm
intollerent	intollerent
Johnson)	Jonson)
The apostle	Havoriy
Johnson,	Jonson,
Kou	Kou
Saint	saing
bring	keltira
by	oldida
Research.	tadqiqot.
ownership.	egalik.
100	100
places	joylarini
speaking	gapirib
sons &amp; gt;	o&#39;g&#39;illari&gt;
put	qo&#39;ymaguncha
flying	uchayotganda
Edmonton	Edmonton
stone,	tosh,
fax	faks
Vica	Vica
Son &amp; quot;	O&#39;g&#39;li&quot;
fan.	fan.
1/2	1/2
talk	munozarasi
physician	tabib
Electronic	Elektron
distribution	tarqatish
the front	old
expenses	xarajatlarni
people	odamlarda
we got.	oldik.
living	yashash
&amp; Quot; &amp; quot jargon;	&quot;jargonu&quot;
on-line	on-line
clueless	clueless
Knife	Pichoq
sense.	ma&#39;nosidir.
(Gary	(Gary
send.	yuboraman.
sensitive	sezgir
afraid of	qo&#39;rqdilar
said: &amp; gt; &amp; gt;	deydi:&gt;&gt;
Adams)	Adams)
rising	ko&#39;tarilgan
closer	yaqinmiz
circuit	tutashuv
The temperature	harorati
Tiff	Tiff
Bernard)	Bernard)
global	global
_National	_National
after	keyin
MIniVas	MIniVas
four	to&#39;rt
tolerable	muhosaba
the face	yuziga
The mother	Onadan
kill	o&#39;ldiradilar
mother	ona
Bures	Bures
June	Iyun
recession	tushish
&amp; Quot; T &amp; quot;	&quot;T&quot;
Assouline	assult
I understand	tushundim
purchase	sotib
March	Mart
Mars	Mars
Collins &amp; gt;	aslida&gt;
direction	yo&#39;nalish
riding	minib
three	uchta
crafts	hunarmandchilik
Blomberg	Blomberg
1.1	1,1
authorized	vakolatli
Mark	Mark
.	eng.
Index	indeksi
not	kelmagan,
Infrastructures	infrastrukturaning
earth	yuzida
1.3	1,3
mid-1993	o&#39;rta-1993
active	faol
tvtwm	tvtwm
the basics	asoslarini
rejected.	rad.
writes:	yozadi:
save	saqlab
temperature,	harorat,
tear	sug&#39;urib
promotion	rag&#39;batlantirish
success	muvaffaqiyat
GIF,	GIF,
until	gacha
Saturn	Saturnning
.	ko&#39;ra.
RED)	rad)
According to the	ko&#39;ra,
strict	qat&#39;iy
writes.	yozadi.
for	uchun
sharp	o&#39;tkir
stargazers	stargazers
ExposureMask	ExposureMask
Do you know?	bilasizmi?
formation	shakllantirish
the atmosphere,	atmosfera,
the owner	egasining
human	inson
Because	Chunki
symptoms.	alomatlar.
feud	adovat
Timothy	Timo&#39;tiyga
the volume of	hajmining
His	Uning
(Cases	(hollar
(38.8	(38,8
colors	ranglar
object	ob&#39;ekt
Neal	Neal
spring	bahor
say.	aytish.
Management	boshqarish
say,	aytish,
Canadians:	Kanadaliklar:
Syria	Suriya
pride	faxr
vshield	vshield
&amp; gt;	ular&gt;
places	joylarda
iconified	iconified
...	...
Then,	So&#39;ngra,
Fang)	Fang)
Neptune	Neptunning
That is,	Ana,
Eurosport	Eurosport
..:	..:
&amp; quot;	sotib&quot;
Midwest	Midwest
Cipriani)	Cipriani)
places	joylarga
transmission	o&#39;tkazish
sick	kasal
between	o&#39;rtasida
pointed out.	ta&#39;kidlanadi.
jargon	jargon
The Lord	Rabbiyning
Nea.	Nea.
armpit	qo&#39;ltiq
Word	Word
say	aytishi
* &amp; Gt;	*&gt;
LGBT	jinsdoshlarini
&amp; Quot; You &amp; quot;	&quot;Siz&quot;
add.	qo&#39;shing.
the sky	osmonni
nasty	jirkanch
muddy	loyqa
Law	Qonunda
in terms of,	jihatidan,
the bodies of	organlarining
who knows	biladi
Larry	Larri
After	so&#39;ng,
aside	surib
denied.	inkor.
does not	bermaydi
oozed	oozed
m.	yashayman.
Those who	qilganlar
hockey,	xokkey,
then.	so&#39;ng.
BEP)	sudlanuvchi)
more than	ortiq,
computer	kompyuter
has been	qilinganidan
contribution	hissa
Go down	tushing
determination	belgilash
out	tashqariga
including,	jumladan,
me.	menga.
terminal	terminal
Morocco	Marokash,
chip	yonga
flesh	tana
disease	kasallik
reprehensible	kınanması
enough	yetarlicha
&amp; gt;	bo&#39;lish&gt;
sitting	o&#39;tirgan
sky	osmon
on the outskirts of	etagida
Cloud	Cloud
marks	belgilari
expending	sarflayapsiz,
Why	Nega
how many	qanchadan-qancha
thorough	batafsil
altitudes	balandliklardan
States	States
those who	bo&#39;lganlarga
understand.	tushunmadilar.
Kars	-Karl
similar to	o&#39;xshaydi
I know)	Bilaman)
surfaces	qirish
(All	(hammasi
The power of	kuchi
(At least	(kamida
Skepticism	Skeptitsizm
As a result,	Natijada,
Brendan	Brendan
.	qilamiz.
denser	zichroq
unlettered	o&#39;qimagan
years of age	yoshgacha
Consulting	Consulting,
&amp; Lt; 15464@optilink.COM&amp;gt;	&lt;15464@optilink.COM&gt;
difference	farq
but &amp; gt;	lekin&gt;
said: &amp; gt;	deydi:&gt;
ninety	to&#39;qson
Day	Kun
hearing	eshitish
HELP:	HELP:
disagreements,	ixtiloflar,
KALDILDI	Kaldis
Mariner	Mariner
image	tasvir
out	tashqarida
Help!	yordam!
SAP,	dastani
research	tadqiqotlarning
colorful	rangli
patients &amp; gt;	bemorlarni&gt;
sex &amp; quot ;.	sex&quot;.
Diseases	«kasalliklar
think.	o&#39;ylaydi.
Will	Qiladi
help	yordam,
aware	xabardor
face	yuzi
discovered	kashf
parts	qismlar,
Miranda	Miranda
leave	tark
public	jamoat
I am &amp; gt;	emasman&gt;
I will.	beraman.
fall	kuz
watch &amp; gt;	tomosha&gt;
day	kun
diagnosis	tashxis
Cash	yonilg&#39;i
being	oshirilmoqda
BC	miloddan
cryptanalysis,	kriptoanaliz,
html>	mls@panix.com
case	holda
legs,	bukilib-bukilib,
,	ketgan,
Lee	Lee
dissolution	tarqatib,
people	odamlar
line	chizig&#39;i
&amp; gt;	joy&gt;
applied	qo&#39;llanilishi
a &amp; gt;	bir&gt;
health	sog&#39;liqni
&amp; gt;	qilib&gt;
risk	tavakkal
virtual	virtual
about	haqda
: &amp; gt; &amp; gt;	bo&#39;lishi:&gt;&gt;
England	England
Thorson)	Thorson)
Shapiro)	Shapiro)
buttons	tugmalaridan
(Truth)	(Haqiqat)
worthy	loyiq
Bounce	Bounce
symptoms	alomatlar
gays,	gomoseksualistlar,
Dr.Banzai	Dr.Banzai
tone	ohangini
(0,0)	(0,0)
........	........
institution	muassasada
Support)	Support)
release)	relizlar),
restart	restart
MDs	MDs
.	kerak.
crafts	hunarmandlikni
,	kerak,
parts	qismlari
.45	.45
Hydrogen	Vodorod
html>	dbd@icf.hrb.com
Shortcuts	klavishlar
rather	afzal
Aviation	Aviatsiya
Code	kodini
single	yakka
methane,	metan,
you need?	kerak?
1-800-344-4539.	1-800-344-4539.
markets	bozorlarida
;	kerak;
metal	metall
400 &amp; gt;	400&gt;
MC)	MC)
masters	ustalari
Consult	maslahatlashing
The use of	Foydalanish
second,	sekundiga
Rubin)	Rubin)
upgrades	yuksaltirish
Law	Qonunga
FJ1200 &amp; gt;	FJ1200&gt;
status	holat
Ethics &amp; quot ;.	axloq&quot;.
argument	argument
did not have	demadi-ku
X11R5	X11R5
X11R4	X11R4
suggest.	fikrdamiz.
current &amp; quot;	amaldagi&quot;
.	qilinishi.
aluminum,	alüminyumdan
When the	olganda,
electric	elektr
Fellow	yo&#39;ldoshlar
Filter	filtri
Captain	miqyosda
html>	kmac@cisco.com
laboratory	laboratoriya
In contrast,	o&#39;laroq,
(&amp; Gt;	(ning&gt;
html>	hal@cco.caltech.edu
Americans	amerikaliklar
The procedure for	tartibi
easy.	osondir.
spheres	sohalari
dept.	dept.
relaxing.	topdingiz.
(For example,	(aytaylik,
doubtful	shubhali
Appreciation.	minnatdor.
receiving	olgandan
Appreciation	minnatdor,
8000	8000
Comet	Kometa
do not	kelmaymiz,
html>	joshuaf@yang.earlham.edu
Pioneers	Kashshoflar
file	fayl
SETVER.EXE	SETVER.EXE
&amp; Quot;	&quot;o&#39;sha
html>	munns@cae.wisc.edu
I would like to	istayman
Model	Model
e-mail	e-mail
IMHO	IMHO
Square	maydonida
escape,	qochish,
Mars	Marsda
features;	xususiyatlari;
realization	ro&#39;yobga
html>	Steve.Shapiro@f440.n101.z1.fidonet.org
Brenner)	Brenner)
France	Fransiya
years	yillarning
be sold	sotiladi
Siemon	Siemon
features.	xususiyatlari.
features	xususiyatlari,
parts	qismlar
pop &amp; quot ;.	pop&quot;.
the collapse of	parchalanib
equipment	uskunalar
&amp; Quot;	&quot;qismiga
Jesus)	Isoning)
XR250L	XR250L
Andreas	Andreas
Asteroids	Asteroitler
cause	kelishi
comes,	kelsa,
Lo!	Lo!
(Juan	(Xuan
Terra	Terra
list	ro&#39;yxat
Mormonism	Mormonizm
static	statik
Luis &amp; gt;	Luis&gt;
clay	loy
of course,	albatta,
rifle	miltiq
of course.	albatta.
Patricia	Patricia
&amp; Quot; systemic &amp; quot;	&quot;tizimli&quot;
junk	arzimas
Terrorism	Terrorizmga
occurred	ro&#39;y
player.	futbolchi.
&amp; gt; &amp; gt;	yilda&gt;&gt;
Are you curious.	berasiz.
p.s.	p.s.
Scientists	Olimlar
yeast	xamirturush
started	boshladi
(Sorry,	(Uzr,
formula	formuladan
&amp; Lt; Apr.9.01.09.22.1993.16580@athos.rutgers.edu&amp;gt;	&lt;Apr.9.01.09.22.1993.16580@athos.rutgers.edu&gt;
fool	ahmoq
share	baham
air-bag	havo-paket
&amp; Gt;	Ulardan&gt;
killed	o&#39;ldirilgan
Japanese	Yapon
acetylene,	atsetilen,
reboot	reboot
matters	holatlardan
original	original
torre	torre
bad	yomon
nissan	nissan
is.	bo&#39;lishidir.
really?	albatta?
Similarities	o&#39;xshashliklar
to	qilishi
Invisible	ko&#39;rinmaydi
Mission	Missiya,
Cisco	Cisco
information	axborot
]	qilish]
Lin	Lin
unlock	qulfni
Hello,	Salom,
to be	bo&#39;lishi
browser	brauzer
Field &amp; gt;	Voizlik&gt;
Korenek	Korenek
(Ryan	(Ryan
Square	maydoniga
southeners	southeners
_ARE_	_ARE_
marginal	chekka
volcanoes	vulqonlardan
%: &amp; gt; &amp; gt;	foizi:&gt;&gt;
probably	ehtimol,
human,	inson,
weapons	qurollar
orbit	orbitasining
decorated.	bezatilgan.
html>	192.100.81.100
Mars	Marsga
.	qilish.
3 &amp; quot ;,	3&quot;,
to	qilish,
windows	derazalar
html>	lmh@juliet.caltech.edu
magic	sehr
.	bo&#39;lish.
Now,	endi,
point	nuqtasi
The amplifier	yükseltici
telescopic	teleskopik
are not	emaslikda
Federal	federal
Davis	Davis
Internet:	Internet:
planet	sayyoramizga
Clear	Aniq
reached.	yetib.
repopulation	repopulation
After all,	Axir,
players	futbolchi
Mail:	Mail:
Under the influence	ta&#39;sirida
,	bo&#39;lish,
is set	lsa
packing	o&#39;rash
David	David
the possibility of	ehtimoli
December	Dekabr
(Starowl@a2i.rahul.net)	(starowl@a2i.rahul.net)
(Please	(iltimos
increase	oshirish,
among	orangizda
weight,	og&#39;irligi,
&amp; gt;	kabi,&gt;
explanation	tushuntirish
Planetology	Planetoloji
PCX,	PCX,
link	aloqa
Back &amp; quot;	Orqaga&quot;
???	???
Physician &amp; quot;	tabib&quot;
(Help!)	(Yordam!)
fungal	zamburug&#39;li
5-7)	5-7)
generous	saxiy
the impact of	ta&#39;sirini
hold	turing,
&amp; Lt; May.7.01.08.16.1993.14381@athos.rutgers.edu&amp;gt;	&lt;May.7.01.08.16.1993.14381@athos.rutgers.edu&gt;
the apostles,	havoriylar,
reliability	ishonchliligi
flood,	sel,
John	Yuhanno
The burden of	yuki
Pittsburgh	Pitsburg
Prism	Prism
appreciation	baho
&amp; Quot; Buy	&quot;Buy
glaciers:	muzliklarning:
(225	(225
Things	Things
the sky	osmonda
n	qarsillamoq
you	sizlarga
Definitely	Albatta
Beyond,	Beyond,
created	yaratilgan
man	kishining
Now.	endi.
NatLamp	NatLamp
Bucky	Bucky
Sex	jinsi
,	holda,
intercession	shafoatga
the parameters	parametrlarini
household size	uy-o&#39;lchamli
5-6.	5-6.
barely	zo&#39;rg&#39;a
N81	N81
)	holda)
Canaveral	Canaveral
port	port
does not	qilmasa,
We are proud	faxrlanamiz
... &amp; Gt;	...&gt;
prince	shahzoda
tumor.	shish.
talking	gaplashib
sticky	yopishqoq
orbital	orbital
time	safar
The circulation	muomalasi
patients	bemorlarni
Passengers	Yo&#39;lovchilardan
fulfilled	bajo
gaseous	gazsimon
).	deb).
post	post
(Life	(Life
recently	yaqinda
glass	shisha
(West	(g&#39;arbiy
html>	m-it2691@DOC.CS.NYU.EDU
If you	ekansiz
Tangent	chiziqlarga
market	bozorida
See.	qarang.
you	seni
NASA	NASA,
photographs	fotosuratlarni
(The sun	(quyosh
pair	er-xotin
What?	Nima?
charity.	xayriya.
secrets	sirlarini
cents	sent
Novel	Roman
What,	Nima,
--------------------------- &amp; Gt;	---------------------------&gt;
I know.	bilaman.
html>	folta@well.sf.ca.us
&amp; Quot; likely	&quot;munosib
Dead	O&#39;liklar
pedal,	pedalına,
barren	bepusht
Landmann)	Landmann)
with	bilan,
.	bilan.
I know,	bilaman,
Palestine	Falastinda,
writing,	yozishni,
Symbolisme	symbolisms
(Blaise	(Blez
)	bilan)
Tidser	TIDSA
dentin	dentin
Triton	Triton
Corfe	kuchining
do you think?	o&#39;ylaysiz?
coordinates	koordinatalarini
Pan-European	Pan-Evropa
1742	1742a
&amp; Quot; standard &amp; quot;	&quot;standart&quot;
crusher	soluvchi
need	muhtoj
discipline	intizom
two,	ikkala,
Sensitivity	jilo
Christians	Masihiylar
Loc	Loc
Rhode Island	Aylend
; &amp; gt;	bo&#39;ladi;&gt;
===================================	===================================
(800)	(800)
unstable	beqaror
standard,	standart,
general	umumiy
Magellan	Magellan
funny.	kulgili.
play	o&#39;ynashga
CHARON	CHARON
card	karta
sources	manbalarini
millions of	millionlab
welshed	welshed
rippled	dalgalıdır
from	boshlab,
Schaufenbuel)	Schaufenbuel)
enemies	dushmanlari
abuse	suiiste&#39;mol
freezes,	qaytmoqda,
LM350T	LM350T
called	nomlangan
expense	hisobidan
the path	yo&#39;lini
randomized,	randomize
I believe,	ishonaman,
a source	manbaidir
to be	bo&#39;lish
system	tizim
employer	beruvchi
I believe that.	ishonaman.
opposition	qarshilik
I thought	o&#39;ylardim
types)	turdagi)
the complexity of the	murakkabligi
proposal	taklif
Sermons	Va&#39;zi
doing	qilyapsan,
doing.	qilyapsan.
volts	voltgacha
iron-rich	temir-boy
18EB	18EB
(Norway)	(Norvegiya)
&amp; Gt ;,	&gt;,
Monte,	o&#39;rnatilgan,
point	nuqtaga
humility	kamtarlik
doing &#39;	qilyapsiz»,
sure	amin
Postbus	Postbus
the personality	shaxsi
oath	qasam
mass	ommaviy
&amp; Quot;	&quot;hal
charge.	tariflanadi.
{Uunet	{uunet,
comfortable	qulay
Exit	Chiqish
vapor	bug&#39;ining
atheism	ateizm
Fort	fortay
explained	bayon
life	hayotimda
-km	-km
///	///
Conduct	Boshlovchi
Moses&#39;	Musoning
MC05A	MC05A
.signature	.signature
(Next	(keyingi
circumstances	vaziyat
mag	mag
Rind	Rind
rotation	aylanish
meet	kutib
know	bilingki
River	River
man	man
the legs	oyoqlari
return	qaytishingiz
the patient	bemorning
(Billy	(Billy
It is	etiladi
The production of	chiqarilishi
personal-computer	shaxsiy-kompyuter
wheel	g&#39;ildirak
offer.	etamiz.
Bosham	izsiz
as long as	modomiki
irregularities &amp; gt;	nosimmetrikliklar&gt;
speed	tezligini
Matt &amp; gt;	Matt&gt;
sysops)	hizmatkorlari)
10--	10--
Honda	Xonda
html>	gt4417a@prism.gatech.edu
Jeans	gravitatsiyaviy
MWm	MWm
the existence of	mavjudligining
the dead	o&#39;likdan
Saturn	Saturn
I say,	aytaman,
point	nuqtada
I heard.	eshitdim.
decreases.	tushiradi.
Borland	Borland
Once,	marta,
Expo	Expo
analysis	tahlil
times.	marta.
generators,	generatorlari,
refugees	qochqinlar
In addition,	tashqari,
)	tashqari)
Terminal	Terminal
motives	niyatlarda
On behalf	nomimdan
&amp; Quot; beat &amp; quot;	&quot;kaltaklashdi&quot;
but	ammo
month.	oylik.
talking &amp; gt;	gapiryapsiz&gt;
(Update):	(yangilash):
years	yoshda
electromechanical	elektromexanik
**************************************************	**************************************************
I know	bilaman
EISA	EISA
Error	Xato
(How	(Qanday
revealed	vahiy
bodies	organlari,
Jump	harakatlanish
Gregory	Gregory
-------------------------------------------------	-------------------------------------------------
dark,	qorong&#39;u,
(Elaine	(Elaine
Photoelectric	fotoelektrik
scam	hünirini
death	o&#39;limi
Considering the	inobatga
sensors	datchiklari
I	men
host	mezbon
you can not find	topmasangiz
times)	marta)
parallel	parallel
questions	savollarga
last	oxirgi
rock	qoyaga
departure	ketish
signals	signallari
secular	dunyoviy
again))	yana))
comets,	kometalar,
Practice &amp; gt;	amaliyot&gt;
___________________	___________________
survey	so&#39;rovda
achieve	erishish
but &amp; gt;	ammo&gt;
death.	o&#39;lim.
html>	lmh@shakes.caltech.edu
chips,	chips,
promises	va&#39;dalari
Joshua	Joshuaf
shirt	ko&#39;ylak,
target	maqsad
Deal of	bitimi
spouse	xotin
observed.	kuzatilgan.
black	qora,
I	Men
23:17:25	23:17:25
as	go&#39;yo
html>	Cl056@cleveland.Freenet.Edu
&amp; Lt; pgf.735012282@srl03.cacs.usl.edu&amp;gt;	&lt;pgf.735012282@srl03.cacs.usl.edu&gt;
Great	Great
Reseller	dileriga
Companion	sahobaning
Have you?	Sizchi?
Meg	Meg
live.	yashamadi.
additional	qo&#39;shimcha
immaculately	pokiza
planet	sayyoramizni
photos	suratlarni
Wind	Shamol
NHL	NHL
&amp; gt;	bu&gt;
sattellite	sattellite
Coupons	kuponlar
Add	qo&#39;shish
Toronto	Toronto
&#39;All	«barcha
should	lozim
teacher,	o&#39;qituvchi,
Input &amp; gt;	kirishlar&gt;
Mariners	Mariners
traditions	an&#39;analarini
channels	kanallari
Future	Future
bullshit	saçmalýklarý
EUROPA	EUROPA
Parson	Parsli
planet,	sayyora,
state.	davlat.
the planet.	sayyora.
Guthrie	Guthrie
not	bo&#39;lmasa
atheist	ateist
About	haqida
rings	halqalarni
Windows	Windows
planned	rejalashtirilgan
transportation	tashish
the inputs	kirishlar
treatment	davolash,
(Goods	(tovarlar
biological	biologik
objects	ob&#39;ektlarini
Department	bo&#39;limi
Treatment)	davolash)
ask	so&#39;raysizlar
buttons	tugmalari
bankrupt	bankrot
remains.	qolmoqda.
Cliffs	cliffs
Williams	Williams
individual	individual
definitely	albatta
SMARTDRV.EXE	SMARTDRV.EXE
Read more.	o&#39;qing.
cores	yadrolari
Greg,	Greg,
^^^^^^^^^^^^^^^^^^^^^^^^^^^^^	^^^^^^^^^^^^^^^^^^^^^^^^^^^^^
offers	etadi
Treatments	yordamni
out	olib
html>	km@cs.pitt.edu
Kevin	Kevin
shows	ko&#39;rsatadi
speed	tezlik
missions	missiyalari,
Man	Man
American	amerikalik
Mariner	Mariner,
Example	Misol
NCI	NCI
)	etiladi)
formation	shakllantirish,
Mac	Mac
experiments	tajribalar
It is,	etiladi,
view	versiya
The poster	plakat
.	etiladi.
Words &amp; gt;	va&#39;dalari&gt;
past	o&#39;tmish
transmits	uzatadi
Christianity	Xristianlikni
elements	elementlar
Below	Pastda
html>	rls@uihepa.hep.uiuc.edu
right,	to&#39;g&#39;ri,
Keyboard,	Klaviaturadan,
letting.	qoldirardi.
soon	o&#39;tmay
anti-days	anti-kun
May	May
future	kelajak
Assuming &amp; gt;	faraz&gt;
initiation	boshlash
I do not understand.	tushunmadim.
html>	ethan@cs.columbia.edu
scientist	olim
NET	NET
people	kishilarga
stored	saqlanishi
remote	olis
winds	shamollarni
orange	apelsin
(Benedict	(Benedikt
certain	muayyan
[Human]	[insoniyat]
supreme	oliy
satisfaction.	qondirish.
latest	so&#39;nggi,
the dead	o&#39;liklarni
stay	qolish
tutor	tarbiyachimiz
authorities	hokimiyat
,	ushlab,
--------------------------------------------------	--------------------------------------------------
and &amp; gt;	va&gt;
city	shahrida
teams	jamoalarning
shack	shack
&amp; Gt; &amp; gt; &amp; gt; &amp; gt; &amp; gt;	&gt;&gt;&gt;&gt;&gt;
closure	yopish
activity	faoliyat
death	o&#39;lim
dead	o&#39;lik
along	bo&#39;ylab
1970	1970
Input	Kirish
I am happy	xursandman
in:	ichida:
1971	1971
Accordingly,	doirada
decision	qaror
1972	1972
1973	1973
1974	1974
1975	1975
(Re:	(Re:
1976	1976
someone	birovga
1977	1977
1978	1978
1979	1979
)	ichida)
secretly	yashirincha
Instruments	Instruments
C.O.D.	C.O.D.
pit	chuqurga
_____________________________________________________________________	_____________________________________________________________________
I learned.	o&#39;rgandim.
- &amp; Gt; &amp; gt;	-&gt;&gt;
The compounds	aralashmalar
1990	1990
alyoung@kiwi.ucs	alyoung@kiwi.ucs
view	ko&#39;rinish
goods	mol
countries	mamlakatlarida
1983	1983
1980	1980
1981	1981
doctor	shifokor
1986	1986
headed	boshchiligidagi,
suitable	mos
1984	1984
1985	1985
486/33	486/33
1989	1989
pitied	achingan
Hiroshi	Xiroshi
unsuccessful	muvaffaqiyatsiz
April	Aprel
too	judayam
mention	qayd
(Red	(Red
But	Ammo
(HAWK	(HAWK
parables	masallar
treatment	davosi
cold	sovuq
&#39;Impartial&#39;	«xolis»
1995	1995
change	o&#39;zgarish
manager)	boshqaruvchiName)
1991	1991
in diameter	diametri
incurable	bedavo
1992	1992
1993	1993
LM350K:	LM350K:
drivers license	haydovchilar-litsenziya
1994	1994
I did not know.	bilmasdim.
army	armiya
1999	1999
| &amp; Gt;	|&gt;
brother	birodarim
remote	uzoqdan
Help:	Yordam:
Gay	xunasa
Security &amp; quot;	xavfsizlik&quot;
Accepted	Qabul
ZENON	ZENON
Phone	telefonni
Note	Note
?	kerakmi?
Answers.	Javoblar.
continuation	davom
Alicelik	Alicea,
die	o&#39;lib
3:31	3:31
city	shahridagi
&amp; Lt; 1993Apr22.153000.1@vms.ocom.okstate.edu&amp;gt; &amp; gt;	&lt;1993Apr22.153000.1@vms.ocom.okstate.edu&gt;&gt;
Mount	Mount
Shower &amp; gt;	dushman&gt;
Institute of	instituti
acids	kislotalar
------------------------------------------	------------------------------------------
(360	(360
synchronization	hamohang
cells	hujayralar
MacRae	MacRae
prompt,	irodasi
Czech)	bordik)
region	viloyatida
&amp; gt;	emas&gt;
countries	mamlakatlariga
by region	hududga
Gases	Gazlar
If.	bo&#39;lsangiz.
&amp; Lt; thomasp@ifi.uio.no&amp;gt;	&lt;thomasp@ifi.uio.no&gt;
If	bo&#39;lsangiz,
disappearance	yo&#39;qolib
printers,	ulamolar
html>	carl_f_hoffman@cup.portal.com
the house	uyiga
The sun	Quyoshdan
rules	qoidalari
html>	jodfishe@silver.ucs.indiana.edu
html>	shapiro@sofbas.enet.dec.com
&amp; Quot; &amp; quot;	&quot;biznes&quot;
the elements	unsurlar
Fotokimya	Fotokimya
hostile &amp; quot;	dushmanlik&quot;
the implementation of	bajarilishi
students	o&#39;quvchilar
crimes	jinoyatlar
Reading	O&#39;qish
period	davri
harmful	zararli
planning	rejalashtirish
Observer	Observer
returns	qaytadi
commission	komissiya
hydrogen	vodorod
a matter of	masalasidir
visit	ziyorat
worth.	arziydi.
Kawaguchi,	Kawaguchi,
Bell-Northern	Bell-Shimoliy
Of the church	Jamoatning
... &amp; Gt;	....&gt;
distance,	masofalarga,
The theory of	nazariyasi
Ezekiel)	Hizqiyo)
-----------------------------	-----------------------------
(Larry	(Larry
arrogance	kibr
Steve.	Steve.
stars	yulduzlar,
,	bo&#39;lib,
including	jumladan
distant	uzoqdagi
Diffie-Hellman	Diffie-Hellman,
html>	slegge@kean.ucs.mun.ca
the interpretation of	talqin
pictures	suratlar
NASA	NASA
Training &amp; gt;	tayyorlash,&gt;
honor	sharafini
them,	ularni,
ice	muz
Evolution	Evolution
places	joylari
summary	xulosa
antique	qadimiy
fate	taqdir
Mom)	ota-)
sales,	sotish,
follow	amal
that&#39;s	yotipti
Urania	Uranian
Ctrl-Alt-Del	Ctrl-Alt-Del
devices	asboblari
form	shakl
freedom	erkinlik
submitted	taqdim
different,	turli,
Retrograde	retrograd
in vain,	behuda,
. &amp; quot;	va.&quot;
(323	(323
product	mahsulot
Even	Hatto
common	tarqalgan
places	joylarni
the impact of	ta&#39;siri
society	jamiyatda
Kou)	Kou)
Ariel,	Ariel,
materials.	materiallar.
====================================	====================================
at least,	bo&#39;lmasa,
history	tarix
(Earth	(Earth
primitive	sodda
dies	o&#39;lsa
runner	yuguruvchi
CHIPS	CHIPS
difficult.	qiyin.
Steven	Steven
I do not understand.	tushunmayman.
leave.	tark.
theists	theists
headache	og&#39;rig&#39;i
5.25	5,25
different?	turli?
Nicji	Nicji,
difficult,	qiyin,
-dk	-dk
film	kino
The implied	shama
the arrival of	kelishidan
immoral	axloqsiz
God&#39;s	Xudoning
My	My,
beauty	go&#39;zallik
(No	»(yo&#39;q
affect	ta&#39;sir,
Without the help of	yordamisiz
Sunday	yakshanba
Volcanism	Vulkanizm
texts	matnlari
given	berildi,
ultimate	yakuniy
Spindle	mil
vertical	vertikal
Replace	almashtirish
laptop	cho&#39;kkan
history	tarixga
literature	adabiyotni
in vain.	behuda.
Lamp,	chiroq,
high	yuqori
(818)	(818)
As far as	O&#39;qisak
history.	tarixi.
Jews,	yahudiylar
templates	andozalari
Christians:	masihiylarga:
statement	iboralar
... &amp; Quot;	...&quot;
in the way	yo&#39;lida
Therapy	qutulmoqchi
density	zichlikdagi
history,	tarixi,
Crater	Crater
1938	1938
March &amp; gt;	Mart&gt;
Who?	kim?
MLS	mls
&amp; gt; &amp; gt;	chunki&gt;&gt;
info	ma&#39;lumotlari
In 1930	1930
forward	orziqib
one of the	birining
committed	sodir
Christianity	Masihiylikda
martin	martin
about	haqingizda
&amp; gt;	bunday&gt;
will	qo&#39;yadi
,	keldi,
.	keldi.
Jesus	Isoga
Gravitational	Gravitational
1947	1947
1949	1949
1948	1948
Fine	Fine
tens of	o&#39;nlab
of speculation	spekülasyon
stations	stantsiyalarda
Enterprise	Enterprise,
the disease	kasallikning
Lovers)	sevganlar)
&amp; Quot; patients	&quot;bemorlarning
copy	nusxa
Mr.	Mr.
said,	aytilmoqda,
the planets	sayyoralarning
Small	kichik
countless	sanoqsiz
Technology	Technology
1959	1959
1958	1958
restored	tiklanadi
)	bilan),
motorcycle	mototsikl
sever	zaiflashishi
(Yeast)	(xamirturush)
astronomical	astronomik
the site	saytida
Depending on the	qarab
engineer	muhandis
Checker	tekshiruvi
from the sky	osmondan
when,	qachon,
when.	qachon.
ear	quloq
time	vaqtning
at least	kamida
&amp; gt;	hisoblanadi&gt;
Barry	Barry
everywhere	bo&#39;lishidan
I came	keldim
INFJ	INFJ
errors	xatolar
===========================	===========================
1967	1967
1969	1969
1968	1968
I do not,	chiqmaysiz,
1962	1962
I do not.	chiqmaysiz.
1965	1965
someone	birovni
1964	1964
Who,	kim,
:	keldi:
Extensions	kengaytmalari,
against	qarshi,
a member of the	a&#39;zosi
(Ray	(Ray
INF)	INF)
I&#39;d like to.	qilmoqchiman.
Despite the	qaramay
(310	(310
I am going to	ketyapman,
----------------- &amp; Gt; &amp; quot;	-----------------&gt;&quot;
developed.	rivojlangan.
ancient	qadimgi
(&amp; Quot; apparent	(&quot;zohiriy
