Fayllar	ملفات
yuzdan	مائة
XR650L	XR650L
taklifni	اقتراح
(Erik	(إريك
&quot;bulut	على &amp; quot؛ سحابة
535	535
rivojlantirish	تنمية
Kosmosdan	الفضاء
ruhoniylikni	كهنوت
jet	طائرة نفاثة
jilo,	حساسية
pochta	بريد
orbitalar	أوربت
#	#
mehnat,	العمل،
Guruhlar:	مجموعات:
James	جيمس
noyabr	تشرين الثاني
$	$
*	*
Yagona	فقط
+	+
(Jon	(جون
(	(
shimoliy-janubiy	الشمال والجنوب
)	)
accusors	accusors
&quot;bo&#39;sh	على &amp; quot؛ فارغة
Team	فريق
.	.
RKBA	RKBA
/	/
,	،
mahbuslar	السجناء
-	-
natijasida,	ونتيجة لذلك،
3	3
2	2
qaytdi	عاد
1	1
7	7
6	6
5	5
odamni	رجل
4	4
:	:
9	9
8	8
&lt;94318@hydra.gatech.EDU&gt;	العلامة &amp; lt؛ 94318@hydra.gatech.EDU&amp;gt.
ma&#39;no	معنى
Gauche	أخرق
=	=
spec	المواصفات
D	D
Kickback	رشوة
Norvegiyada	النرويج
muhitni	البيئة
E	E
F	F
SetWUTime	SetWUTime
@	@
A	A
B	B
qo&#39;llaydi	الدعم
C	C
L	L
faoliyati&gt;,	وGT،،
tufayli,	لأنه،
M	M
H	H
I	أنا
tufayli.	.
J	J
U	هو
T	تي
tarbiyalang.	تثقيف.
&quot;Men	على &amp; quot؛ I
(713)	(713)
Q	Q
S	S
R	R
(balki,	(ولكن،
\	\
_	_
^	^
bosish	الضغط
hukumat	حكومة
X	X
qo&#39;lga	مزلاج
1846	1846
ongli	واع
mmm@cup.portal.com	html>
asboblarini	أدوات
g	ز
c	ج
a	ل
&lt;1r10jcINNt1g@lynx.unm.edu&gt;	العلامة &amp; lt؛ 1r10jcINNt1g@lynx.unm.edu&amp;gt.
berilmaydi	ليس
yilda	في
tarkibda	فرقة
o	س
aholiga	السكان
narxi	سعر
m	م
ixcham	ميثاق
i	ط
uchish	طيران
w	ث
v	الخامس
u	هو
so&#39;zlashish,	حديث
empirik&gt;	التجريبية وGT.
520	520
p	ص
Stiv	ستيف
~	~
qanotga	وكيل
|	|
x	س
yutuqlar	الإنجازات
og&#39;irligi	الوزن
Wonder?	أتساءل؟
yoqdi	أعجبتني
g&#39;arbiy	الغربي
karakollardan	البؤر الاستيطانية
Melnick)	ميلنك)
uzoq,	منذ فترة طويلة،
shohlik	مملكة
&quot;ochiq&quot;,	على &amp; quot؛ فتح &amp; مثل؛،
bosimi	الضغط
muharriridan	المنظمين
JPEG,	JPEG،
qayta,	،
0.14	0.14
ocom.okstate.edu	html>
MAX641	MAX641
580	580
Adam	آدم
GIF	GIF
rahbar?	الزعيم؟
583	583
tuproqli	تأريض
va&#39;dalarining	وعود
darajasi:	معدل:
(__)	(__)
olishga,	من
haddan	مفرط
&quot;vaqtinchalik	على &amp; quot؛ مؤقتا
hisobot	تقارير
hududlarida,	المناطق،
ochiq.	مجانا.
raqami:	عدد:
ochiq,	مفتوحة،
XBell	XBEL
chiziladi	مسحوب
Quyosh,	الشمس،
brigadasi	لواء
tufaylidir.	بسبب ذلك.
559	559
muntazam	منتظم
hududlarida	المناطق
birga,	ومع ذلك،
yo&#39;qotish	خسارة
xabardordir	علم
Sugar	سكر
kompaniyalari	الشركات
lpt1	LPT1
giyohvandlik	إدمان
aytaylik	أقول،
o&#39;tadi.	سيكون.
materiallar	المواد
va&#39;z.	الوعظ.
aholining	السكان
zaryadlangan	متهم
xotirasida	الذاكرة،
bosing	انقر
pgf@srl02.cacs.usl.edu|Like	pgf@srl02.cacs.usl.edu|Like
olingan.	.
ostida	أقل من
kashshof,	الرواد،
Division	تقسيم
boshchiligida	بقيادة
sifatida	كما
guys,	الرجال،
okean	المحيط
yo&#39;nalishda	اتجاه
yaqin	قريب
(Artur	(آرثر
kengligi	عرض
Tasco	TASCO
murojaatlarni	المراجع
DR250ES	DR250ES
suhbatlashdi.	وتحدث.
murakkab	صعب
vesterman.	الغربية.
dinim	دين
maqtana	تباهى
&gt;&gt;	وطن؛ &amp; GT؛
ichidagi	في
ildizlari,	الجذور،
muhitda	بيئة
zichligi	كثافة
diniy	ديني
oqimining	تدفق
ko&#39;rishadi.	نرى.
Payg&#39;ambar;	النبي.
Detriot,	المخلفات،
identifikatorlari,	معرفات
bo&#39;limi&gt;	الرعاية &amp; GT؛
PATH	PATH
shunchaki	فقط
etilgan.	.
ma&#39;no,	معنى،
meni	لي
hisobga	مع الأخذ بعين
QURILMA	DEVICE
sirli	غامض
termoq	المعادلات التفاضلية
o&#39;rtacha	متوسط
Falastinliklar	الفلسطينيين
shubha.	مما لا شك فيه.
sotuvchi	بائع
suyuq-suv	الماء السائل
og&#39;ir-qarab	ثقيلة المظهر
issiqxonada	دفيئة
orasida,	بين
joy	مكان
tozalaydi,	نظيفة،
tushunchasini	مفهوم
mumkin&gt;	وGT.
qaytib	إلى الوراء
ma&#39;noda,	المعنى،
raqami	عدد
vakolatxonalar	مكاتب
bulutlar	سحاب
Converter	تحويل
integratsiya	التكامل
xil&gt;	وGT.
internet:	الإنترنت:
kiradi	تشمل
&quot;xamirturush	على &amp; quot؛ الخميرة
bayon.	وأوضح.
010-A	010-A
mustasno	استثناء
men,	أنا
dizaynlashtirilgan	التصاميم
qilinadi	سيكون
majbur.	المطلوبة.
mahkum	أدان
4H7	4H7
falsafiy	فلسفي
g&#39;arbga	غربا
eski	قديم
echilishi	مقدمة
indepth	وراء الخبر
sozlanmasi	الإعداد
1ff&gt;	1ff &amp; GT؛
Bo&#39;lishi	أن تكون
Hozirgi	تيار
Quyoshga	الشمس
eshik&quot;	باب ومثل؛
Tibbiyot	دواء
NASAning	وكالة ناسا
jip	CIP
boshlash)	ابدأ)
mulk	ممتلكات
bordik	ذهبنا
Neptune	نبتون
&quot;oq	على &amp; quot؛ الأبيض
ko&#39;tardi.	المثارة.
olmas.	بكثير.
to&#39;g&#39;risida	حول
tranfer	ميرين
qismlariga	المكونات،
daqiqa.	دقيقة.
yo&#39;nalishi,	الاتجاه،
&quot;hislar&quot;	على &amp; quot؛ بمعنى ومثل؛
orolida,	في الجزيرة،
davrning	فترة
DOUBLE_BUFFER	DOUBLE_BUFFER
500	500
&quot;muqobil&quot;	على &amp; quot؛ البديل &amp; مثل؛
hujayra	خلية
--------------------------------------------	--------------------------------------------
12:26	00:26
Aslida,	في الواقع،
unumdor	إنتاجية
P.s.	سكرتير خاص
Edmond	إدموند
Iroq	العراق
ta&#39;siridan	آثار
tizmasiga	محور
nusxasini	نسخة
mezbonlar	المضيفين
ish.	الأعمال.
kludgy,	kludgy
cometa	المذنب
kengaytirish	توسع
Neptun,	نيبتون
drum	طبل
qopqoq	غطاء
5,7	5.7
kuzatuvchilar	المراقبين
Stein)	شتاين)
chaqirdi)	ودعا)
5.0	5.0
namuna	عينة
variantlari	خيارات
1870	1870
mashinasini	الكاميرا
^^^^^^^^^^^^^^^^^^^^^^^^^^^^^^^^^^^^^^^^^^^^^^^^^^	^^^^^^^^^^^^^^^^^^^^^^^^^^^^^^^^^^^^^^^^^^^^^^^^^^
763-5889	763-5889
Ro&#39;yxatdan	تسجيل
berilmaydi,	ليس
avgust	آب
3:&gt;	3: &amp; GT؛
qiziqarli	ممتع
qo&#39;l	يد
olasizmi,	هل
timmbake@mcl.ucsb.edu	html>
qilishga	إلى
olasizmi.	هل.
Window	نافذة
Kabolsuz	Kabolsuz
Cyrix	بنتيوم
aksincha	على العكس تماما
uchida	في نهاية
maslahat	نصيحة
va&#39;dasiga	الوعد
olasizmi?	من أنت؟
xudosi	إله
olamlar	العالم
arxeologiya	علم الآثار
orollari	الجزر
nashr	منشور
16-169	16-169
jihatidan	من حيث
bazasi	قاعدة البيانات
quyosh	شمس
Deyarli	تقريبا
ulanish	صلة
mavsumiy	موسمي
nazorati&quot;	التحكم ومثل؛
1ff,	1ff
tashvishlanib	ما يدعو للقلق
mingdan	ألف
ilmiy-fantastik	الخيال العلمي
zahirasi	احتياطي
Etc	الخ
tushunib.	شرح.
pastga	أسفل
yahudiylar&gt;	اليهود وGT.
qilishim	فعل
kontaktlar	اتصالات
Cyric	Cyric
NUETZMAN	NUETZMAN
qamchilagan	يلات
Yozuvlarga	الكتب
erda,	هنا،
sharoitida	الشروط
Ero	الجيش الجمهوري الايرلندي
FTP	FTP
erda.	هنا.
davolanish	علاج
&lt;sl3b+@andrew.cmu.edu&gt;	العلامة &amp; lt؛ sl3b+@andrew.cmu.edu&amp;gt.
(plus,	(زائد،
qabul	مسلم بصحته
mo&#39;ljallangan	تصميم
e&#39;tiqod	دين
Honda	هوندا
superencipherment	superencipherment
vaqti-vaqti	من آن لآخر
&lt;1rbn60$gs7@usenet.INS.CWRU.Edu&gt;	العلامة &amp; lt؛ 1rbn60$gs7@usenet.INS.CWRU.Edu&amp;gt.
Kanada,	كندا
bo&#39;ladi&gt;	وGT.
irim	خرافة
alohida	فصل
hayotida	الحياة
nasli	انحطاط
vaqt	مرة
tugagach	في نهاية
(82,178	(82178
Inson	الإنسان
topaklı	محفر
vaqo	لا شيء
bir-biridan	واحدة-
(«real»	(&#39;ريال مدريد&#39;
Panjobcha)	البنجابية)
maxsus).	خاص).
mahsuldorlikka	إنتاجية
ilg&#39;or	متقدم
kerak	ينبغي
quvonamiz.	نفرح.
muhabbat	حب
noring@netcom.com	html>
otilishiga	طرد
688-8231	688-8231
energiyasi,	الطاقة،
XXX	XXX
anglatdi.	دخل.
uchib,	طيران
kometa,	المذنب
uchib.	الطيران.
muzlatib.	المجمدة.
thumb	إبهام اليد
hays@ssd.intel.com	html>
og&#39;irroq	أثقل
fikrlar.	الآراء.
...........	...........
Kimnidir	شخص ما
soni	عدد
joriy	تيار
pastki	أدنى
bor&gt;	وGT.
esa,	،
ish	عمل
taslim	استسلام
Quyoshni	الشمس
&quot;men	على &amp; quot؛ I
Tsai)	تساي)
qilinadi.	.
Earth	أرض
mavjud	متاح
taqqoslab,	مقارنة،
11:25	11:25
yanada	المزيد
(604)	(604)
tovonini	كعب
GMT&gt;:	GMT &amp; GT؛:
bosmoqchi	غمرت
sevinglar	سيفيم
yondirib,	حرق
Pilat	بيلاطس
tafovutlar	الخلافات
trafikni	مرور
PPM,	PPM
narsalarni	أشياء
tuproqqa	تربة
o&#39;yinchoqlar	اللعب
qaradi,	نظرت،
yaqinroq	أقرب
gapiradigan	الكلام
qurol	سلاح
tegish	لمس
qiyin	من الصعب
PowerPC	باور
o&#39;ng&gt;&gt;	الحق وGT؛ &amp; GT؛
(xotira	(الذاكرة
kelayotgan?	قادمة من؟
Muolajalar	العلاجات
ro&#39;yxatdan	تسجيل
zo&#39;ravon	عنيف
o&#39;zlari	أنفسهم
&lt;rauser.734062608@sfu.ca&gt;	العلامة &amp; lt؛ rauser.734062608@sfu.ca&amp;gt.
Crawford)	كروفورد)
Rind)	قشرة)
Internet	الإنترنت
moyli	زيتي
============ECHO	============ ECHO
kechqurun,	في المساء،
biznes	عمل
o&#39;chirilgan	حذف
AYNAN	بالضبط
talabalar	طلاب
premade	Topspeed
sol.	تنظر.
halqalar	خواتم
qit&#39;ada	القارات
Deydi	يقول
prob	مسبار
Pontiy	البنطي
yuqorida	فوق
qilmoq	جعل
Tomas	توماس
sayohatchilar	مسافرين
mehribon)	المحبة)
Qoldi	بقي
roziligi	موافقة
tillo	الذهب
jamoasi	فريق
tarkibiy	بنيوي
diametri,	قطر،
tubsizlik	هاوية
jaskew@spam.maths.adelaide.edu	html>
unutilmas	لا ينسى
Eng	معظم
​​Venera	فينوس
Psevdo-o&#39;qituvchi&gt;	وGT-المعلمين الزائفة.
Clint	كلينت
fotosuratlar	تصوير
ochiq-oydin	واضح
Technologies,	التقنيات،
teging	صنبور
Accord,	اتفاق
vazn	الوزن
biseksüel	المخنثين
Jordan	الأردن
kutayapmiz.	تنتظر.
soha	قطاع
moyil	عرضة لل
ataladi.	دعا.
so&#39;zning	كلمة
Quddusda	القدس
eshitdim	سمعت
maqsadlari,	الأهداف،
hayotini	حياة
Marty,	مارتي
tugagan)	انتهى)
yaroqsiz	باطل
chiroq	مصباح
kulminatsion	تتويج
energiyasidan	طاقة
kaliti	المفتاح ل
1.770	1.770
percieved	percieved
NEGA	لماذا
(Ayollar	(المرأة
afsona	أسطورة
-391	-391
ning?]&quot;]	؟] ومثل؛]
Usmonlilar	العثمانيين
shifrlangan	مشفرة
hollarda	الحالات
quvnoq	مرح
Columbia	كولومبيا
ko&#39;proq,	أكثر
yirtilib	مزقتها
Original	الأصل
ko&#39;proq.	وأكثر من ذلك.
dramatik	دراماتيكي
quruq	جاف
post,	بعد
(chaqaloq	(بيبي
tug-of-urush	لعبة شد الحبل من الحرب
noaniq	غير واضح
qayiq	قارب
&amp;	والأمبير.
Dances	الرقصات
ergashish	تتبع
&lt;C5r60r.4ID@megatest.com&gt;	العلامة &amp; lt؛ C5r60r.4ID@megatest.com&amp;gt.
rscharfy@magnus.acs.ohio-state.edu	html>
ishlaydigan,	العمل
lekin	لكن
&quot;osmon	على &amp; quot؛ السماء
xizmatini	خدمة
eshitdi?	سمعت؟
G20	G20
sezilarli	بشكل كبير
«Agar	&#39;
bugungi	اليوم
oqib	تدفق
Serbiya	الصربي
Isroilga	إسرائيل
ta&#39;kidladi.	قال.
chiqarila	الإنتاج
dalil	دليل
kim	الذي
behuda	اهدر
dasturiy	البرمجيات
.4ID	.4ID
tizimiga	نظام
postlar	وظائف
Louis	لويس
o&#39;rnini	دور
boshqa	البعض
himoya&quot;	حماية ومثل؛
boshqaruvchisini	مدير
usuli	طريقة
#,	#
istasangiz,	إذا كنت ترغب في
ma&#39;nosini	معنى
&quot;xavfsizlik	على &amp; quot؛ والأمن
qobig&#39;ini	القشرة
meteoroid	نيزك
arablar	العرب
yubordi.	أرسلت.
algoritmi	خوارزمية
qilaman	أنا
ultrabinafsha	فوق بنفسجي
shug&#39;ullanadi	تشارك
354-1333,	354-1333،
niyat,	حسن النية،
#:	#:
401	401
400	400
Xo&#39;sh	هكذا
viski	ويسكي
henling	Henly
soat	ساعة
Yuqori&gt;	وطن.
bosimli	الضغط
mahalliy,	المحلية،
Cryptologia	Cryptologia
narsalarga	أشياء
omadli.	كنا محظوظين.
klub	ناد
&quot;^^^^^^^^^^^^^^^^^^^^^^^^^^^^^^^^	على &amp; quot؛ ^^^^^^^^^^^^^^^^^^^^^^^^^^^^^^^^
harakat	عمل
1.610	1610
oldindan	مقدما
qaysar	عنيد
(62-mil)	(62 ميل)
ta&#39;sir	تأثير
bezaklar	زينة
taklifi	اقتراح
javob	إجابة
foydasiz	عديم الفائدة
qilyapman!	أنا!
guruhini	مجموعة
SEVGINI	الحب
non-shifokorlar	غير الأطباء
qilyapman,	أنا
yaqindan	عن كثب
integer	عدد صحيح
sabablari	أسباب
securital	أمن
qayta	ثانية
qaralganda,	عموما،
!!	!!
qilyapman.	أنا.
erkinliklarini	الحريات
qurbonligi	تضحية
tushunish	فهم
artmel@well.sf.ca.us	html>
(______	(______
erta	في وقت مبكر
Jinoyatchilik	جريمة
qilyapman;	أنا؛
foyda	مصلحة
body	هيئة
************	************
Elvis	ألفيس
reponse	أن reponse
kimyoviy	مادة كيميائية
14-19	14-19
Milliy	مواطن
qoplama	غطاء
(Karl	(كارل
Martin,	مارتن،
qilmoqchisiz?	انت ذاهب الى القيام به؟
qaysi	التي
&lt;RVESTERM@vma.cc.nd.edu&gt;	العلامة &amp; lt؛ RVESTERM@vma.cc.nd.edu&amp;gt.
engp2008@nusvm.nus.sg	html>
funt)	الجنيه)
bo&#39;lsa,)	إذا)
Kanada	كندا
Avvalgi	سابق
ken	كين
Tech.	التكنولوجيا.
paneli,	مكتب،
bulut	سحابة
&quot;yuksak	على &amp; quot؛ عالية
amrlarning	الوصايا
dasturni	التطبيق
tanasi.	الجسم.
to&#39;g&#39;ri	صحيح
imkonini	القدرة على
35.789	35789
u&gt;	وGT.
o&#39;rni,	دور،
taklif,	العروض
salqinlash	تعيش
asrlar	قرون
to&#39;lqinlar	أمواج
dalda	مشجع
100&gt;&gt;	100 &amp; GT؛ &amp; GT؛
manbai	مصدر
chiqarib	نزع
8:31	08:31
chiqishdan	ركوب
tizimida	النظام
Evropa	أوروبا
nomlanuvchi	معروف
yubordi,	أرسلت
qo&#39;shnilari	الجيران
Jalilalik	الجليل
Boston	بوسطن
o&#39;simlik	مصنع
yalang&#39;och,	عاريا،
Sun,	الشمس،
xarajatlar	نفقات
hissiy	عاطفي
animatsiya	حيوية
inoyati	نعمة
Bunday-va-,	في مثل هذه الحالة،
xudolarga	الآلهة
liniyalarida.	خطوط.
Stassen	[ستسن]
edim	كنت
ko&#39;prik	جسر
audio	سمعي
jabbor	قهري
sabablarini	أسباب
emulyatorlarni	emulyatorlarni
chiqdi	خرج
(odatda	(وعادة ما
467	467
niyati	نية
-&gt;	- وطن.
birinchi,	أولا،
afzallik	التفوق
erigan	مصهور
e&#39;tiborsiz	تجاهل
ning	الصورة
o&#39;qib.	ش.
oltin	الذهب
ta&#39;qib,	تليها
o&#39;qib,	قرأ
osongina	بسهولة
yarim	نصف
olgan	التي
ringlets	الجدائل
kimligi	هوية
Driver	سائق
hammasi	كل
&quot;ko&#39;rish&quot;,	على &amp; quot؛ &amp; مثل؛،
adashgan	ضل
Tanlab	مختار
masofadagi	بعيد
*,	*
mantiq	منطق
gacha,	إلى
**	**
koinot	الفضاء
eriy	لإذابة
tirilmas	قيامة
Sue,	سو،
Wai	واي
Yupiter	كوكب المشتري
yilda,	في
Chap	اليسار
amalga	خارج
yilda.	في.
guruhiga	مجموعة
uyg&#39;otishning	استيقظ
Qonunni	القانون
birinchi	أولا
zaiflashtirish	المقعدة
nima	ما
(hozirga	(الآن
+1	+1
++	++
supper.	العشاء.
mavqeini	حالة
Maykl	مايكل
(A	(A
phj@remus.rutgers.edu	html>
bo&#39;ladi&quot;	ومثل؛
*************************************	*************************************
mavsumda	الموسم
bola-ligada	طفل في الدوري
look-	look-
ta&#39;minlaydi,	تقدم،
(;	(؛
amalda	عمليا
plexiglassso	plexiglassso
(:	(:
4.094	4094
tashvishlantirgandir	قلق
(?	(؟
&quot;soğukluk&quot;	على &amp; quot؛ البرد ومثل؛
franko	فرانكو
(2	(2
hozir	الآن
CSHOW	CSHOW
o&#39;rinlarini	وظائف
(1	(1
(7	(7
maqsadi	والغرض من
etgan	التي
narsa&gt;&gt;	وGT؛ &amp; GT؛
()	()
(a	(A
ba&#39;zi	بعض
egasi.	المالك.
keltirilgan	المدرجة
Magic	سحر
(\	(\
Deydilar,	يقولون،
&quot;haqiqiy&quot;&gt;	على &amp; quot؛ حقيقية ومثل؛ &amp; GT؛
Iso,	يسوع،
samoviy	سماوي
ritley@uimrl7.mrl.uiuc.edu	html>
(T	(T
professionallar.	المهنيين.
ota-o&#39;rtasida	بين الوالدين
o&#39;sadi	النمو
(I	(I
yosh-Leith)	الشباب-ليث)
),	)
Cometary	المذنبات
Puryear	Puryear
ekvatorial	استوائي
hatto	حتى
halokatli	كارثي
Qo&#39;shma	المفصل
AMERIKA	AMERICA
Maqolasidan	مقالة
platsebo	دواء وهمي
hardcore	المتشددين
amaliy	عملي
..	..
gonzaled@ucsu.Colorado.EDU	html>
Altima	ألتيما
(korenek@nmti.com)	(Korenek@nmti.com)
oqilona,	عقلانية،
tashlaydi.]	رمي.]
oshdi.	زيادة.
4,6	4.6
guruhda	المجموعات
1759	1759
Chiroq	مصباح
istagan	مرغوب
1,610	1610
barpo	بني
//	//
ko&#39;proq	أكثر
majburiyatini	التزام
tugmasini	زر
evropaliklar	الأوروبيون
ixtiyori	حرية التصرف
-!	-!
qaychi	مقص
ge!severy%severy@uunet.UU.NET	html>
ofisiga	مكتب
yilda:	في:
Farangeyt).	فهرنهايت).
Farangeyt),	فهرنهايت)،
[Gen	[الجنرال
o&#39;lasizlar	يموت
chegarasida	الحدود
xatarlar	المخاطر
algoritm,	الخوارزمية،
e-mail:	البريد الإلكتروني:
yildan	منذ
Yahudiylar	اليهود،
ILV20078@UDELVM.UDEL.EDU	html>
Gay	مثلي الجنس
bo&#39;lsa&gt;	وGT.
Sovet	السوفييتي
Cramer	كريمر
-.	-.
raster	النقطية
kalit&quot;	مفتاح ومثل؛
&quot;Borshevshky&quot;	على &amp; quot؛ Borshevshky ومثل؛
e-mail,	البريد الإلكتروني،
algoritm?	الخوارزمية؟
HCI	HCI
ma&#39;yus	حزين
Kloo	Kloo
birikmasi	مزيج من
necha	عدة
namelplate	namelplate
bor.	.
xatti:	السلوك:
bor)	)
35	35
bor,	هناك،
ofisida	في المكتب
3:	3:
&lt;1993Apr21.170403.22855@yang.earlham.edu&gt;	العلامة &amp; lt؛ 1993Apr21.170403.22855@yang.earlham.edu&amp;gt.
ko&#39;ringan	الظهور
sug&#39;orish	ري
4.	4.
sanasi	تاريخ
4,	4
King)	الملك)
42	42
bor?	هناك؟
40	40
tushunchasiga	مفهوم
cheklash	تقييد
ligini	الملون
bor:	هناك:
ishlayotgan	العمل
o&#39;ng?	أليس كذلك؟
(613)	(613)
tushgan	تلقى
dinni	دين
2:	2:
ogohlantirish.	تحذير.
anti	المضادة
turi	نوع
yarmidan	نصف
sotish	بيع
22	22
severy	سيفرن
senga	اليك
23	23
befor	قبل احتساب
24	24
25	25
TAKOZLARI	تصاعد
o&#39;zgarishlar	التغييرات
tura	موقف
26	26
Spin;	تدور.
27	27
28	28
1W	1W
29	29
3,	3
3.	3.
stephen.guerke@mvs.udel.edu	html>
30	30
1m	1M
32	32
Ishii,	إيشي
31	31
davrida	فترة
fasllari	المد والجزر
eroziyasi,	تآكل،
chiziqli	خطي
3)	3)
qaerda	حيث
nashrida	السطوع
qo&#39;llab-quvvatlanadigan	أيد
kamchilikka	عدم وجود
19	19
tutish.	السلوك.
1:	1:
qilyapman	أنا
17	17
18	18
e&#39;tirof	المعترف بها
15	15
16	16
13	13
14	14
11	11
12	12
tutish?	السلوك؟
21	21
20	20
2.	2.
8.20)	8.20)
2)	2)
yo&#39;ldoshlarini,	الأقمار الصناعية،
2%	2٪
erda	هنا
Kompyuter	كمبيوتر
bosh	رئيس
erikb@idt.unit.no	html>
aytdi.	قال.
aytdi,	وقال:
litsenziya,	ترخيص
1.	1.
10	10
Islom	الإسلام
1)	1)
1,	1
qarash,	نظرة،
1%	1٪
Swartz	سوارتز
5VDC	5VDC
formatlash	التنسيق
7:	7:
narxi)	السعر)
78	78
Shubhasiz,	من الواضح،
faoliyatini	أنشطة
yotgan	B
prohipiting	prohipiting
Ato,	آدم،
tashqarisiga	بعيدا عن
niyat	نية
uzgan?	لقطة؟
kometasi	المذنب
Erta	في وقت مبكر
butterscotch	حلوى من سكر أسمر وزبدة
qonuniyligini	شرعية
Yerning	الأرض
6:	6:
so&#39;zlari	الكلمات
insonlar,	الناس
Lunar	قمري
olmaydilar&quot;,	ومثل؛، لا
soatiga	كل ساعة
maqsad,	الهدف
Lekin,	ومع ذلك،
(o&#39;sha	(
7)	7)
Shifokorlar	الأطباء
!!!!&quot;	!!!! &amp; قووت]؛
zum	لحظة
70	70
qariyb	تقريبا
72	72
76	76
kasaliga	التشخيص
modem	مودم
Noqonuniy-Key	غير الشرعيين مفتاح
5:	5:
inoyati.	نعمة.
martyj@uiuc.edu	html>
Solomita)	Solomita)
56	56
Update	التحديث
ba&#39;zan,	في بعض الأحيان،
55	55
qoidalar	قواعد
ancha	كثيرا
sayyoraning	الكوكب
o&#39;g&#39;irlab	اختطاف
chindan	حقا
Suvga	الماء
xato-line	خط الصدع-
ayblov	مقاضاة
60	60
guruhni	مجموعة
&quot;barcha	على &amp; quot؛
belgilangan	تعريف
yonayotgan	احتراق
tutib,	أرض مستأجرة
istamayman	أنا لا أريد
^^^^^^^^^^^^^^^^^^^^^^^^^^^^^^^^^^^	^^^^^^^^^^^^^^^^^^^^^^^^^^^^^^^^^^^
4:	4:
organik	عضوي
orqa	إلى الوراء
______	______
4?	4؟
vaqtincha	مؤقت
WW2	WW2
70,000th	70000
ko&#39;paydi.	زيادة.
5,	5
mahallada	حي
oralig&#39;i	نطاق
Clipper	مجز
gapirganda];	يتحدث].
Narsa	شيء
ko&#39;zlarini	العيون،
suvni	ماء
5.	5.
Torre:	توري:
50	50
vakuum	فراغ
(508)	(508)
imkoniyatlari	خيارات
masofa	بعد
o&#39;ylayman-da,	أعتقد، على الرغم من
Azzam)	عزام)
otasi	والده
qurol-qonunchiligi	التشريعات -gun
olingan	التي تم الحصول عليها
astronomlar	علماء الفلك
edi:	هم:
edi;	؛
486	486
Thanks,	شكر
*************************************************	*************************************************
edi?	؟
99,86	99.8
chiqarish	إطلاق
tibbiy	طبي
482	482
paytda,	مرة
to&#39;xtating	توقف
edi,	،
Erga	هنا
edi.	.
o&#39;ylamanglar,	لا أعتقد،
xalqiga	الناس
&lt;/	واللفتنانت؛ /
tartibsizlik	فوضى
o&#39;limi,	الموت،
ehtiyojlarini	الاحتياجات
Madrid	مدريد
kam	أقل من
telematik	تعليم عن بعد
tashkil	نظمت
tomir&gt;	القلب والأوعية الدموية وGT.
maydonchada?	المقصودة؟
Thanks!	بفضل!
qaroqchi	قاطع طريق
Ulker	أولكر
payg&#39;ambarlarning	الأنبياء
Lankform,	Lankford
::	::
O&#39;quvchilarning	القراء
10:39:15	10:39:15
Fla	فلوريدا
tizimini	النظام
dekabr,	كانون الاول
tozalanadi	مسح
bosing.	انقر.
aniq	واضح
ekspertiza	الفحص
(yunoncha	(اليونانية
kundalik	يوميا
ishlamaydi.	العمل.
singan	مكسور
Sayyoraning	الكوكب
:)	:)
MDs,	حركة الديمقراطيين الاشتراكيين
yulduzlarni	النجوم
ruxsat	إذن
o&#39;qigan	قرأ
moyilligiga,	الاستعداد،
edi)	)
Lankford&gt;	Lankford &amp; GT؛
95	95
Tavrot	فسيفساء
sbp002@acad.drake.edu	html>
yadrosi	نواة
93	93
90	90
edi!	!
tekislash	استقامة
Erda	هنا
qoniqmagan	غير راضين
uchuvchi	طيار
ma&#39;lumot	إعلام
&quot;dumlar.&quot;	على &amp; quot؛. ذيول على &amp; quot؛
Imkoniyat	فرصة
funktsiyasi	وظيفة
​​ular	هم
Oktyabr	تشرين الأول
Alt.atheism	Alt.atheism
Voz	تنازل
donali	معرق
sotilgan	تباع
chiqib	خارج
==================================================	==================================================
88	88
Sichqoncha)	الماوس)
ko&#39;rsatmoqda	عروض
xavfsiz,	آمنة،
Muayyan	مؤكد
&quot;Oh,	على &amp; quot؛ أوه،
dekabr	كانون الاول
??	؟؟
bola	صبي
safari	رحلة
MacRae):&gt;&gt;&gt;	ماكراي): &amp; GT؛ &amp; GT؛ &amp; GT؛
binoning	بناء
kiritish,	،
foizi	في المئة
yopib	إغلاق
maqolalar	مقالات
nizo	خلاف
birodarlar,	الإخوة والأخوات،
qilmaydi	لم يحدث ذلك
Statistika&gt;	إحصائيات وGT.
nuqtai	رأي
?!	؟!
qo&#39;nganda	عندما
printsiplari	المبادئ
buyuradi	لدفع
Leong,	يونغ
formatlar,	الأشكال،
qolaman.	المطلوبة.
muammolar,	مشاكل،
kartopu	كرة ثلجية
zoti	الحضنة
X11	X11
suvga	الماء
xalqini	الناس
(LGV	(LGV
imkoniga	القدرة على
biladimi?!?	؟!؟
Bure	بوري
yopiq	إغلاق
(Ken	(كين
tarzda	الطريق
muammolar?	المشاكل؟
qusur	خلل
aslida,	في الواقع،
Erik	إريك
gt4417a@prism.gatech.EDU	html>
foizga	في المئة
WNI	WNI
Portable	المحمول
narsa	شيء
Lotin	لاتينية
bor!	هناك!
o&#39;qish	قراءة
topilmalar	النتائج
media-tadbir	حدث إعلامي
tabiiy	طبيعي
ko&#39;rinadi.)	سيتم عرض.)
yorig&#39;i	خطأ
(5000	(5000
motherships	motherships
mantiqiy.	منطقية.
teng	مساو
Da	في
Db	ديسيبل
xizmat	خدمة
4,850	4850
nomukammal	ناقص
rasmlar	الصور
E.	E.
Land,	أرض
razvedka	استطلاع
anti-qo&#39;ziqorin	المضادة للفطريات
(korenek@nmti.com)&gt;&gt;&gt;	(Korenek@nmti.com) وGT؛ &amp; GT؛ &amp; GT؛
qilish	إلى
DH	DH
(Detroyt,	(ديترويت،
vulqon	بركان
nashr,	نشرت
(ya&#39;ni,	(وهذا هو،
kolleji	كلية
&quot;kasalliklar	على &amp; quot؛ المرض
ma&#39;lum	معروف
sharoiti	الشروط
(«oxirgi&gt;	(الماضي &amp; GT؛
Bures&gt;	بوريش &amp; GT؛
bo&#39;lmas	ليس
boshini	رأسه
ekstraditsiya	تسليم المجرمين
musulmon	مسلم
virus..It	virus..It
340	340
endi.&quot;,	الآن ومثل؛.،
yuzasining	السطح
temp	درجة الحرارة
nusxasidan	طبق الاصل
hisobotlarida	تقارير
da&#39;vo	شكوى
boshqaruvchiName	مدير
konfiguratsiya	ترتيب
GE	GE
Wen-Cheng	ون تشنغ
diniy&gt;	الدينية وGT.
Shundan	أن
ha,	نعم،
Shunday	هكذا
eşlenen	تعيين ل
qilish?)	؟)
Er	أرض
amp&gt;	amp &amp; GT؛
Sichqoncha	فأر
asteroitler,	الكويكبات
G.	G.
FM	FM
yulduzlarga	النجوم
gnomes	التماثيل
qulay.	مريحة.
ammiak,	الأمونيا،
kilometrlik	كيلومتر
differensial	التفاضلية
HG	HG
&lt;C5t7Gs.7v3@news.iastate.edu&gt;	العلامة &amp; lt؛ C5t7Gs.7v3@news.iastate.edu&amp;gt.
Incorporated	أدرجت
davlatlar,	الدول،
IP:	IP:
763-2626	763-2626
ishlatilgan,	وتستخدم
GP	GP
beradi	تقدم
GM	GM
H.	H.
tarkibidan	تكوين
(Paul	(بول
recomendations	توصيات المؤتمر
oddball	غريب الاطوار
ham	و
QUACK,	QUACK
mish-mish	الشائعات
itself_	itself_
(Martin	(مارتن
From:	من:
davomida	إلى
hal	الحل
5:17	05:17
qoldi	بقي
jusgement	jusgement
haq	رسوم
Oort	أورت
har	كل
Vaqt	مرة
Titan	عملاق
(emas,	(لا
matbuot	صحافة
kelayotgan	قادم
From,	من
kelishida	قادم
Falakda	أوربت
A.	A.
Singapur	سنغافورة
======================================&gt;	====================================== وطن.
AT	AT
300	300
Home	منزل
monitor	رصد
IMMMMMMMMMMMMMMMMMMMMMMMMMMMMMMMMMMMMMMMMMMMMMMMMMMMMMMMMMMM;	IMMMMMMMMMMMMMMMMMMMMMMMMMMMMMMMMMMMMMMMMMMMMMMMMMMMMMMMMMMM.
kutilayotgan	متوقع
bekor,	الإلغاء،
kanallari,	القنوات،
qarama-qarshi.	عكس ذلك.
Boshqa	البعض
Tiroid	درقي
xislat	جودة
30%	30٪
Everest	ايفرست
III	III
bo&#39;lagini	قطعة
AM	AM
B.	B.
BV	BV
C:	C:
&lt;C5qsBF.IEK@ms.uky.edu&gt;	العلامة &amp; lt؛ C5qsBF.IEK@ms.uky.edu&amp;gt.
baribir	على أي حال
&quot;muhokama&quot;	على &amp; quot؛ &amp; مثل مناقشة.
yashovchi	مواطن
vodiylar	الوديان
CA	CA
musht	قبضة
mamlakati	بلد
BI	BI
ta&#39;qiqlangan	حظرت
avtomatik	أوتوماتيكي
tarzda&gt;	وGT.
havoriy	الرسول
sayyora	كوكب
An	ل
virtual-ildiz	الجذر الظاهري
namoyish	مظاهرة
C,	C
stol	جدول
Al	شركة
kiritilgan	شمل
missiyasi	مهمة
foydalanayotgan?	تستخدم؟
3.0	3.0
javobgar	المسؤول
&quot;mergan&quot;,&gt;	على &amp; quot؛ مطلق النار ومثل؛ &amp; GT؛
3.1	3.1
(&quot;vasiyatini&quot;	(على &amp; quot؛ بلدي ومثل؛
Eastwood	إيستوود
Bu	هذا
tutish	الحفاظ
shug&#39;ullanadi.	تشارك.
iborat,	،
iborat.	.
botir	botir
&lt;o&#39;rniga	العلامة &amp; lt؛ بدلا من ذلك
shunga	هكذا
yoyib.	نشر.
iltimos.	من فضلك.
Jovian	جوفي
Ganimedes	Ganimedes
iltimos,	من فضلك،
xarajat,	التكلفة،
botil	كذب
CD	القرص المضغوط
qaratilgan	تهدف إلى
ekan.&quot;	. ومثل؛
D.	D.
ko&#39;pchilik	معظم
!!)	!!)
boshiga	لكل
uzog&#39;i	العلاج
Assad	الأسد
Ehtimol,	ربما،
!!!	!!!
Ogayo	أوهايو
bizga	لنا
zbekiston	السلطة الفلسطينية
Twin	التوأم
ichiga	يحتوي على
zot	هو
(root	(الجذر
hey	مهلا
(NASA	(NASA
Xudo	الله
assimetrik	لا متماثل
cratered	متهالكة
Cardinals	الكرادلة
egalarining	أصحاب
Leonard	ليونارد
MD	MD
cheklanishiga	تقييد
jasur	شجاع
MB	MB
He,	انه،
resurslarini	موارد
da&gt;	وGT.
mobil	المحمول
kvadrat	مربع
tashlamoqchi	رمي
N.	N.
Vulqon	بركان
qaerda&gt;	حيث &amp; GT؛
guvohlar	شهود
Gilkey	Gilkes
&quot;X9&quot;	على &amp; quot؛ X9 ومثل؛
MS	MS
elektron	إلكتروني
tarozida	وزن
NI	NI
3,8	3.8
3,5	3.5
tirilaman.	الارتفاع.
NA	NA
(oxirgi	(آخر
dlb@fanny.wash.inmet.com	html>
imoningiz	إيمان
gapirdi?	تحدث؟
Jazoir	الجزائر
My	لي
ya&#39;ni,	وهذا هو،
Electronics,	الإلكترونيات
kimsiz?	من؟
---------------------------	---------------------------
Kommutatsiya&gt;	التبديل &amp; GT؛
NO	NO
tuman,	منطقة،
P.	P.
kalitiga	المفتاح
ON	ON
bo&#39;ron	عاصفة
OK	حسنا
chaldi	أنا رن
fuqarolari	المواطنين
PowerBook?	بووربووك؟
Sayt	موقع
(Scooter	(سكوتر
diskdan	القرص
nisbatan,	،
shohidlik:	الشاهد:
hamjamiyat	مجتمع
&quot;magnit	على &amp; quot؛ المغناطيسي
(6200	(6200
P5	P5
&quot;..	على &amp; quot؛
mikrosxemalar	الدوائر
maslahatlar?	نصائح؟
yopildi:	أغلقت:
No	لا
oralig&#39;i.	مجموعة.
OP	OP
lei@rtsg.mot.com	html>
OR	OR
o&#39;chirildi,	حذف،
PL	PL
On	في
Shohligida	مملكة
(Wen-Cheng	(ون تشنغ
Oh	يا
qaytarib	عودة
Od	إعلان
Ligasi	الدوري
PB	PB
PC	PC
bilim	معرفة
qorong&#39;u	ظلام
tarixi	تاريخ
emissiya	انبعاث
Go	اذهب
Barringer	بارنجر
o&#39;tkaziladi.	سيتم عقد.
jingalak	مجعد
&quot;ochiq&quot;	على &amp; quot؛ فتح &amp; مثل؛
qorong&#39;i	غامض
nomaqbul	أبجدية
&quot;Etarli	على &amp; quot؛ كفى
biologiya	علم الاحياء
his	يشعر
taxta	مجلس
ID	الهوية
Ha	نعم
o&#39;rganish	لمعرفة
He	هو
nuet_ke@pts.mot.com	html>
dog&#39;larni	بقع
Hi	مرحبا
Club,	ناد
Tom&gt;	توم &amp; GT؛
Lander	لاندر
iyul,	تموز
J.	J.
IN	IN
IO	IO
qilasiz?	انت ذاهب الى القيام به؟
bajarish	أداء
sohasida	في مجال
yuzasi	السطح
o&#39;g&#39;irlangan	مسروق
IS	IS
IT	IT
dh782@cleveland.Freenet.Edu	html>
mevalaridan	ثمار
Club.	النادي.
Ha.	نعم.
Hz	هرتز
Ha,	نعم،
o&#39;rgatsa,	يعلم،
Network	شبكة
bilib	تعلم
kuzatuvlar	الملاحظات
EGALON)	حيازة)
JB	JB
Io	الإعلام والتوعية
&quot;),	على &amp; quot؛)،
vafot	توفي
In	في
kanal	قناة
shuncha	هكذا
kinoya	كينا
marhamatli&gt;	كريمة &amp; GT؛
JT	JT
demak	الوسائل
kelishini	قادمة
AUTOCAD	AUTOCAD
(Hamaza	(حماس
kulgili	سخيف
qo&#39;lga,	،
IBM	IBM
zid	عكس
&quot;Faqat	على &amp; quot؛ فقط
st1ge@Elroy.UH.EDU	html>
Toyota	تويوتا
mustaqil	مستقل
uxlab,	نائم
(Joseph	(جوزيف
To&#39;g&#39;ri,	صحيح
emulator	منافس
L.	L.
raqib	منافس
zaxira	النسخ الاحتياطي
kishi,	الناس
sport	رياضة
o&#39;zlarini	أنفسهم
sinf,	الصف،
past	منخفض
chaqasan.	كدمة.
IBMning	IBM
Hal	الحل
ichida	ضمن
negadir	لسبب ما
qiymati	قيمة
Ham	و
Birodarlar,	الإخوة والأخوات،
LH	LH
Har	كل
FROMTHEDEAD:	FROMTHEDEAD:
Masihdir.&quot;	المسيح على &amp; quot؛
boshqacha	مختلف
aytishim	قول
VL	VL
W.	W.
Ulysses&#39;in,	أوليسيس
hisoboti	تقرير
Isreal	İşret
huquqlarini	حقوق
parda	ستارة
dunyolar	العالم
Tx	تكساس
bizni	لنا
ko&#39;rganlar.	رأيت.
qoldi&gt;	وGT.
bo&#39;sh	فارغ
dotsent	أستاذ مشارك
heteroseksüel	الغيرية
saqlaydi,	مخازن
Antarktida	القارة القطبية الجنوبية
unutmang	لا ننسى
rahmat.	شكرا لك.
qurboni	الضحية
yuz	وجه
Gelişigüzel	دون تمييز
kechish!	تنويه!
Th	عشر
erta,	في وقت مبكر
oziqlangan	بنك الاحتياطي الفيدرالي
ishga	أطلقت
PROOFOF:::	PROOFOF :::
olaysız	هادئ
yuk	حمل
foydalanadi	الاستخدامات
TV	التلفزيون
hamkorlar	شركاء
&quot;bilan.	على &amp; quot ؛.
wnk@aquifer.geology.uiuc.edu	html>
Muqaddas	المقدس
kechish?	إخلاء المسئولية؟
turar	الإقامة
Charter	الميثاق
kalitini	المفتاح
[erkak]	[ذكر]
XT	XT
Norton	نورتون
Landmann	Landmann
Oldingi	سابق
ikkinchisi,	ثانيا،
maxfiy	سري
ko&#39;rsatmalar	تعليمات
&quot;soat&quot;	على &amp; quot؛ &amp; مثل؛
darajada,	مستوى
zerikarli,	ممل
Yevropaga	إلى أوروبا
simob	زئبق
burchak)	الزاوية)
ertak	حكاية
muammolarni	المشاكل
yozida	في الصيف
burchak,	الزاوية،
Va	و
------------------------	------------------------
Jun&#39;ichiro	جونيشيرو
porlab	تألق
emasman-da,	على الرغم من أنني لست
Open	فتح
isbotlash	لإثبات
Pathfinder&gt;&gt;&gt;	باثفايندر &amp; GT؛ &amp; GT؛ &amp; GT؛
S.	S.
loyiha,	المشروع،
qoralangan	البقع
xona	غرفة
chiqish	خروج
murojaat,	اتصال
Qani,	حيث
Folta)	فولتس)
blok.	كتلة.
tirilmagan	أثار
yaxshi!	حسن!
RA	RA
qaratib	تركيز
Qurol	سلاح
shoxini	قرون
pastga&gt;	أسفل &amp; GT؛
Meni	لي
muqobil	البديل
o&#39;qib	قرأ
bo&#39;lsa,&gt;&gt;	وGT؛ &amp; GT؛
ildiz	جذر
&quot;Bu	على &amp; quot؛
aylantirilib	قيود
turib	بدون
singari)	مثل)
to&#39;siqlar	العقبات
qilinsa	إذا
R.	R.
alin@nyx.cs.du.edu	html>
xatoyim.	خطأ.
(1.5-mil)	(1.5 ميل)
haysi)	هايز)
fuqarolar,	المواطنين،
yaxshi,	كذلك،
arziydi.&quot;	يستحق ومثل؛
Mavzu:	الموضوع:
gol	هدف
qaytishini	للعودة
kapasitif	وبالسعة
Oy	شهر
Vayss)	فايس)
yurishni	على المشي
qilib,	،
oynasini	نافذة
jinoyat	جريمة
oooo	OOOO
bo&#39;lmasa&gt;	أو &amp; GT؛
qo&#39;ng&#39;iroq	جرس
o&#39;rganildi.	درس.
So	هكذا
qoldiqlari	أنقاض
dori	دواء
SS	SS
yoz	الصيف
uchun;	ل.
nazaridan	من حيث
uchun?	؟
imkoniyatlarini	الفرص
Chin	صحيح
urg&#39;u	تشديد
uchun:	إلى:
Men,	أنا
uchun,	إلى
Re	إعادة
Aql,	الاستخبارات،
uchun.	.
ketdi	ذهب
joylashtirish.	.
SI	SI
rahmati	رحمة
uchun%	٪
ertalab,	في الصباح،
-120	-120
yoq	فريق
uchun)	)
RR	RR
kelgan;	؛
Insondir	الرجل
uchun!	!
///////	///////
&quot;sekin	على &amp; quot؛ بطيئة
franjion@spot.colorado.edu	html>
qilib.	.
minalar	الألغام
Driver&gt;	سائق &amp; GT؛
topildi.	تم العثور عليها.
chaqmoqni	البرق،
So&#39;zga	يتحدث
Eski	قديم
Campus	حرم الجامعة
Snail	حلزون
orqali	عبر
gul	زهرة
N3JXP	N3JXP
turli	متنوع
yashagan.	عاش.
shogird	المريد
yoqishingiz	الوها
bemorlar,	المرضى،
^)	^)
sayyoramizning	الكوكب
(xohlagan	(ويلز
birini	واحد
o&#39;sayotgan,	متزايد
Severy	سيفرن
xotira	ذاكرة
sevib,	الحب،
yuqoridagi	أعلى
sulfat	كبريتات
xos,	الأصلي،
qadimiy,	القديمة،
\\	\\
uchun.&quot;,	. ومثل،،
CONFIG.SYS	CONFIG.SYS
Mavzu	موضوع
=============================================	=============================================
Xo&#39;sh,	حسنا،
mediator	وسيط
Ogohlantirishlar	عدم مسؤولية
risolaning	الكتيب
ahamiyatga	أهمية
mutakabbir	متغطرس
sharqqa)	الشرق)
buyuriladi	وصف الدواء
&quot;qovun&quot;	على &amp; quot؛ الفواكه ومثل؛
kutish	توقع
qirg&#39;in	مذبحة
o&#39;quvchi	قارئ
astronavtlar	رواد الفضاء
__	__
(Lin	(لين
switch	تحول
sichqoncha	فأر
yo&#39;nalishini	اتجاه
tushdi.	الخبز المحمص.
tushdi,	نخب،
MouseWare	MouseWare
safarga	رحلة
dbernard@clesun.Central.Sun.COM	html>
tubdan	الكاردينال
jo&#39;natish,	إرسال
Hutchison&quot;	هوتشيسون ومثل؛
murojaat?	الاتصال؟
naqsh	نمط
qonunlarini	قوانين
`.	.
[2]	[2]
^^	^^
Kosmosda	في الفضاء
Taoloning	سبحانه وتعالى،
xudolar	الآلهة
3-8),&gt;	3-8)، وGT.
ixtisoslashtirilgan	متخصص
singlim,	شقيقة،
-183	-183
oyna&gt;	نافذة &amp; GT؛
ustuvor	أفضلية
mustahkam-rock	على الصخور الصلبة
382	382
hafa&gt;	حزين &amp; GT؛
AQShda	في الولايات المتحدة
&quot;insonparvarlik&quot;	على &amp; quot؛ أنسنة ومثل؛
&quot;Shaxsiy	على &amp; quot؛
Falastin	فلسطين
konservativ.	المحافظ.
cho&#39;mish	معمودية
muallifi	الكاتب
(Skelton	(سكيلتون
-179	-179
ko&#39;rinmaydi.	تظهر.
&quot;loyqa	على &amp; quot؛ غامض
ustoz	معلم
orqaga	إلى الوراء
Davlat	دولة
portlatishga	ضربة
modellari	نماذج
yoylari	أقواس
sozlamoq	لحن
yozish	إرسال
yalang&#39;och	عار
(Douglas	(دوغلاس
375	375
oxirida,	في النهاية،
boshga	رئيس
qamashtiruvchi	باهر
&quot;:`	على &amp; quot ؛:
pizza-rangli	بلون البيتزا
[a	[A
Kosmosga	الفضاء
(masalan),	(على سبيل المثال)
Nanaimo,	نانايمو،
biriga	واحدة من
israel	إسرائيل
360	360
turmush	المعيشة
Sana	تاريخ
o&#39;rniga	بدلا من
o&#39;sish)	النمو)
Minglab	الآلاف
Yuz	وجه
G&#39;azo	غزة
[u	[U
HRB	HRB
o&#39;rganib,	الدراسة،
o&#39;rganib.	فحصها.
Sams	سامس
mo&#39;minlar	المؤمنين
[I	[I
Chris	كريس
chaqirishni	الدعوة
\)	\)
chiqarilgan	نموذج
organ	عضو
»Siz	&#39;أنت
\;	\؛
48?)	48؟)
fotokimyo&quot;	ضوئية ومثل؛
o&#39;rganib;	دراسة؛
chaqiriq	دعوة
tashlash	نزع
K1Y	K1Y
&quot;bekor	وquot؛ إلغاء
Land	أرض
hayron	مندهش
o&#39;ynaydi.	اللعب.
nisbatan	نسبيا
ge	جنرال الكتريك
qiluvchilarni	المشترين
Uran	اليورانيوم
muammo,	المشكلة،
infektsiyalari,	العدوى
ga	إلى
qutblarda	أعمدة
&lt;1qksc2$2mr@fido.asd.sgi.com&gt;	العلامة &amp; lt؛ 1qksc2$2mr@fido.asd.sgi.com&amp;gt.
chiqaruvchi	الشركة المصنعة
yo&#39;ldosh	الأقمار الصناعية
o&#39;zimning	لي
JPL	JPL
tashlaydi,	رمي
bunday	مثل
Paul	بول
milya)	ميلا في الساعة)
203	203
bolalarni	الأطفال
200	200
lug&#39;at	قاموس
20:	20:
&quot;Va	على &amp; quot؛
shogirdlari	التلاميذ
SLEGGE@kean.ucs.munc.ca	html>
&quot;Uy	على &amp; quot؛
kuchlari	القوات
20%	20٪
kengaytirish-nafs)	توسيع الروح)
i,	ط
imkon	ممكن
tuyulardi	يبدو
bizning	لنا
dedi	قال
oxirgi):&gt;	نهائي): &amp; GT؛
qildim.	فعلت.
fayllarni	ملفات
xizmati	خدمة
stantsiyani	محطة
qoldirgan.	غادر.
Corollas	التويج
Beta	بيتا
kashshof	رائد
talqini	تأويل
shogirdlariga	تلاميذه،
munosib	مستحق
In:	في:
gapirish).	التحدث).
o&#39;tgan.	.
&quot;...	على &amp; quot؛ ...
Gruziya	جورجيا
oniy&gt;	لحظة وGT.
yulduz	نجمة
ailin	Aili في
etti	سبعة
sanaladi.	هو.
munozaralar	مناقشة
21)	21)
do	فعل
Iftccu:	Iftccu:
In.	في.
portretlar	صور
doim	باستمرار
21,	21
ko&#39;ra	وفقا ل
qo&#39;shni	الجيران
bo&#39;sh,	مجانا،
kamon	أقواس
bundan	بالإضافة إلى ذلك،
JPB	JPB
ashyo	مادة
Agnostitsizm	اللاأدرية
maqbul	مقبول
delusional&gt;	الوهمية وGT.
Necha	عدة
ishora,	التوقيع،
yer	أرض
Advanced	المتقدم
Io,	الإعلام والتوعية
meteoritlarning	النيازك
qildik.	لدينا.
ishora;	التوقيع.
er	أرض
Past	منخفض
Fraering)	Fraering)
dizayn	تصميم
Bu!&quot;	! على &amp; quot؛
yaxshi&quot;.	ومثل؛
Lantz)	انتس)
qanday&gt;	وGT.
bu	هذا
ko&#39;za	إبريق
bf	فرنك بلجيكي
qilingan.	.
qilingan,	،
foydalangandan	باستخدام
bi	ثنائية
Topraklama.	التأريض.
Bugun	اليوم
deb;	ذلك؛
juft	زوج
da	في
deb:	ما يلي:
havzasi	حوض
deb?	ذلك؟
2,5	2.5
kemada	السفينة
Teemu	تيمو
(xotinim)	(زوجتي)
bosh.]	.]
faqat,	فقط
deb,	،
maydon,	منطقة
deb.	.
kompyuterga	كمبيوتر
shippak	شبشب
tekshiriladi)	التحقق)
yumshatish	للتخفيف من
XT350	XT350
ab245@cleveland.Freenet.Edu	html>
Tarix	تاريخ
jele	هلام
edi).	).
ko&#39;chmas	حقيقي
yaratadi.	يخلق.
deyarli	تقريبا
edi),	)
geb@cs.pitt.edu	html>
yomonroq	أسوأ
holatiga	طريقة
Tahrir:	تحرير:
``	``
uunet	UUNET
Oynasida,	نافذة
Recyle	تسمية recyle
zambilda	نقالة
Texnikasi&gt;&gt;	وطن؛ &amp; GT؛
hujjatsiz	وثائقي
hurmat	احترام
qo&#39;liga,	سلامة،
boruvchi	الرائدة
tomosha	راقب
c:	ج:
franjion@spot.Colorado.EDU	html>
narxlari,	أسعار
JKN	JKN
BIROR	أي
maydoni	منطقة
juda	جدا
ad	إد
[1]	[1]
bosim	الضغط
narxlari.	الأسعار.
no	لا
hujjatni	وثيقة
nuriga	ضوء الشمس
&quot;platsebo	على &amp; quot؛ همي
ilovalar	تطبيقات
Cadillac&quot;	كاديلاك ومثل؛
ayollarning	المرأة
maqsadi,	والغرض من
qo&#39;shilmayman.	انا اختلف.
of	من
laboratoriyalari	مختبرات
nizomiga	تداخل
aralashmalari	مركبات لل
Savolingizga	مسألة
schuster@panix.com	html>
Meteor	نيزك
bayroq	علم
In:&gt;&gt;	في: &amp; GT؛ &amp; GT؛
yorqin	مشرق
dizaynlar	التصاميم
yovvoyi	وحشي
kosmik)	فضاء)
qo&#39;yish,	،
kosmik,	الفضاء
o`yini	التصفيات
oq	أبيض
Ko&#39;proq,	أكثر
dono	حكيم
o&#39;rniga,	بدلا من ذلك،
Lippard)	Lippard)
etib	كما
Observer,	مراقب
oz	القليل
oy	شهر
ham&gt;	وGT.
mehmon,	ضيف
ko&#39;rdik.	رأيت.
pe	PE
ko&#39;rdik,	رأينا،
pm	مساء
ustiga,	في
chiptalar	تذاكر ل
psyrobtw@ubvmsb.cc.buffalo.edu	html>
Member	الأعضاء
emasligini	ليس
myselfe	بجانب myselff
jadvallar	الجداول
BBS:	BBS:
Galatiyaliklarga	غلاطية
mas&#39;uliyatni	مسؤولية
dos;	دوس.
platalar	لوحات
Agar&gt;	A &amp; GT؛
1500	1500
kompaniya	شركة
me	لي
Ditto.	كما سبق.
Yakshanba	يوم الأحد
Messier	مسير
ruhoniylar	الكهنة
46904	46904
kvant	كمية
boshpana	حق اللجوء السياسي
&quot;tajovuzkor&quot;	على &amp; quot؛ عدوانية ومثل؛
tinch	هدوء
chiqaradi.	.
hukmronlik	حكم
kamarini	حزام
qarashda&quot;	وهلة ومثل؛
jonsiz	ميت
xanjar	خنجر
olib,	،
na	غ
Erkaklar	الرجال
o&#39;ldirish	قتل
ortodoksal	الأرثوذكسية
ko&#39;rdim.	رأيت.
instituti:	معهد:
Arizona	أريزونا
o&#39;liklar,	ميت
ni	خيار
do&#39;konlar	مخازن
olib.	.
p.	ص.
boshdan	تجربة
(Ispaniya)	(إسبانيا)
itoat	طاعة
Orbiters	المدارية
Kontaktlarni	الاتصالات
P.S.	سكرتير خاص
ta&#39;minot	زودت
mock@watt.support.Corp.Sun.COM	html>
tekshirish:	تحقق:
ro&#39;yxatda	قائمة
egilib	انحنى
Afsuski,	للأسف،
XQueryTree	XQueryTree
EMAS	NOT
oxir-oqibatda	أخيرا
AVTOMATIK	AUTOMATIC
quvg&#39;in	اضطهاد
Bressler)	بريسون)
vazifalari	وظائف
holatini	حالة
Tabib	الطبيب
emasman,	أنا،
emasman.	أنا لا.
boshladi;	بدأت.
ku	KU
Evropadan	أوروبا
tirilishi	القيامة
boshladi,	،
emasman!	أنا لا!
boshladi.	.
ing	جي
Xudosiman,	الله
qurish	إنشاءات
Rubenfeld)	Rubenfeld)
emasman;	أنا لست؛
ko&#39;r)	أعمى)
iqlim	مناخ
Yo&#39;q,	لا،
qat&#39;i	بغض النظر عن
pog&#39;ona	دفقة
kamar	حزام
===========	===========
EMAS.	NOT.
Orbiter,	المتتبع
istayman.	وأود أن.
istayman,	وأود أن،
hi	مرحبا
Yer	أرض
Meeting,	لقاء
o&#39;zgartirish	بديل
yil	عام
Sizga	أنت
livesey@solntze.wpd.sgi.com	html>
yo&#39;qolganda,	خسارة
Xelion	خليل
Salbchilar	الصليبيين
avlod	جيل
JPS&gt;	JPS &amp; GT؛
____	____
mayda	مايو
tengdoshlari	الأقران
to&#39;plash	جمع
shifokorlar	الأطباء
ilm	تعليم
ko&#39;p,	كثير،
in	في
ip	خيط
TranslateCoordinates&gt;	TranslateCoordinates &amp; GT؛
impedans	مقاومة
so&#39;rab	تطلب
(&gt;,	(&amp; طن،،
iz	أثر
suratga	الصور
Fred&#39;S	فريد
ko&#39;p!	أكثر!
faraz,	على افتراض،
COEGALON@LARC.NASA.GOV	html>
Sharma)	شارما)
[Iso]	[يسوع]
etc,	الخ،
porloq.	مشرق.
zanjir	سلسلة
YYY	YYY
etan	الإيثان
xt	XT
spot	بقعة
yilgacha	سنوات
rejalashtirilgan,	المخطط
ismi	اسم
Test	اختبار
rejalashtirilgan.	المخطط لها.
emasman&quot;,	ومثل؛، وأنا
to&#39;qnashdi	اشتباك
tavsiflovchi	وصف
aktsiyalarning	أسهم
modernizatsiya	تحديث
boshlanadi	يبدأ
Powerbook	بووربووك
Schaufenbuel	Schaufenbuel
aylanishi	دوخة
apparat	جهاز
yarim-rock	نصف الصخور
Calling	دعوة
ortiq&gt;	وGT.
bading@cs.tu-	bading@cs.tu-
vv	ت ت
etar	يأس
davolash.&quot;	. العلاج ومثل؛
upperleft	upperleft
ekanini	أن
tanlangan	مختار
paytda	في حين
yorug	مشرق
masofalarga	المسافات
xarakterli&gt;	سمة &amp; GT؛
(amerikaliklar)	(الأميركيون)
(Barcha	(جميع
Radio-Shack-ega	راديو شاك
Lantz	انتس
nodrog@hardy.u.washington.edu	html>
keltirishi	سبب
&lt;C4Hyou.1Iz@mentor.cc.purdue.edu&gt;	العلامة &amp; lt؛ C4Hyou.1Iz@mentor.cc.purdue.edu&amp;gt.
yechim	حل
to&#39;lanadi	إيلاء
uz	المشاركات
ko&#39;chib&gt;	وGT التحرك؛
uy	منزل
va	و
(James	(جيمس
yana	ثانية
chidamli	مقاوم
Buyuk	عظيم
tovar	بضائع
o&#39;chdi	حفيف
ko&#39;zlar,	عيون
etdi	شارع
ta&#39;riflaydi:	فهو يصف:
anakart	اللوحة الأم
matrix	قالب
kuzatiladi:	لاحظ:
`joylashtiring]	إدراج]
&quot;qizil	على &amp; quot؛ أحمر
ko&#39;pincha	غالبا
chiziqlar	خطوط
bildirdi	قال
keltirganlar	أولئك الذين
Kinsley	كينسلي
tushunchasi&gt;	مفهوم &amp; GT؛
up	فوق
tomoshabinlar	المشاهدين
&quot;gi	على &amp; quot؛
jarayoni	عملية
modelini	نموذج
sezuvchanlik	حساسية
sinov	اختبار
&quot;ga	على &amp; quot؛
&quot;Minnesota	على &amp; quot؛ مينيسوتا
etildi,	كان،
kuzatiladi.	لوحظ.
Zich	ضيق
terimiga	اختيار
kuzatiladi,	هناك،
etildi.	.
to	إلى
tuproq	تربة
Siyosiy	سياسي
v.	ج.
-235	-235
Shaxsan,	شخصيا،
halihamon	الطفولة
ISA)	ISA)
(Marcus	(ماركوس
te	الشركة المصرية للاتصالات
yomon,	سيئة،
kunduzi	بعد الظهر
ochilishi	افتتاح
kashfiyotchining	مكتشف
sayyoralar	الكواكب
welcome	ترحيب
Osmon	سماء
Teng	مساو
gipotezasi,	الفرضية،
chiqildi	المشاهدات
Yonga	رقاقة
hte	إيرباص
o&#39;lchagan,	قياس،
Masih,	المسيح،
o&#39;lik-tugasa	المسدودة-
kuchaytirgich	محسن
axloq&quot;	أخلاقيات ومثل؛
amper	أمبير
ko&#39;zlari	عيون
Texas	تكساس
u,	وقال:
sudga	محكمة
brenner@ldgo.columbia.edu	html>
asoslanadi.	ويستند.
chorak	ربع
Xokkey,	الهوكي،
suvlari,	مياه
ilgari	منذ
Hududingizda	في منطقتك
&quot;taslim&quot;	على &amp; quot؛ الرصاص ومثل؛
to&#39;plangan	جمعت
yugurish	جولة
degan?	ذلك؟
zoting	بذرة
​​&gt;&gt;	وطن؛ &amp; GT؛
yoyish	انتشار
ota-LED	الآباء LED
(Men	(I
plitalari	لوحات
rivojlanish	نمو
sharqiy-to-g&#39;arbda	الشرق إلى الغرب
sharoitlarda	الشروط
xos	خاص
-221	-221
bilan	مع
raqam	عدد
bressler@iftccu.ca.boeing.com	html>
transfer&gt;	نقل وGT.
xok	المخصص
xom	الخام
shartlarda,	الشروط
&#39;&#39;	&#39;&#39;
cherkovi	كنيسة
dilemma	معضلة
foydalanadi.	يستخدم.
jamiyat	مجتمع
ba&#39;zilari	بعض
gapiryapsiz?	الذي تتحدث عنه؟
foydali	مفيد
test	اختبار
izhor&gt;	التعبير عن وGT.
(Stiven	(ستيفن
280	280
kelganlar	الوافدين
Arab	عربي
Yerdan	من ثم
Brooks)	بروكس)
Xon	خان
Individual:	فرد:
Texnologiya	تكنولوجيا
so&#39;zlarini	الكلمات
28:	28:
Boulder	جلمود
etdi.	.
ishonsangiz,	إذا كنت تعتقد أن،
&quot;Bure&quot;	على &amp; quot؛ بوري &amp; مثل؛
yonqutisi	yonqutisi
ular&gt;&gt;	وGT؛ &amp; GT؛
tasavvur	خيال
engp2008@nusunix.nus.sg	html>
qachon	عندما
o&#39;tmishda	في الماضي
kecha	أمس
winfrvk@dutiws.twi.tudelft.nl	html>
qayta-post	إعادة آخر
&quot;^^^^&gt;	على &amp; quot؛ ^^^^ &amp; GT؛
40-22k	40-22k
tejamkorlik	كويلو
willisw@willisw.ENG.CLEMSON.edu	html>
Systems	أنظمة
eshkaklar	معاول
g&#39;amxo&#39;rlik?	مهتم؟
propter	propter
hitter	ضاربا
voqealar	أحداث
Munosabatlar,	العلاقات
Egalon	حيازة
o&#39;rtasidagi	بين
tiriltirgan,	أثار
sharafiga,	شرف
fazogirlar	رواد الفضاء
tortib	من
o&#39;lchamli	حجم
qisqa&gt;	باختصار &amp; GT؛
qadar	حتى
adolatsizlik	ظلم
Hayot	حياة
Yer&gt;	الأرض وGT.
(men	(I
Ularning	هم
logo	الشعار
shaharlari	مدن
talk.politics.guns	talk.politics.guns
&lt;BADING.93Apr23105229@athene.cs.tu-berlin.de&gt;	العلامة &amp; lt؛ BADING.93Apr23105229@athene.cs.tu-berlin.de&amp;gt.
1971-yillar	1971
Stalin&gt;	ستالين و GT.
muvaffaqiyatsiz.	فشل.
rivojlanayotgan	تطوير
Xavfsizlik&quot;	الأمانة و مثل؛
ko&#39;rsatdi.	.
pubinfo.jpl.nasa.gov	html>
yaxlitlanadi,	يتم تقريب،
&quot;keyin	على &amp; quot؛
caltech.edu	html>
tasvirlar	الصور
240	240
Bruklin	بروكلين
14-19&gt;	14-19 &amp; GT؛
xalqi	الناس
qayirida	سهول الفيضانات
istardim	وأود أن
shahar)	المدينة)
Besh	خمسة
kutilmagan	غير متوقع
Journal	مجلة
manfaatdor	مهتم
jihozlangan.	مجهزة.
243	243
Ming)	مينغ)
aniqligi	دقة
1975-yillar	1975
gazlar	الغازات
abadiy	إلى الأبد
ular,	هم
munosabatlar	العلاقات
yarador	جريح
24-bit	24-بت
nazarini	زاوية
ISA	ISA
(Yoki	(أو
masalasidir.	القضية.
oshiradi	زيادات
raqamlar	أرقام
qilmagan	ليس
belgilari,	العلامات التجارية،
statistika	إحصائيات
kesib	قطع
sajda	ساجدا
yordam	مساعدة
Argo	آرغو
sohillarni,	البنك،
(Walter	(والتر
12.00	12.00
eritilgan	الذائب
yurtini	أرض
orangecar&#39;ait	LMH
250	250
happed.	يحدث.
(Henling,	(Henly،
J23	J23
tubsiz	لا قعر له
silindir	اسطوانات
25.	25.
*****	*****
yomonlik	شر
yuqori&gt;	وGT.
Telefon	هاتف
White	أبيض
saylov	انتخابات
o&#39;ldi,	توفي،
yr	سنة
ishonish	إلى الاعتقاد
Rahmat.	شكرا لك.
Vashingtonda	واشنطن، DC
ma&#39;nosiz	لا معنى له
vakili	ممثل
yo	أو
berlin.de	html>
&lt;1r0vk6INNaft@cronkite.Central.Sun.COM&gt;	العلامة &amp; lt؛ 1r0vk6INNaft@cronkite.Central.Sun.COM&amp;gt.
tarixchisi	مؤرخ
Brenner	برينر
GetGeometry	GetGeometry
boshqaruvchisi	مدير
Iaccoca	Iaccoca
yurib,	المشي،
Shopper	المتسوق
Matrix	قالب
namuna,	نموذج،
o&#39;rta	متوسط
tizimidan	نظام
theist	Theisen ل
Ushbu	هذا
yolg&#39;iz	وحيدا
qo&#39;yish	وضع
«Alloh)	الله)
topilgan	تم العثور على
qo&#39;liga	من ناحية
g&#39;arbdan	الغرب
narsa)	)
narsa,	لا شيء
zimmasiga	زمام المبادرة
Mitsubishi	ميتسوبيشي
Fazogirlar	رواد الفضاء
**************	**************
xokkey	الهوكي
amatuer	الهواة
(Phil	(فيل
Pathfinder	مستكشف
narsa:	أمور:
Falastinda	فلسطين
vaqtini	مرة
qutqarishni	لتقديم
soddalashtirilgan	مبسط
App	التطبيق
Hard	من الصعب
Apr	أبريل
Zabur	ترنيمة
Sport	رياضة
qila	فعل
urush	حرب
o&#39;ylagan	فكر
bo&#39;lardi	سيكون من
vfintd.386:	vfintd.386:
tavsiya	موصى به
Stony	حجري
meniki)	الألغام)
sivilizatsiyasida	حضارة
So&#39;nggi	آخر
vatt:	واط:
qamrovli	منتديات
muvaffaqiyatli	ناجح
tomonga	نحو
almashishni,	تبادل
shilmoq	خدش
tashxis,	التشخيص،
heteroseksüel,&gt;,	الغيرية، وGT،،
Ongida	في عقول
yahudiy,	اليهودية،
baliqchi)	الصيد)
baxtsiz	الحوادث
hall@boi.hp.com	html>
binoan	وفقا ل
91%	91٪
pharvey@quack.kfu.com	html>
noqonuniy	غير شرعي
jazo	عقاب
iqtisodiy	اقتصادي
balandligi	ارتفاع
lippard@skyblu.ccit.arizona.edu	html>
Giants	عمالقة
Zbib)	زبيب)
faraz	على افتراض
bor&quot;.	ومثل؛
(GIF,	(GIF،
Brian	بريان
nosimmetrikliklar	المخالفات
kitoblarida	الكتب
ta&#39;minlash	العرض
Mariya	ماريا
chiqish?	؟
Ko&#39;rishlar	المشاهدات
Hawk	صقر
shartlariga	شروط
allaqachon	سابقا
kamroq	أقل
mag&#39;lub	هزم
jihozlandi.	مجهزة.
dunyoning	عالم
Havo	هواء
&quot;un-vakolatli&quot;	على &amp; quot؛ برنامج الأمم المتحدة للأذن ومثل؛
makr	hile
tushunchasi	مفهوم
ota-ichiga	الآباء
tekshirildi.	فحصها.
fan	علم
narsa»	»
chiqishi	الانتاج
974	974
karta.	البطاقة.
tamoyillariga	مبادئ
Kulgili	سخيف
katalogini	فهرس
(872	(872
algoritmlarni	خوارزميات
Yaqinda	مؤخرا
borar	لدى وصوله
izlayotgan&gt;	بحث &amp; GT؛
Hays	مثليون جنسيا
ishlaydi-da,	في العمل،
&quot;biz	على &amp; quot؛
Store	مخزن
foydalangan,	باستخدام
atmosferasida,	الغلاف الجوي،
banschbach	banschbach
Amerika	أمريكا
ko&#39;rindi,	ظهر،
Suv	ماء
ko&#39;rindi.	يبدو.
tizimlar	أنظمة
taqsimlash	التوزيع
gelişigüzel	دون تمييز
Sun	شمس
ko&#39;rgan	رأيت
(842	(842
ko&#39;rindi;	بدا؛
tizimida,	النظام
millionli	مليون
&quot;....	على &amp; quot؛ ...
munosabatda&gt;	العلاقات &amp; GT؛
xil	نفس
mail	بريد
gijgijlash	مدفوع
tushuntirishga	شرح
qulfi&quot;.	قفل ومثل؛
natijalari,	النتائج
Herschel	هيرشيل
aytadi.	قال.
Toronto,	تورونتو،
Nissan	نيسان
Europa	أوروبا
billq@ms.uky.edu	html>
jumladan,)	بما في ذلك)
uzatiladi.	المرسلة.
aylantirish	المترجم
degani	متوسط
soqchi	حارس
tomonidan	بواسطة
&quot;bir	على &amp; quot؛
yahudiylarning	اليهود،
ikki,	اثنين،
aylanishi,	والدوخة،
mashinalari	آلية
Bu&gt;	وطن.
buyurdi.	أمر.
Shadow	ظل
ma&#39;lumotlar	معلومات
aytib	قال
zabt	التسلق
Kifa	سيفاس
ikki?	اثنين؟
ikkala	على حد سواء
664-6354	664-6354
[nasroniylar]	[المسيحيين]
tamoyillariga,	مبادئ
shtatining	حالة
Bolalar	الأطفال
Qanchadan-qancha	كم عدد
&lt;wnk.734824081@aquifer.geology.uiuc.edu&gt;	العلامة &amp; lt؛ wnk.734824081@aquifer.geology.uiuc.edu&amp;gt.
oqlash	مبرر
bo&#39;ladi.	.
mintaqadagi	منطقة
&quot;bajarish&quot;	على &amp; quot؛ &amp; مثل؛
o&#39;zaro	متبادل
ishonsangiz	إذا كنت تعتقد أن
namelplate&gt;	namelplate &amp; GT؛
yordamida	باستخدام
yonga&gt;	رقاقة &amp; GT؛
nomini	اسم
bo&#39;ladi,	سوف
bo&#39;ladi?	؟
Fiction	خيال
&quot;orqa	على &amp; quot؛ العودة
jamiyatning	مجتمع
of&gt;	وGT.
Tezroq	أسرع
hujayralari	الخلايا
bo&#39;lardi.	أنه سيكون.
So&#39;ngra	ثم
bajardi	الوفاء
bo&#39;lardi,	سيكون من،
bo&#39;ladi;	؛
vasiyat&quot;	الوصية ومثل؛
balandlikdagi	على ارتفاع
yetti	سبعة
atashimiz	دعوة
kasalxonada	المستشفى
Banklar	البنوك
bo&#39;lmagan	لا
tasavvur,	تخيل،
xaloskor	حارس الحياة
marotaba	مرة
ushlab	عقد
#From	#From
aql-idrok	ذكاء
xavfi	خطر
qilinmoqda,	هو،
========	========
qilinmoqda.	هو.
jo&#39;natib,	إرسال
Guns,	البنادق،
&quot;Pushti	على &amp; quot؛ الوردي
Statistika	إحصائيات
balandlik,	ارتفاع
borligi	وجود
meteorit	نيزك
qismlarga	أجزاء
qo&#39;pol	هائج
Tan	أسمر
Brothers	الاخوة
frank@D012S658.uucp	frank@D012S658.uucp
vatin	الضرب
joyda	في كل مكان
Krsek)	Krsek)
turibmiz)	رؤية)
INTERNET:	INTERNET:
Hutchison	هوتشيسون
kamaytirish	الحد
sohalarida	في مجالات
Hali	بعد
tushadi	سوف
Djakarta	جاكرتا
grafik	رسم بياني
kiygan	يرتدي
tushkunlik	كآبة
olaman&gt;	I &amp; GT؛
9:31	09:31
Noring	نوريو
loyihasini	المشروع
&lt;19613@pitt.UUCP&gt;	العلامة &amp; lt؛ 19613@pitt.UUCP&amp;gt.
Trondxeym	تروندهايم
Mustaqillik	استقلال
Galiley	غاليليو
yarim)	نصف)
joyga	مكان
Merkuriy	زئبق
boshqalarning	آخرون
O&#39;Dwyer)	أو دواير)
&lt;e&#39;tiqod	العلامة &amp; lt؛ الإيمان
=========================	=========================
(tosh),	(روك)
tepalari	الكثبان
formatlar	صيغ
eslash	لنتذكر
begona	غريب
Hans	هانز
ning)	)
uu.net	html>
badiiy	فني
sarflaydi.	قضاء.
go&#39;zal	جميل
Sci.med,	Sci.med
Malumot	تحديث الصفحة
&quot;Terminator&quot;,	على &amp; quot؛ المنهي ومثل،،
imkoniyatlarni	الفرص
&quot;QUACK&quot;	على &amp; quot؛ QUACK ومثل؛
94550	94550
ustidan	في
aralashma	مزيج
egri	منحنى
Frmwrks	Frmwrks
ko&#39;rganmisiz?	هل؟
Inning	الشوط
(Rimliklarga	(رومية
tashqi	خارجي
xalqlarga	الدول،
oltingugurt-boy	الغنية بالكبريت
(317)	(317)
Galileo	غاليليو
kalit	مفتاح
Knowles&quot;	نولز ومثل؛
borib	إذهب إلى
mashinadan	الجهاز
aniqlandi.	التي تم تحديدها.
qoniqarli	مرض
WAGNER,	WAGNER
plastinka	لوحة
nasroniylar	المسيحيين
atmosferaga	الجو
tutun	دخان
zaif	عرضة
punjabi@leland.Stanford.EDU	html>
sayyoralar,	الكواكب،
farq,	الفرق،
xulosasi	اختتام
&quot;shifokorlarining&quot;	على &amp; quot؛ &amp; ممارسة مثل؛
etan-metan	الايثان غاز الميثان
Bicentennial	الذكرى المئوية الثانية
boshlab	من
Siz	أنت
09:02:48	09:02:48
Yamakawa,	ياماكاوا
may,	مايو
but-pastga	ولكن بانخفاض
o&#39;tadi	سوف
jalb	جذب
to&#39;plamini	مجموعة
ketdi;	؛
Yorqin	مشرق
qo&#39;llab-quvvatlaydi,	الدعم
jahannam	الجحيم
Qiyin	من الصعب
Clayton	كلايتون
Yevropaliklar:	الأوروبيون:
Sichqonchasi	MOUSE
saqlab.	محافظة عليه.
SuperVGA	Superve
ketdi.	.
saqlab,	حفظ
oladi	يشمل
qilgan	الذي
ikki-astronavt	اثنين من رواد الفضاء
qutilish	خلاص
ozchilik	أقلية
Aslida	في الواقع
xabarlar	رسائل
Malaspina	مالاسبينا
(menimcha)	(على ما أظن)
84-yil	84 سنوات
V-Mail:	V الإلكتروني:
yurish	سير
bo&#39;lishiga	أن تكون
Yoqub	يعقوب
o&#39;ylagani	فكر
ShU	DE
kodi	رمز
qanotlari	أجنحة
toplar	قمم
o&#39;sha	أن
ketdi?	؟
From	من
e_mail:	e_mali:
farqi	الفرق
rioya	الامتثال
plitalari.&quot;	. لوحات ومثل؛
chips	رقائق
turmaydi,	الاحتكار،
gigantlar	عمالقة
sakkiz	ثمانية
Sir	سر
(xokkey	(الهوكي
Kolorado,	كولورادو
olmayman.	لا أستطيع.
haqiqatni	الحقيقة
--------------------	--------------------
olmayman,	لا أستطيع،
Injilni	الإنجيل
matn	نص
Shu	هذا
Yo&#39;lovchilarning	الركاب
BIOS	BIOS
bormi	هل
kashfiyot	اكتشاف
Demak,	لذلك،
er,	،
olmoq:	تغذيات:
gaplashayotgan	الحديث
anketalar	استطلاعات الرأي
(tvtwm)	(Tvtwm)
Ibrohimning	إبراهيم،
aytgan	قال
shakllanishi	تشكيل
(Chris	(كريس
fuqarolarini	المواطنين
qonun&gt;	القانون و GT.
Masihning	يسوع المسيح
keltirildi.	جلبت.
haqiqatga	واقع
mulkiy	ممتلكات
Narxlari	أسعار
mahalliy	محلي
muzokaralar	محادثات
og&#39;diruvchi	حجرة التجميد
bosqichi	مرحلة
bo&#39;lmasligi	ليس
ko&#39;rsatish	عرض
etish	إلى
drayveri	سائق
sci.med	sci.med
tayansak,	نحن نعتمد على،
sistemleştirmek	منهجة
(Darryl	(داريل
Umuman	عام
vfintd.386	vfintd.386
Anything	أي شئ
Dori	دوري
Zaif	عرضة
takliflarni	اقتراحات
aniqlash	تقرير
metall,	المعادن،
Macworld	مكوورلد
Bitnet	البتنت
Denning	دينينغ
Vashington	واشنطن
somwhere	سمور
eítiyotsizlik	متهور
vaqtida	في حينه
janubiy	جنوبي
devide	ديفيد
Matto	ماثيو
iste&#39;dod	موهبة
onboard	على متن الطائرة
Sen	أنت
Ahd	عهد
ezilgan	مهروس
atmosferasining	الجو
ular	هم
bobda	باب
Rabbimiz	الرب
uchun).	).
Emas	ليس
ishlari	أعمال
chill	قشعريرة
keng,	على نطاق واسع،
esa	و
yopishgan	الانضمام إلى
----------------------------------------------	----------------------------------------------
harakat,	عمل
mumkinmi?	هل من الممكن؟
kolleji,	كلية،
Sotish	بيع
sys.ini	sys.ini
(Ey)	(O)
nasroniylik	مسيحية
savolga	سؤال
stansiyalari	محطات
milliard	مليار
do&#39;stim	صديقي
Richard	ريتشارد
TTL	TTL
futbolchilar	اللاعبين
:-)	:-)
Muhitini	بيئة
odamsiz	كنت
Chiroqqa,	مصباح،
evropaliklar,	الأوروبيون،
tizimlari	أنظمة
Karlton	كارلتون
harakat:	العمل:
yoqimsiz	بغيض
boshingni	رئيس
soliq	ضريبة
urushi	حرب
bo&#39;lishini	أن تكون
Birinchi	أولا
noo&#39;rin	غير مناسب
mana	هنا
again	موجه
oak.oakland.edu:pub/msdos/windows3/winjp210.zip	html>
Air	هواء
bormoqda,	غير
tanasi	الجسم
dastur&gt;	وGT.
navbatida,	بدوره،
bormoqda.	هو.
bormoqda?	هو؟
Cuesta	كويستا
seysmik	زلزالي
imkoniyati	إمكانية
ishonch	الثقة
Kommutatsiya	التحول
namoyondalarining	يمارس
C.)	C.)
kunda	اليوم
Dodson)	دودسون)
&quot;gnostein?	على &amp; quot؛ gnostein؟
mintaqada	منطقة
ko&#39;rishingiz	رؤية
Barqaror	مستقر
ariza	تطبيق
kishi	الناس
tizimlar,	نظم،
topilgan.	تم العثور عليها.
son-sanoqsiz	لا تعد ولا تحصى
koma	غيبوبة
xonadoshim	رفيق الحجرة
topilgan,	وجدت،
tirilish	القيامة
&quot;yaxshi&quot;	على &amp; quot؛ جيدة ومثل؛
eng	معظم
Ular	هم
nuqta&gt;	نقطة &amp; GT؛
&lt;188@ky3b.UUCP&gt;	العلامة &amp; lt؛ 188@ky3b.UUCP&amp;gt.
BMP	BMP
TSC	TSC
tutadi.	المبلغ.
BMW	BMW
hissini	الشعور
ingl	مرئي
do&#39;st	أصدقاء
krater	فوهة البركان
imkoniyat,	فرصة،
Giotto	جيوتو
sinishi	كسر
strong&gt;	قوية وGT.
Shubhali	مشكوك فيه
kon!	التعدين!
Otasi	والده
jamiyat&quot;	المجتمع ومثل؛
Barton)	بارتون)
fikrlarini	أفكار
daraja	مستوى
orqasida	خلف
qism	جزء
konini	منجم
&#39;joylashgan.	&quot;.
&quot;orqaga	على &amp; quot؛ العودة
sening	ك
ikkinchi)	الثانية)
kommutatsiya	التحول
loyihalarni	مشاريع
nasling	بذرة
mollarni	بضائع
qobiliyatini&gt;	قدرة &amp; GT؛
parchalanish	DECAY
atmosferasi	الجو
ega.	.
&#39;93)	&#39;93)
manzara	مشهد
ega,	،
tingladi.	مقطع.
Davis)	ديفيس)
Crash	تحطم
vazifalarni	المهام
suyuq	سائل
Amr	عمرو
mart	مسيرة
tavsifi	وصف ل
vaziyatni	حالة
ega;	؛
mikrometeoritleri	الجسيمات النيزكية الدقيقة
C2.	C2.
go&#39;yo.	غويا.
(ayniqsa	(خاصة
aylanayotgan	يدور
empedans	مقاومة
Ana	آنا
texnologiyalari	تكنولوجيا
(),	()
1-301-340-4543	1-301-340-4543
().	().
degan	أن
miyop,	miyop
munosabat-nazorat	السيطرة على الموقف
investitsiyalash	استثمار
(10-105	(10-105
kimyosi	الكيمياء
candida	المبيضات
&gt;&gt;.	وطن؛ &amp; GT؛
Sayyoralar,	الكواكب
bloklari	كتل
&gt;&gt;,	وطن؛ &amp; GT؛،
vositalar	الأجهزة
ko&#39;zlarimga	عيون
jang	عراك
Delaware	ديلاوير
email:	البريد الإلكتروني:
755-8742	755-8742
qutqarishga	إنقاذ
qayg&#39;u	حزن
sayyoralarda	الكواكب
behisob	لا يعد ولا يحصى
Galant,	جالانت،
sifatida,	كما
jismoniy,	المادية،
sifatida.	.
qasddan	عمدا
sifatida:	على النحو التالي:
Falastinga	فلسطين
tez-tez	كثيرا
fundamental	أساسي
jmilhoan@magnus.acs.ohio-state.edu	html>
So.	H
jami	مجموع
agar)	أ)
agar,	إذا،
Namoz	صلاة
Markaz	مركز
gt7469a@prism.gatech.edu	html>
guvoh	الشاهد
1312	1312
Alt.psychology.personality	Alt.psychology.personality
rost,	صحيح،
Nima	ما
saqlash	حفظ
ettirmaydi.	لا.
atmosfera	الجو
Buy	منارة
yurishlari	يمشي
borligini	وجود
(6)	(6)
&lt;No.	العلامة &amp; lt؛ رقم
yangilangan	تحديث
tegishli	الاقتضاء
miltiq&gt;	بندقية و GT.
qilinadi&gt;	وGT.
(59	(59
Adaptec	ADAPTEC
evro	اليورو
qildi	وجدت
uyasi	فتحة
salmon	سمك السلمون
Doimiy	دائم
gif	GIF
nega	لماذا
arab	عربي
mo&#39;ljallangan,	تصميم
buyurgan.	أمر.
sababli	لذلك،
(5)	(5)
huquqlar	حقوق
Qonun	القانون
Umbriel,	أومبريا
ganimedes	ganimedes
qo&#39;llab-quvvatlash,	الدعم،
oylar	أشهر
Asteroids	الكويكبات
Page)	الصفحة)
neft	نفط
qo&#39;riqlab	حراسة
Barton	بارتون
yadrosidagi	جوهر
qilsinlar.	السماح.
(4)	(4)
Bu,	هذا هو
&quot;orbitasida	على &amp; quot؛ المدار
Landmann&gt;	Landmann &amp; GT؛
ulagichlar	موصلات
tizimlari,	نظم،
irodasi,	موجه،
Ning	S
kometalar	المذنبات
vahima	ذعر
&quot;Evropa	على &amp; quot؛
yadro	نووي
normal,	طبيعي
sindromi)&gt;	متلازمة) وGT.
Mening	لي
Agar	إذا
barcha?	كل شيء؟
dogma	عقيدة
SUV	سيارات الدفع الرباعي
ko&#39;rinadi?	يبدو؟
Jismoniy	المادية
(3)	(3)
Obligatsiyalar	قيود
etilgan	ثابت
ko&#39;rinadi.	سيتم عرض.
qo&#39;llab-quvvatlashi	دعم
variaty	فارياتي
barcha)	جميع)
Capture	أسر
[26]	[26]
Aytib	قال
barcha.	جميع.
masalan,	على سبيل المثال،
(27	(27
dushmanlarini	الأعداء
zambil	طمي
ko&#39;rinadi)	يبدو)
(24	(24
qutisi	البريد الوارد
faqat	فقط
aylanayotib,	التحركات
aylanayotib.	مدارات.
kodlangan	مشفرة
Uchun	ل
kungi	يوميا
sindirish	استراحة
kuni,	اليوم،
ongida	في عقول
(2)	(2)
kelmading,	لا
Miranda,	ميراندا،
======================	======================
tomondan,	من ناحية أخرى،
82:	82:
(1)	(1)
ko&#39;zga	عين
qoldirib,	مغادرة
ulangan	متصلا
saqlanib	محفوظ
============================================	============================================
(745	(745
yangilash	تجديد
Bibliya&gt;	الكتاب المقدس و GT.
[23]	[23]
LaStrange)	LaStrange)
Ruh	روح
kun-klub	النادي -يوم
ishlatish,	استخدام
avtomobillari	السيارات
yuramanmi	ميناء
qiyosiy	نسبي
aralashtirmang.	لا تخلط.
jasorat	شجاعة
moddalar	المواد
goaltender	حارس مرمى
ekspluatatsiya	استغلال
ularning	هم
optik	بصري
tarixchilar,	المؤرخون،
[24]	[24]
nodir	فريد من نوعه
[25]	[25]
oldida,	أمام
Halqalarni	خواتم
Avtomatlashtirilgan	الآلي
yopiladi.	مغلقة.
&quot;Pavel	على &amp; quot؛ بافل
Diffie-Xellman	ديفي هيلمان
(Yuk	(يوك
I3150101@dbstu1.rz.tu-bs.de	html>
7-sirt	7 السطح
jh6r@andrew.cmu.edu	html>
(Bake	(خبز
shakllantirildi	شكلت
manevra	المناورة
gaz	غاز
iltimos	من فضلك
MUMKIN	MAY
so&#39;rab,	تطلب
qiling.	.
Sam	سام
foydalanishingiz	استعمال
import	استيراد
eslayman,	أتذكر،
Cramer,	كريمر
elliptik	بيضاوي الشكل
Franjione)	Franjione)
Cramer)	كريمر)
Triantafyllopoulos	Triantafyllopoulos
quyilib	تركيز
(?)	(؟)
«ob&#39;ektiv	&quot;الهدف
ring	عصابة
qiling!	من فضلك!
prognozi	توقعات
plutoneon,	plutoneon
boshladi&gt;	وGT.
so&#39;yilgan	ذبح
to&#39;laydi	لدفع
buzilgan	فاسد
qanchalik	كيف
UUCP:!	لا شيء UUCP
raqamlari	أرقام
&quot;ob&#39;ektiv	على &amp; quot؛ الهدف
Iste&#39;mol	استهلاك
gay	GAY
Umumiy	عام
poster	الملصق
salafiy	السلف
&lt;id.XNFZ.VJ8@nmti.com&gt;	العلامة &amp; lt؛ id.XNFZ.VJ8@nmti.com&amp;gt.
&quot;q&quot;	على &amp; quot؛ ف &amp; مثل؛
gap	جملة
mahalla	حي
ko&#39;zni	عين
=====================================	=====================================
9,846	9846
posted	شارك
variant	خيار
qilindi	كانت
edim!	فعلت!
aniqlash,	تحديد،
hobbiest	hobbiest
o&#39;zining	له
Depozit	الوديعة
neon	نيون
bermoq	منح
kelin-of-ko&#39;rinishida	نقطة من رأي
sharaf	شرف
&quot;atmosfera	على &amp; quot؛ الجو
xira	شاحب
(Richard	(ريتشارد
kislorod	أكسجين
c23st@kocrsv01.delcoelect.com	html>
doimiy	دائم
6x9	6X9
Sifatida	كما
&quot;Inson	على &amp; quot؛ الإنسان
San	سان
«Kim	كيم
nima.	ما.
(Scott	(سكوت
nima,	ما
kerakli	تريد
ishlash	أداء
boshlang&#39;ich	ابتدائي
Canadiens	كنديينز
unutdingizmi?)	نسيت كلمة المرور؟)
paytida,	خلال
edik.	كنا.
tushdi	خبز محمص
o&#39;rab	محاط
Juda	جدا
shuningdek&gt;	وGT.
Kinsey	كينزي
chiplari	رقائق
xterm	إكس تيرم
nima?	ماذا؟
uzatish	انتقال
DES	DES
Finlyandiya,	فنلندا
standart	معيار
753-3245,	753-3245،
bo&#39;lishimiz	أن تكون
2400	2400
qo&#39;llab-quvvatlasa,	الدعم
Rosa	روزا
Rockville,	روكفيل،
O&#39;qisak,	بقدر
urdi)	ضرب)
ligasida	الدوري
eshitilgan?	سمعت؟
qilib	كما
qoida	حكم
(93	(93
o&#39;xshash,	مثل،
tuzatishlar	التصحيحات
o&#39;rinda	مكان
edim.	فعلت.
cj195@cleveland.Freenet.Edu	html>
kuyrukluyıldızların	المذنبات
stylizied	stylizied
qaraganda,	وفقا ل
eslatib	ذكر
politsiya	شرطة
imon	إيمان
ayrilish	الفصل
uunet.	UUNET.
joylashtirilgan	وضعت
(88	(88
oynasida	نافذة
yodda	تذكر
ESPN	ESPN
atmosferada	الجو
harorati,	درجة الحرارة،
betob	تحقق في
hamkorlikda	تعاون
​​201	201
(128.149.6.2)	(128.149.6.2)
masalaga	قضية
Rowland,	رولاند
Kichik	صغير
Vayss	WEISS
Shimoliy	شمالي
&lt;1r1i7mINN4n4@cronkite.cisco.com&gt;	العلامة &amp; lt؛ 1r1i7mINN4n4@cronkite.cisco.com&amp;gt.
olmang.	لا.
eksklyuziv	باستثناء
korenek@nmti.com	html>
o&#39;ylardim.	اعتقدت.
amaldagi&quot;.	تيار &amp; مثل؛
sharoitlar	الشروط
o&#39;rnatish	تركيب
arablaridan	العرب
Hadi	هادي
yahudiylarga	اليهود،
jigarrang	أسمر
Gyuygens	هيغنز
24:46	24:46
ba&#39;zan	أحيانا
xaritalash	رسم الخرائط
umid	أمل
achitqilari	الخمائر
uchdan	-thirds
Harumph.	Harumph.
barqaror	مستقر
hikoya	قصة
faoliyati	الأنشطة
Spin	غزل
xulq&quot;	السلوك ومثل؛
vacsc0qe@VAX.CSUN.EDU:	html>
Nelson)	نيلسون)
davlatlar	الدول
Astronomlar	علماء الفلك
kelgan&gt;	وGT.
A&gt;	A &amp; GT؛
Zbib	زبيب
yashaydi	حياة
ro&#39;parasiga	دقة
paydo,	،
qilardi	قيمة
etilmoqda	هي
(Bu	(هذا
VanHeyningen	VanHeyningen
Balki	ربما
yodgorlik	نصب تذكاري
yupqa	رقيق
ammiak	غاز الأمونيا
nozil.	كشفت.
qulflangan	مغلق
kameralar	كاميرات
o&#39;ylab	اعتقد
SKS	SKS
anglatadi	الوسائل
amaliyot	ممارسة
hammasini	كل
qilsa	إذا كان
leonard@aix3090b.uky.edu	html>
2300	2300
Madaniyat	ثقافة
sizlardan	من أنت
rahbarlar	القادة
qaytgan	عاد
&quot;qurol	على &amp; quot؛ الأسلحة
nozik,	غرامة،
Ammiak	غاز الأمونيا
haydovchi	سائق
displeyda	العرض
00ecgillespi@leo.bsuvc.bsu.edu&gt;	00ecgillespi@leo.bsuvc.bsu.edu&amp;gt.
ulardan	منهم
birdan	فجأة
End,	نهاية
qilaman,	أنا
ketkazdi.	سحرت.
parchalanishi	الاضمحلال
potentsial	إمكانية
Qonunchilikni	التشريع
ikkinchi	في المرتبة الثانية
Citizen	مواطن
o&#39;qotar	بنادق
415-	415-
olgan,	،
parented	أصليا
«SRESURRECTION:::	SRESURRECTION :::
anakartı	اللوحة الأم
ro&#39;yxatiga	قائمة
Afrika	أفريقيا
asosiy	رئيسي
olib&quot;	ومثل؛
to&#39;p	مدفع
Biz	نحن
to&#39;q	البرتقالي
G&#39;arbga	غربا
his-tuyg&#39;ularini	مشاعر
yashagan	عاش
Kirk.	كيرك.
&lt;jh6r+@andrew.cmu.edu&gt;	العلامة &amp; lt؛ jh6r+@andrew.cmu.edu&amp;gt.
AQSh	الولايات المتحدة الأمريكية
qurol:	الأسلحة:
infüzyonları	ضخ
mening&gt;	I &amp; GT؛
erkaklar	الرجال
do&#39;konlari	المحلات التجارية
xodimlari	العاملين
qilaman.	أنا.
qurol,	أسلحة
Bir	واحد
United	الولايات المتحدة
beradi!	!
Robert	روبرت
kilometr	كيلومتر
Lekin	لكن
hitter)	ضاربا)
Iordaniya	الأردن
do&#39;stlarim	أصدقاء
izlab	البحث
SER	SER
SET	SET
moddiy	مادة
Re:	رد:
20-asrning	القرن 20th
chetlashish	الاضطرابات
beradi,	،
araştırdıktan	البحث
Re?	إعادة؟
beradi.	.
Public	جمهور
Red	أحمر
qilmoqda	يريد
Sizning	ك
beradi:	على ما يلي:
yoki	أو
holatlar	ظروف
dengizchilar	البحارة
faoliyat,	نشاط
qilsa,	إذا كان
plakatlar	ملصقات
o&#39;zgargan,	تغيير
odamlarning	الناس
&quot;Jonathan	على &amp; quot؛ جوناثان
html>	أتش تي أم أل&gt;
flash	فلاش
fikr	فكر
SPL	SPL
o&#39;rni	دور
moliyalashtirilgan	ممولة
ingichka	رقيق
foo	فو
bo&#39;ladigan	سوف
sinflari	فصول
natijasidir.	نتيجة لذلك.
COD	COD
---------------------	---------------------
girdap	دوامة
yondashuv.	النهج.
stoli,	على سطح المكتب،
yondashuv,	نهج
fikr?	أفكار؟
POBox	صندوق البريد
kiritdi	وون
Ishga	أطلقت
Illustrated	يتضح
o&#39;g&#39;li	ابنه،
shaxslar	الأشخاص
Kamida	على الأقل
masalaning	قضية
mohiyati	جوهر
beysbol	البيسبول
meni,	لي
yahudiylarni	اليهود
Ron	رون
mezonlari.	المعايير.
menga	لي
manfaatdormiz.	نحن مهتمون.
O&#39;pka)	الرئة)
bugun	اليوم
Endi	الآن
yulduzli	النجوم
buyumlar	البنود
Crawford	كروفورد
qo&#39;lini	يد
narxda,	أسعار
belgilab	تعريف
doirasida	في إطار
munozara,	الحديث،
yaxshiroq)	أفضل)
murakkab.	مجمع.
ro&#39;yxatida	قائمة
Lebannon	Lebannon
quvonch	فرح
PowerBook	بووربووك
IMHO,	IMHO
OLIY	العالي
Yuhanno,	جون،
Milodiy	CE،
baland	ارتفاع
Tarixan,	تاريخيا،
(qayta:	(إعادة:
yilning	عام
bo&#39;lmasa&gt;&gt;,	أو &amp; GT؛ &amp; GT؛،
uzatish,	انتقال
eksport	تصدير
Nyu-Yorker,	نيويورك،
Isoning	يسوع
boruvchi,	المنتهية ولايته،
kurash	النضال
Spot	بقعة
ko&#39;rsatilgan	وترد
o&#39;zgardi	تغيير
Yahudiy	اليهودي
uzuk,	حلقات،
noqulayliklarni	إزعاج
(5,25	(5.25
asar	أثر
qishda	في فصل الشتاء
(J.	(J.
eksantrikliği	الانحراف
»,	&#39;
274-5357	274-5357
».	.
&lt;1993Apr21.234159.1206@ualr.edu&gt;	العلامة &amp; lt؛ 1993Apr21.234159.1206@ualr.edu&amp;gt.
duch	وجه
yagona	فقط
ko&#39;rmagan	رأيت
&quot;Drakula&quot;	على &amp; quot؛ دراكولا ومثل؛
[standart	[قياسي
maydon	منطقة
yog&#39;och	خشب
...]]	...]
Ommaviy	كتلة
nuqtasi,	نقطة،
ibodat&gt;	الصلاة و GT.
(Edward	(إدوارد
hafta	أسبوع
asosan	أساسيا
Regards,	التحيات،
qalin	سميك
Kitobda,	كتاب
muhokama	مناقشة
taxminan	تقريبا
skaner.	الماسح الضوئي.
geyzer	نبع ماء حار
qo&#39;llaniladi)	ينطبق)
keltirib	جلب
(kim	(منظمة الصحة العالمية
Matsuo,	ماتسوي
so&#39;rash	تطلب
Xokkey	الهوكي
farqlar	الخلافات
oshiriladi?&quot;	؟ ومثل؛
yaqin-up	عن قرب
fuqarolik	مواطنية
15-ilon	15-ثعبان
Indoneziya	أندونيسيا
departamentining	قسم
kimdir&gt;	شخص وGT.
Barcha	كل
Columbia&gt;	كولومبيا وGT.
Xodimlar	أفراد
o&#39;roq	منجل
parolini	فك تشفير
Bos	بوس
90%	90٪
So&#39;rov	طلب
video,	فيديو
keyin,	ثم،
Monreal,	مونتريال،
Yoki	أو
qilayotgan	تفعل
galma	بالتناوب
mehmondo&#39;stlik	حسن الضيافة
qaragan	مواجهة
fayllari	ملفات
Odamlar	الناس
missiya	مهمة
yosh	شاب
omadsiz	غير محظوظ
OpenLook	OpenLook
Bunday	مثل
aytiladi.	قال.
Vehical	Vehical
ta&#39;siri:	تأثير:
sharma@tiger.vill.edu	html>
ziyolilar	المثقفون
asrlar,	قرون،
faoliyatida	أنشطة
ta&#39;sir&gt;	وGT.
trayektoriya	SPIE
tortish	خطورة
hayvonlar	الحيوانات
&lt;C5w5CB.Ct4@rahul.net&gt;	العلامة &amp; lt؛ C5w5CB.Ct4@rahul.net&amp;gt.
video	فيديو
(&lt;o&gt;	(&amp; اللفتنانت؛ س &amp; GT؛
sayyohni	السياح
quyruq	ذيل
^^^^^^^^^^^^^^^^^^^^^^^^^^	^^^^^^^^^^^^^^^^^^^^^^^^^^
topmadik.	لا يمكن العثور عليه.
(John	(يوحنا
ko&#39;rsatgan.	.
jinoyatchilar	المجرمين
qondiradi.	كافية.
Bundan	بالإضافة إلى ذلك،
73,	73
He&gt;	انه &amp; GT؛
Friedman	فريدمان
kaliti,	المفتاح
hukmronligi	حكم
yuboriladi	أرسلت ل
bir:	و:
kichikroq,	أصغر،
kengash	مجلس
bir,	ل
nomidagi	اسمه
Station	محطة
27.6	27.6
Thanx	ثنإكس
axloqini	أخلاق
Najotga	خلاص
voqea	حدث
qobig&#39;ining	القشرة
jurnallar	تسجيل الدخول
(lekin	(ولكن
hukumatining	حكومة
rejalari	خطط
emasman&quot;	أنا لست مثل &amp;؛
hunar	مهنة
Lampoon_	Lampoon_
Asteroid	الكويكب
Selannes	Selannes
taqdim),	)
izlayapman.	أود.
ukasi	شقيقه
OLIVEIRA	أوليفيرا
foydalanishni	استخدام
biri	واحدة من
suv-muz	المياه والجليد
sho&#39;ng&#39;idi	وارتمى
410-34-1	410-34-1
Software	البرمجيات
yogurt	زبادي
dinamik	ديناميكي
to&#39;lash	لدفع
Hitter	ضاربا
ko&#39;tardi	أثار
kata	على الأرض
qutb	قطب
Tezligi	سرعة
[Bo&#39;ldi	[بولد
kengashi	مجلس
Buyurtma	ترتيب
&quot;Uran	على &amp; quot؛ أوران
700	700
703	703
kuchga	قوة
tayanib	الاعتماد على
Va,	و
serverda	الخادم
Microsoft	مايكروسوفت
Maplewood	خشب القيقب
yaratilgan.	بإنشائه.
elementlarning	العناصر
Kennedi	كينيدي
voqea,	حدث
DX)	DX)
tashrif	زيارة
dan	من
dam	بقية
tasvirni	صورة
gazni	غاز
&quot;optik	على &amp; quot؛ البصرية
o&#39;ylayman),	على ما أظن)
Cup	كوب
dumaloq	جولة
I&gt;	I &amp; GT؛
Lee)	لي)
besoqolbozlik	المثلية
ABI,	ABI
tarkibiga	جزء من
Nanaimo	نانايمو
soni.	.
&lt;o&gt;)	واللفتنانت؛ س &amp; GT؛)
&quot;imkonini	على &amp; quot؛
maydoni,	منطقة
Kennedy	كينيدي
vaqtinchalik	مؤقت
cl056@cleveland.Freenet.Edu	html>
(Spiros	(سبيروس
o&#39;rinli,	المقاعد
kallapo&#39;sh	kulupush
7,5	7.5
ishongan	الذي يعتقد
ko&#39;rgan.	.
maydonga	رمية
kasb	مهنة
Moroccans	المغاربة
uyimni	منزل
ko&#39;rib,	،
emasmanmi?	أنا؟
&lt;1APR199313404295@skyblu.ccit.arizona.edu	html>
1200	1200
200uf	200uf
devi&quot;	عملاق ومثل؛
vitamin	فيتامين
haydovchilar	السائقين
redraws	يعيد رسم
gapira	في الكلام
(61302	(61302
Ave.	افي
Psevdo-tibbiy	شبه الطبي
samolyot	الطائرات
ravishda,	وفقا لذلك،
g&#39;azabini	الغضب
Henry	هنري
atalmish	دعا
ibodat.	الصلاة.
Whitten	ويتن
Tushuntirib	شرح
ibodat,	عبادة
ming&#39;irlaydi	يتمتم
zbib@bnr.ca	html>
betel@camelot.bradley.edu	html>
muolajalar	العلاجات
kengaymoqda	توسيع
ayrim	فصل
va.	و.
&lt;,	العلامة &amp; lt؛،
hajmi	حجم
va,	و،
(IMHO)	(IMHO)
o&#39;tmishda,	في الماضي،
so&#39;zlar	الكلمات
oshirildi.	زيادة.
McCord,	ماكورد
va!	و!
ularga	منهم
DOSKEY	DOSKEY
(mening	(بلادي
qatlam	طبقة
home	منزل
MS-Windows	ميكروسوفت ويندوز
raketa&quot;	الصواريخ ومثل؛
Pentium	بنتيوم
foydalanilgan	وقد استخدم
_outside_	_outside_
(Medicare	(الرعاية الطبية
(Milliy)	(الوطني)
dahshat&gt;	الإرهاب وGT.
rauser@fraser.sfu.ca	html>
jarayonlarini	العمليات
istaydi,	يريد
empirik	التجريبية
HMMMMMMMMMMMMMMMMMMMMMMMMMMMMMMMMMMMMMMMMMMMMMMMMMMMMMMMMMMM	HMMMMMMMMMMMMMMMMMMMMMMMMMMMMMMMMMMMMMMMMMMMMMMMMMMMMMMMMMMM
Fayl	ملف
o&#39;zida,	في
Tuzatish:	تصحيح:
ularda	هم
Deb	أن
oshirildi?	زيادة؟
qonunlari	قوانين
badjahl	غاضب
(severy)	(العديد)
bor).	).
o&#39;ylayman.	على ما أعتقد.
o&#39;ylayman)	على ما أظن)
​​_him_	_him_
axloqiy,	الأخلاق،
keyingi?	في المرة القادمة؟
o&#39;ylayman,	أعتقد،
Xiram	حيرام
Oberon	أوبيرون
homo	لوطي
.....	.....
Van	عربة
alanga	لهب
&lt;2958804@QUCDN.QueensU.CA&gt;	العلامة &amp; lt؛ 2958804@QUCDN.QueensU.CA&amp;gt.
ishqalanish	احتكاك
Office:	المكتب:
yig&#39;ilib	قابلة للطي
viloyat,	الإقليمية،
Wai-Ming	واي مينغ
dunyoda	العالم
buzmasdan	دون كسر
ifodalaydi.	الرموز.
olqishlaymiz.	نرحب.
litsenziyaga	المرخصة
tashlashdi	يلقي
tutyapman.	أعنيه.
qulf	قفل
xususiyati	ميزة
esgan	إيسن
&quot;Lekin,	على &amp; quot؛ ومع ذلك،
sinüzit	إلتهاب الجيب
qo&#39;shnisidan	الجيران
uzr	اعتذار
Mags&gt;	أكواب وGT.
Terrorizmga)	الإرهاب)
gt7469a@prism.gatech.EDU	html>
Frank	فرانك
taxmin?	تخمين؟
taqiqlash,	حظر
622121	622121
energiya	طاقة
narxlari	أسعار
&lt;Men	العلامة &amp; lt؛ I
joylardan	الأماكن
Dastur	برنامج
biz,	ونحن،
yanvar,	في يناير،
fanining	علم
hazir	احترس
1978,	1978
farqlarni	الخلافات
muxlislari	المشجعين
manzarani	صورة
taxmin,	مقدر
samarali	فعال
Ya&#39;ni,	وهذا هو،
hazil	مرح
Kreiling)	Kreiller)
yuborilishi	أرسلت
Dan	من
sxema	الرسم البياني
chetda	وبصرف النظر عن
Regio	رجو
&quot;arab?&quot;	على &amp; quot؛ العربية &amp; قووت]؛؟
uya	التشغيل الآلي،
kuchli	قوي
o&#39;rgatish.	التدريس.
cratered.	متهالكة.
orbiters	المدارية
hisoblayman	أعتقد
muxlislar	المشجعين
goolsbey@cs.utexas.edu	html>
tortiladi	تخضع ل
ma&#39;lumotni	معلومات
750	750
Ford	مخاضة
tashqari	إلا
avtomobil	سيارة
tipi	الفضاء
Faehl	Faehl
oladi)	)
oladi,	،
oladi.	.
tayanch	قاعدة
nishonlash	احتفال
organlarning	الهيئات
VLB	VLB
32-bit	32-بت
Earth-o&#39;lchamli	الأرض الحجم
Avgust	آب
bo&#39;lyapti	كرر
king@reasoning.com	html>
emasligini.	لا.
yo&#39;l	طريق
dunyoni	عالم
486DX-33	486DX-33
yo&#39;q	لا
4.0-4.3	4،0-4،3
tizimli	النظامية
parametrlarni.	المعلمات.
oqimi,	تدفق
shovqin	ضجيج
uzoqlasha	إلى الانحراف
Cleopatra	كليوباترا
beriladigan	صدر
ketadi.	النفقات.
Ular&gt;	أنها وGT.
ketadi,	الذهاب
o&#39;tish&gt;	وGT.
buyurtma	ترتيب
yashil	أخضر
Mars,	المريخ
Steve	ستيف
VLX	VLX
tanaffus	استراحة
R&gt;	R &amp; GT؛
DLC	DLC
ko&#39;rish	رأي
jarayonlarni	العمليات
blaisec@sr.hp.com	html>
diagramma	مخطط
VMS	VMS
Duglas	دوغلاس
ayblashadi.	المتهم.
Etarli	كاف
Um,	أم،
Farangeyt)	فهرنهايت)
Plutondan	بلوتو
darcha	نافذة
ekan&gt;&gt;	وGT؛ &amp; GT؛
unga	لها
Mocker)	موك)
DMA	DMA
tanqid	نقد
o`chirilishi	MUTE
zaryad	تهمة
nuqtada,	عند هذه النقطة،
va&#39;z	خطبة
Algoritm	خوارزمية
uzr,	آسف،
manzarasi	المشهد
(Hal	(هال
Mitsubushi	ميتسوبيشي
gapirib,	يتحدث،
(Ham	(حسنا
----	----
yonga,	رقاقة،
tirilgan	بعث
yozish,	إرسال
to&#39;liq&gt;	وGT.
uzoq	بعيدا
(bo&#39;lishi	(أن تكون
Iso&gt;	يسوع وGT.
______________________________________________	______________________________________________
hayot	حياة
bor.)	هناك).
yaxshilaydi.	يحسن.
Tashqari,	بالإضافة إلى ذلك،
&lt;May.12.04.27.47.1993.9935@athos.rutgers.edu&gt;	العلامة &amp; lt؛ May.12.04.27.47.1993.9935@athos.rutgers.edu&amp;gt.
Uni	لها
berganda	عندما
imkoniyat	فرصة
ko&#39;ryapsizmi?	هل ترى؟
ron.roth@rose.com	html>
atrof-muhit	البيئة
shakllantiradi,	شكل
ko&#39;ring	محاولة
to&#39;g&#39;riligi	دقة
Teodor	تيودور
ikkinchi-tartibi	من الدرجة الثانية
ishlatiladi	يستخدم
bajarilgan	أداء
qo&#39;ndi	هبطت
orbitasi:	المدار:
&quot;Stiven	على &amp; quot؛ ستيفن
og&#39;riq	ألم
nazar	نظرة
&quot;Borland	على &amp; quot؛ بورلاند
5500	5500
tarkibi	تركيب
Elektr	كهربائي
o&#39;yladim	ظننت
xo&#39;jaligi	زراعة
7.00	7.00
atrof-muhit,	بيئة،
(317)743-1394	(317)743-1394
beshinchi	خامس
uzuk	عصابة
Kasal-tabib	على المريض والطبيب
xelion	خليل
juliet	جولييت
yashashni	للعيش
g&#39;oyaviy	أيديولوجية
140-165	140-165
bilimdon	المعرفة
Kishi	الناس
qog&#39;ozga	ورقة
davlatni	دولة
kavlash	ترسيخ
bo&#39;lishini,	،
(qayta	(
derazadan	نافذة
ijtimoiy-kalit	المفتاح العام
batman@cisco.com	html>
tuzatish,	التصحيح،
(-290	(-290
kabi	مثل
tizimi,	نظام
(Aaron	(آرون
bor-ku.	هناك.
oson	سهل
(-298	(-298
tizimga	تسجيل الدخول
(masalan,	(على سبيل المثال،
umr	حياة
Deportes	ديبورتيس
tizimda	نظام
shakllari	أشكال
(masalan)	(مثال)
yurgan	المشي
mutaxassis.	الموظفين.
zohiriy	الظاهر
Diffie-Hellman	ديفي هيلمان
dunyolar,	العالم
Falastinliklar,	الفلسطينيين
8,6	8.6
sahrolarda,	الصحاري،
lavozimidan	موقف
million	مليون
kashf,	اكتشاف،
ekstrapolyatsiya	استقراء
hayotdirman	حياة
8.1	8.1
uni	لها
munozara	خلاف
rahbarlari	رؤساء
ixtirochi	مخترع
Rosenau)	ROSENAU)
Ya&#39;ni	وهذا هو،
Prezident	رئيس
misoldir.	المثال.
harakatlar	الإجراءات
modellashtirish	تصميم
tanlang.	حدد.
atrofida	حول
kuzatish	ملاحظة
sababi	السبب
xavfsizlik	أمن
jamoalarini	فرق
_____________	_____________
daryolar	الأنهار
ishonamiz.	ونحن نعتقد ذلك.
Apollon	أبولو
shaklidagi	في شكل
(Bibliya	(الكتاب المقدس
qolgan.	.
(NRSV)	(NRSV)
butaning	شجيرة
janob,	سيد
ulangan?	اتصال؟
(Ishoq	(إسحاق
Mouting	فم
8,1	8.1
ORIGINAL	ORIGINAL
QANDAY	HOW
Otaning	الأب
ulangan)	متصلة)
alane@microsoft.com	html>
gomoseksualizm	المثلية
hit&gt;	ضرب &amp; GT؛
afronted	afronted
radio	راديو
avgust,	آب
hujumga	هجوم
yopildi	إغلاق
asteroids	الكويكبات
keskin&gt;	الحرجة وGT.
orbitalari	مدارات
radar	رادار
DEVICEHIGH	يستعاض
chora	تدابير
Springs,	الينابيع
evropalik	أوروبية
olimlar	العلماء
UUNET:!	لا شيء UUNET
&quot;Yahudiy	على &amp; quot؛ اليهود
shartlar	الشروط
miqdori	كمية
JPB-sertifikatlangan	سلطة المصادر الطبيعية معتمدة
oxiri	نهاية
Clr	CLR
issiqlik	حرارة
Yernikiga	أرض
reyslar	رحلات
ayblashga	لوم
masalalar	قضايا
Stein	شتاين
Howdy!	مرحبا!
9.128:	9.12:
sintezlashga	الصمامات
Gretzky	Gretzky
to&#39;pponcha	مسدس
pastlab.	التباطؤ.
unda	ثم
deydi	يقول
Unga	لها
DOS	DOS
deraza	نافذة
orollar	الجزر
(Leonard	(ليونارد
ayblovlarni	اتهامات
tajriba	تجربة
zulm	مظلوم
&lt;1qvb5aINNmoi@darkstar.UCSC.EDU&gt;,	العلامة &amp; lt؛ 1qvb5aINNmoi@darkstar.UCSC.EDU&amp;gt،،
tadbir	حدث
dastur	برنامج
thanks,	شكر
(har	(
mavjudotlar	الأصول،
seriya	مسلسل
vaqti	مرة
«vaqtinchalik	&quot;المؤقتة
tashviqot	دعاية
microsoft	مايكروسوفت
Jo&#39;natuvchiga)	المرسل)
belgilangan.	المعمول بها.
ketyapsan?	أنت ذاهب؟
Misr	مصر
Deptt.	قسم
Siz&gt;	لك &amp; GT؛
tarkibini	محتويات
Dovudni	ديفيد
azob-uqubatlarga	معاناة
chekishi	تعاني
belgilangan,	،
nuqta	نقطة
bo&#39;yicha	في
tadqiqot&quot;	الأبحاث ومثل؛
Masih&gt;	المسيح &amp; GT؛
(Michael	(مايكل
eshitildi.	سمعت.
cheklangan	محدود
mamlakatlarda	الدول
boradi	سوف
g&#39;amxo&#39;rlik	رعاية
hududlar	الأراضي
utzoo!	utzoo!
qoladi.	لا يزال قائما.
qoladi,	لا يزال،
uchirish	رمي
taxmin)?	تخمين)؟
kutilmoqda,	متوقع
Germaniya	ألمانيا
ko&#39;rsatib,	،
mukammal	مثالي
illyuziya	أوهام
qilamanki,	أنا
FAQ	التعليمات
klinik	سريري
deb&gt;	وGT.
turadi.	.
sguerke@brahms.udel.edu	html>
patlarni	الريش
koutd@hiramb.hiram.edu	html>
kulba	كوخ
lift-off	انطلاقه
CLEAR	واضح
yangi.	الجديد.
yangi,	جديد،
imoni	إيمان
shakllantirdi.	شكلت.
V9R	V9R
inkor	رفض
o&#39;liklar	ميت
manfaati	صالح
tuzoqqa	ساران
kelsak.	كما.
aloqalar	العلاقات
markaziga	مركز
Shtatlarida	الدول
yo&#39;lovchilarning	الركاب
uch	ثلاثة
Stalin	ستالين
aqlli	ذكي
dengizda	البحر
qanday.&quot;.	. ومثل؛
hayvon	حيوان
tartib	ترتيب
oqimlarni	تيارات
ekspeditsiya,	حملة
hodisa	حدث
AAS-92-186,	AAS-92-186،
ikkovlari	كل من
vaqt.	الوقت.
tog&#39;li	جبلي
bo&#39;lmadi,	ليس
berdimi	كان
tasvirlari	الصور
Kuchliroq,	أقوى،
(aniq)	(واضح)
23-25).	23-25).
tadqiqot	بحث
tovushlar	الأصوات
degani?	يعني؟
sifatli	جودة
korenek)	korenek)
committ	يرتكب
tovushlar.	يبدو.
to&#39;sqinlik,	منع،
1/1000,	1/1000
tug&#39;ilgan,	عيد ميلاد،
odamlar,	الناس
sentyabr	أيلول
tug&#39;ilgan.	ولد.
mintaqani	منطقة
bayonot	بيان
&lt;Rauser.734062608@sfu.ca&gt;	العلامة &amp; lt؛ Rauser.734062608@sfu.ca&amp;gt.
deydi,	وقال:
tartibi,	أجل،
qaytish	العودة إلى
Ishoqning	إسحاق
markazida	في وسط
degani,	الوسائل
yo&#39;lda	على الطريق
qirqish	قطع
ailin):	Aili):
deydi.	قال.
qoidalarini	قواعد
lmouse	lmouse
dalil-belgilar	دليل على الطابع
deydi:	قال تعالى:
vaqt,	مرة
degani.	يعني.
vaqt)	الوقت)
Olti	ستة
(2.147	(2147
(Mustaqil	(المستقلة
tirik	سكن
sabab,	،
issiq	حار
uyat	عار
kamari	بيلين
paketini	صفقة
komissiyasining	لجنة
6,4	6.4
foydalanib	باستخدام
ega	ديك
marsliklarni	المريخ
qoidalariga	أحكام
cherkov	كنيسة
yo&#39;lga	مسار
99.9	99.9
(29.95)	(29.95)
kelinmoqda.	الوجود.
pastlab	التباطؤ في
tuyuladi,	على ما يبدو،
aqlga	عقل
engashib	انه انحنى ايضا الى اسفل
tuyuladi.	على ما يبدو.
so&#39;zlarning	الكلمات
kostyum	دعوى
1972-yilda,	في عام 1972، و
eslab,	تذكر،
qaramay,	ومع ذلك،
Banklar)	البنوك)
Parallel	مواز
bo&#39;lsangiz	إذا
nelson_p@apollo.hp.com	html>
ko&#39;rishni	رؤية
odamlar&gt;	الناس &amp; GT؛
(932	(932
Dorothy	دوروثي
.indiana.edu	.indiana.edu
nomzod	مرشح
Qonuniga	قانون
so&#39;ng	بعد
foydalana	استعمال
gapirish	حديث
ota-	في الأيام الخوالي
edi	كان
o&#39;yin,	لعبة
zumga	جبان
qutblari	ينتهي
doim&gt;	دائما وGT.
6-7	6-7
mablag&#39;lar	أموال
&quot;Konstantinov&quot;	على &amp; quot؛ كونستانتينوف ومثل؛
saqlanadi.	المحفوظة.
&quot;ko&#39;k	على &amp; quot؛ الأزرق
degandi	Pinturicchio
oralig&#39;ida	مجموعة
haqiqat	حقيقة
Radio	راديو
topganingizni	كنت قد
komplekson	بشرة
omili	عامل
izlari	آثار
keskin	مفاجئ
tug&#39;ilganidan	ولادة
saralash	التصفيات
Qonunning	القانون
aytaman.&quot;	أقول ومثل؛
muvofiq	بحسب
dushman	العدو
THEWITNESS	THEWITNESS
Quorum	نصاب قانوني
xushxabarni	والخبر السار
missiyalar	البعثات
POSTITION	POSTITION
chaqiradi	المكالمات
&lt;_Atheism	العلامة &amp; lt؛ _Atheism
yolg&#39;on.	كاذبة.
oyna)	نافذة)
albatta&gt;	وGT.
oqimlari,	التيارات،
waiiiiiit,	waiiiiiit
birodarlarga	الاخوة
Biroq,	ومع ذلك،
bag&#39;ishlangan&gt;&gt;	مكرسة &amp; GT؛ &amp; GT؛
Empedans	مقاومة
mumkin!	يمكنك!
atmosferasi,	الغلاف الجوي،
ob&#39;ektlar	الأجسام
bo&#39;lgani,	،
mumkin)	)
ayniqsa	خاصة
Shostack	Shostack
oqlashga	لتبرير
&lt;...	العلامة &amp; lt؛ ...
mumkin.	.
mumkin,	يمكنك
natijalari	نتائج
mumkin:	يمكنك:
orientatsiya	توجيه
Hughes	هيوز
Baqoevning	باكاييف
kosmik	الفضاء
(g&#39;arbdan	(الغربية
mumkin?	يمكنك؟
qo&#39;llaniladi)&gt;	استخداما) وGT.
294-8153	294-8153
Jonson	جونسون
muloqot	حوار
mumkin;	يمكنك؛
so&#39;ra	تطلب
Montes,	مونتيس
ma&#39;lumotlarni	معلومات
(900	(900
o&#39;lchash	قياس
ravishda	في
insonning	رجل
Uch	ثلاثة
kamar,	حزام،
erkaklarga	الرجال،
1200-1500	1200-1500
Ilohiy	المقدس
geb@cadre.dsl.pitt.edu&gt;	geb@cadre.dsl.pitt.edu&amp;gt.
Gomoseksualizm	المثلية
ko&#39;rmadim	لم أكن أرى
6:.	6:.
&quot;qattiq	على &amp; quot؛
tavba&gt;	محشوة &amp; GT؛
Dodson	دودسون
barpo.	المبنى.
VDC	VDC
McDONNELL	ماكدونيل
evropaliklarga	الأوروبيون
5X9	5X9
Windows,	النوافذ،
istisnolar	الإعفاء
o&#39;tdi	مقبوض
bo&#39;ronlari	العواصف
(orqaga)	(العودة)
Landers	اندرز
niqoblangan,	قناع،
shag&#39;al-o&#39;lchamli	من الحصى الحجم
kislota	حامض
Gary	غاري
tog&#39;orani	أحواض
bolalar	الأطفال
&quot;Foydalanuvchi&quot;	على &amp; quot؛ &amp; مثل؛
vax839@tid.es	html>
(Sanjeev	(سانجيف
radar-xaritalash	رادار رسم الخرائط
atom	ذرة
Bonds	قيود
qabul,	،
MLINDROOS@FINABO.ABO.FI	html>
qabul)	)
quruqliklar	أرض
VGA	VGA
&quot;Bizning	على &amp; quot؛ لدينا
640	640
maxsus	خاص
aniqlanadi	تحديد
oylar,	أشهر
bo&#39;lishi)	)
sirlaridan,	نقطة
armada	أسطول حربي
Graphics	الرسومات
hujjatlarni	الوثائق
inqilob	ثورة
eshak	حمار
Baptist	المعمد
Ichki	داخلي
yoritib.	إلقاء الضوء.
(JT)	(JT)
siz&gt;	وGT.
mukofot	جائزة
San-Xose,	سان خوسيه،
uçurumlar	المنحدرات
otash.	اللهب.
ko&#39;rinadi	يبدو
adolat	عدالة
doiralar	الدوائر
tun	ليل
Mercury,	الزئبق،
shifrlash	التشفير
yaxshi	خير
tovushlar,	يبدو،
to&#39;la.	كامل.
eshitsa.	يسمع.
gravity	خطورة
olindi	تم الاسترجاع
bo&#39;lmaydi.	هو ليس كذلك.
Marty	مارتي
makon	الفضاء
bo&#39;lmaydi,	ليس
Atkinson	أتكينسون
Voice:	صوت:
(JPL	(JPL
chizish&quot;	رسم ومثل؛
soğutulur	تبريد،
muddatli	الاجل
486DLC-33	486DLC 33
bo&#39;lmaydi:	لا:
sonlar	أرقام
kemalar	سفن
Brian,	بريان،
darajasida	مستوى
tuzatish	تصحيح
oylari	أشهر
chiroqlari	أضواء
VHS	VHS
mustasno),	ما عدا)
peer	النظير
bo&#39;lishi;	ليكون؛
oling,	تعلم
Houston	هيوستن
Round	جولة
noma&#39;lum	غير معروف
Apelsin	البرتقالي
650	650
oling.	.
bo&#39;lishi.	.
jihozlangan	مسلح
missiyasining	مهمة
bo&#39;lishi,	،
FBI	FBI
o&#39;tishingiz	سجل
umidsizlik	خيبة أمل
Zoologiya	علم الحيوان
lava	حمم
iyunda	حزيران
quibble-	quibble-
ko&#39;proq?	أكثر من ذلك؟
otib	لقطة
urf-odatlari	تقاليد
asosiy-haroratga	درجة الحرارة الرئيسية
bilamiz.	نحن نعرف ذلك.
bombardimon	قصف
boshidan	بداية
don	حبوب
serverlardan	خوادم
bo&#39;ladi	سوف
km@ky3b.pgh.pa.us	html>
oldi.	.
Axborot	إعلام
tegdi,	لمست،
Sanjeev	سانجيف
mamlakatlaridan	الدول
dos	دوس
bilamiz?	نحن نعرف؟
tojni	تاج
dünyadışı	خارج الأرض
qaytib,	مرة أخرى،
yuqumli	معد
nikel	النيكل
tashlaydi	رمي
pelting	بيلتون
hodisalarni	أحداث
&quot;ob&#39;ektiv&quot;	على &amp; quot؛ الهدف ومثل؛
mavjud»	متاح
rock,	الصخور،
(-366	(-366
dpi	نقطة في البوصة
Nunnally@acs.Harding.edu	html>
shogirdlari)	طلاب)
silkitib	التلويح
davr	فترة
kilogramm	كيلو
uchinchi	ثالث
American	أمريكي
ekranda	شاشة
windows	نوافذ
Ehtimol	ربما
statistik	إحصائي
Bading)	الفن)
bolalar&gt;	أطفال و GT.
ehtimol	ربما
Siemon)	Siemon)
bashoratlar	نبوءات
DoD	وزارة الدفاع
so&#39;raymiz	تطلب
unalterably	قاطع
temir	حديد
siyoh	حبر
kasallik,	مرض
tomonidan.	من قبل.
400dpi)	400dpi)
tomonidan,	بواسطة
Aksiga	حادث
to&#39;qqizinchi	تاسع
ingichka,	غرامة،
Logitech	لوجيتك
topish,	تجد
northeners	northeners
topish.	العثور عليها.
shartnoma	عقد
stantsiyalari	محطات
fazoda,	الفضاء
FAX;	FAX.
Luqo	لوقا
hokimiyatga	سلطان
maqsadida,	من أجل
LEKIN,	ولكن،
bilish	لمعرفة
somon	قش
kalitlari.	مفاتيح.
kanallar	القنوات
(Edmonton,	(إدمونتون،
ularni	منهم
spiral	حلزوني
blokirovku	تحطم
o&#39;tdi.	.
Bo&#39;yicha	في
xususiyatiga	مواصفات
(Dave	(ديف
yo&#39;qolgan	ضائع
Information	إعلام
yozuvlarni	تسجيل
tanitadi,	العقود،
yamaha	ياماها
auroras	الشفق
istamayman!	أنا لا أريد!
hisoblanadi&gt;&gt;	وGT؛ &amp; GT؛
Brenn)	العلامة التجارية)
geliy	الهيليوم
Tim	تيم
efirga	البث
Brenn,	برين
tayyorgarlik,	التحضيرات،
ishlatiladigan	وتستخدم
Anonim	مجهول
ma&#39;lumotga	معلومات
256k	256K
shohiddir	تشهد على
avvalgilaridan	سابق
qimirlagan	فضفاض
signallarining	إشارات
berib	إعطاء
bo&#39;lishni	أن تكون
optilink	optilink
ketsa,	إذا كان
newsdesk@jplpost.jpl.nasa.gov	html>
bulutlarni	الغيوم
taymerni	مؤقت
qiziy	توهج
yondashuv	نهج
&quot;ma&#39;lumotlar	على &amp; quot؛
&lt;1993Apr7.221357.12533@lamont.ldgo.columbia.edu&gt;	العلامة &amp; lt؛ 1993Apr7.221357.12533@lamont.ldgo.columbia.edu&amp;gt.
yozuvchilar	الكتاب
mavjud;	المتاحة؛
So&#39;z	كلمة
qiziq	مضحك
&quot;foydalanuvchi&quot;	على &amp; quot؛ &amp; مثل؛
o&#39;tdi;	عقدت؛
qizil	أحمر
sichqon	فأر
asta-sekin	خطوة خطوة
&quot;real&quot;	على &amp; quot؛ حقيقية ومثل؛
daralarda,	الوديان،
stephen@orchid.UCSC.EDU	html>
samimiy,	الحارة،
o&#39;tib	فيما بعد
(Dostoevskiy)	(دوستويفسكي)
cheklangan,	محدود
ochiq	فتح
yumshoq	ناعم
uyqu	نوم
xabardorligini	وعي
Yordamingiz	مساعدة
(ya&#39;ni	(أي
1.00)	1.00)
kaykay	التزلج
mitti;	قزم.
Bono,	بونو،
sohasida,	في هذا المجال،
faol,	نشط
Wanderers	واندررز
(salbiy	(سلبي
oldim	حصلت
oldik	تلقينا
&gt;&gt;&gt;	وطن؛ &amp; GT؛ &amp; GT؛
to&#39;liq	كامل
salbiy!	سلبية!
bayonotida	بيان
oldin	قبل
«Men	&#39;I
isbot	دليل
tug&#39;diradi.	يطرح.
tog	جبل
qanoti	جناح
dastlab	أصلا
-----------------	-----------------
psevdo-ta&#39;limotning	الزائفة المذهب
10:34	10:34
aylanadi	تم تحويله إلى
hisobotlarni	تقارير
tugatish	اكتمال
qilyapsiz,	فعل
turtki	دفعة
Cassini	كاسيني
charog&#39;on	أشعل
bag&#39;ishlanib	مخصص ل
Biz,	ونحن،
tom	سقف
kishisiga	الذي
beri,	ومنذ ذلك الحين،
maxfiylik&quot;,	الخصوصية ومثل،،
nuri	نوري
tor	ضيق
nereid	الناريدة واحدة من حوريات البحر
Erkak	رجل
fuqaroligini	المواطنة،
mavjud.	المتاحة.
ochko	نقطة
(Version	(النسخة
&gt;	وطن.
aloqasi	صلة
e&#39;tiborli	حسن السمعة
Savollar:	الأسئلة:
kimgadir	شخص ما
(Genri	(هنري
10&quot;	10 ومثل؛
Yuzasining	سطحي
eslang	تذكر
schauf@iastate.edu	html>
anti-ishonch	مكافحة الاحتكار
oylarda	أشهر
va&#39;dalar	وعود
Dunyo	عالم
bo&#39;luvchi	فواصل
Shunga	ومع ذلك،
bo&#39;lgani	غير
4/26/93	4/26/93
100K	100K
o&#39;ylayman	أعتقد
Explorer&gt;	المستكشف &amp; GT؛
&gt;&gt;&gt;&gt;	وطن؛ &amp; GT؛ &amp; GT؛ &amp; GT؛
Campus)	الحرم الجامعي)
Venusian	متعلق بكوكب الزهرة
Tom	سقف
etilmoqda.	الوجود.
Omad	حظ
mavjudligini	وجود
Lei)	لى)
Masih	يسوع المسيح
yolg&#39;on	كذبة
xavfli	خطير
taqqoslashlar?	مقارنات؟
2-ning	2
shaklda	شكل
100,	100
yashaydi,	السكن،
Oxirgi	مشاركة
tushirildi.	وضع.
1000	1000
Saqlash	الحفظ
bahslasha	للترافع
kitob,	الكتاب،
qavmiga	الناس
vositasi	أداة
der	دير
Alpha	ألفا
yoqtirmayman.	أنا لا أحب.
kolba	أنبوب
uyda	منزل
Menimcha,	في رأيي،
dale	واد بلغة الشعر
dan)	)
dan,	من
funksiyalarini	وظائف
Maslahat	نصيحة
bila	مسروق
&lt;31MAR199321091163@juliet.caltech.edu	html>
deb	أن
bo&#39;lgan)	)
kirdi	دخل
»klubi	&quot;نادي
bo&#39;lgan.	.
nikoh	زواج
&lt;p00261@psilink.com&gt;	العلامة &amp; lt؛ p00261@psilink.com&amp;gt.
bo&#39;lgan,	وهذا هو،
Luis	لويس
bo&#39;lmaydi»,	لا &#39;
quyi	أدنى
huquqini	حق
çökerttiğini	حطم
Deviants	المنحرفين
shaxsiy	الشخصية
XRaiseWindow	XRaiseWindow
7,3	7.3
tuyulardi.	يبدو.
orbitalarida	مدارات
bo&#39;lgan?	؟
e&#39;lonlar	إحصائيات
afzal.	التفضيلات.
yorliq	اختصارات
ushbu	هذا
gomoseksual	مثلي الجنس
USA	الولايات المتحدة الأمريكية
vakili.	ممثل.
Umid	أمل
vakili,	ممثل،
bermadi	لم أكن
11-15	15/11
ortda	خلف
Yamanda	يمني
Biri	واحدة من
ortiq	فائض
uxlab	نائم
isrof	الإسراف
to&#39;lov	دفع
ziddiyatli	متناقض
qishloq	قرية
esnetmeyi	امتداد
yulduzlar	النجوم
yaqinlashib,	تقترب
meteoritlar	الشهب
gilkey,	Gilkes،
Kometalar	المذنبات
Dr.	الدكتور
nikel-temir	النيكل والحديد
protey	بروتيوس
arzon	رخيص
bo&#39;lsa,	إذا
&quot;dual	على &amp; quot؛ مزدوج
&lt;belgilab	العلامة &amp; lt؛ تعريف
xohishi	موجه
LaStrange	LaStrange
bo&#39;lsa)	إذا)
yigit	شاب
////	////
default	الافتراضي
tez	بسرعة
sanab	ومشتقاته
henry@zoo.toronto.edu	html>
g&#39;azablangan	غاضب
turdi.	وقفت.
Lindroos	Lindroos
5-daqiqa	5 دقائق
jinoyatchi	مجرم
bo&#39;lsa?	لو؟
joule	جول وحدة طاقة
molekulalar	جزيئات
barcha&gt;	وGT.
3511,	3511
sochli&quot;	الشعر ومثل؛
DOS;	DOS؛
Fang	ناب
1024	1024
DOS6	DOS6
din	دين
WINDOWS;	WINDOWS.
an&#39;anaviy	تقليدي
qoladi	بقايا
dir	دير
Support	دعم
Huh?	هاه؟
Finney	فيني
bo&#39;lsa:	إذا:
withs	قرأ
nazariyotchi	باحث نظري ضليع
shaxsni	شخص
shaklga	شكل
asboblar	الأجهزة
qiluvchi&quot;	ومثل؛
(yuqori	(عالية
Meteoritlarning	النيازك
batareya	بطارية
Hui)	هوى)
mazmunli	هام
domen:	المجال:
Lucifer,	تركيز
masxara	سخرية
Keng	واسع
olmaydi	لا
kirib	دخل
mulozimlari	مسؤولون
natijasi	نتائج
biladi?	من يدري؟
haqiqiy	حقيقي
Dos	دوس
shug&#39;ullangan	تشارك
tayyor	استعداد
massasi	كتلة
biladi,	من يدري،
Kitob	كتاب
chandiq	ندب
dafn	مدفون
ekansiz?	إذا كنت؟
yillar,	سنوات
chiqamiz.	سنفعل.
olmaydi&gt;	لا &amp; GT؛
terisini	الجلد
to&#39;xtatish&gt;	وقف &amp; GT؛
qidiraman.	تبحث.
plastik	البلاستيك
Jon.	جون.
O&#39;shandan	ثم،
xabarlarni	رسائل
yillik	سنوي
muammoni	المشكلة
anglashuv	فهم
narsaga	ما
Iqtisodiy	اقتصادي
neccities	neccities
Meteoroid	نيزك
altimeter	الألتميتر
topgan;	العنصر.
o&#39;zimni	نفسي
OFF	OFF
&quot;Qayta-bildirdi?&quot;	على &amp; quot؛ تحميل على &amp; quot؛؟
Utility	فائدة
Uchinchi	ثالث
qurilish	إنشاءات
qog&#39;oz	ورقة
qo&#39;yishdi	وضع
topgan,	،
göktaşları	الشهب
Uch-Way	ثلاثي
topgan.	.
kotirovka	تداول
kishilar,	الناس
(ba&#39;zi	(بعض
Buffalo	جاموس
tadqiq	تحقيق
chog&#39;ida	خلال
trillion	تريليون
*************************	*************************
doirasida,	،
(Ron	(رون
Magazine	مجلة
[PED]	[PED]
biri,&gt;	وGT.
ta&#39;qib	اضطهاد
(Steve	(ستيف
Bloom,	ازهر،
Psevdo-o&#39;qituvchi	المعلمين الزائفة
chiqilgan	متطور
tong	فجر
hech	لا
shovqin.	الضوضاء.
(Tobias	(توبياس
bemorlar	المرضى
qaradim.	نظرت.
(Kirk	(كيرك
Yangi	جديد
aniq,	واضح
shuning	لذلك،
ajratilgan,	تخصيص
butun,	في كل شيء،
GOURMET	GOURMET
Yo&#39;q	لا
​​Lee	لي
rem	عيني
qarshi	ضد
TIFF,	TIFF
yozadi:&gt;	كتب: &amp; GT؛
o&#39;ndan	دزينة
-428-0800	-428-0800
KATALOG	فهرس
uzata.	في وقت واحد.
maqsadlarini	أهداف
(O&#39;ZMK)	(KJV)
John	جون
Spencer)	سبنسر)
kosmonavtlar	رواد الفضاء
dizayn]	تصميم]
e&#39;tiqod,	الدين،
Dave	ديف
o&#39;limdan	الموتى
sizga	أنت
yevropaliklardan	الأوروبيون
topa	للعثور على
janubida	جنوب
tirilmaydi,	على قيد الحياة،
xristianlar	المسيحيين
zilzila	زلزال
-486-9975	-486-9975
so&#39;rang.	نسأل.
takliflar	عروض
Ikkinchidan,	ثانيا،
e&#39;tiqod.	المعتقد.
OK,	حسنا
demadi?	ولم يقل؟
arablarni	العرب
boshqarmasi	قسم
cheklashlar	القيود
OK.	OK.
omili,	عامل
AMPS	الامبير
(Erkin	(أركين
jon,	الروح،
&quot;qiyin&quot;	على &amp; quot؛ الصعب ومثل؛
tizimining	نظام
kabi-*	kabi- *
texnikasi	معدات
harorat	درجة الحرارة
bo&#39;lib	كما
(Bro	(إخوانه
atrofidagi	حول
rind@enterprise.bih.harvard.edu	html>
Bure,&gt;	بوري &amp; GT؛
...&gt;&gt;&gt;	وطن؛ &amp; GT؛ &amp; GT؛
muhit	متوسط
qatlamlari	طبقات
Alan	آلان
foydalanish»,	&#39;
deyiladi.	دعا.
muhim	مهم
aksincha,	على العكس من ذلك،
o&#39;laroq&gt;	خلافا &amp; GT؛
o&#39;lchanadi.	قياس.
5X9&gt;&gt;	5X9 &amp; GT؛ &amp; GT؛
axir	ل
ergashdilar	يتبع
Hech	لا
as-issiq	كما الساخنة
Systems&gt;	نظم &amp; GT؛
New	جديد
&quot;^^^^^^»	على &amp; quot؛ ^^^^^^
oqilona	معقول
karta,&gt;	بطاقات &amp; GT؛
tugaydi	ينتهي
olmoq	أخذ
&quot;gomoseksual	على &amp; quot؛ مثليون جنسيا
keltirdik	جلبت
rad	رفض
manba	مصدر
&quot;aylanish	على &amp; quot؛ دورة
Switch	تحول
^^^^^^^^^^^^^^^^^^^^^^^^^^^	^^^^^^^^^^^^^^^^^^^^^^^^^^^
qanday	كيف
bo&#39;ldi:	:
qisman	جزئي
bo&#39;ldi;	؛
Leifson)	Leifson)
kelajakda	مستقبل
butunlay	تماما
Inson-Mürettebatlı	الإنسان ويتكون طاقمها
bo&#39;ldi.	.
yahudiy&gt;	اليهودية و GT.
tasdiqlangan	وافق
bo&#39;ldi,	،
Yo&#39;ldoshlar	زميل
xususiyatlarini	خصائص
iloji	ممكن
Kitobni	الكتاب
fakulteti	كلية
Odatda,	عادة،
keyingi	التالي
rom	مدمج
yulduzlardan	النجوم
berib,	إعطاء
eshik	باب
dominant	مهيمن
Dastgoh	ورشة عمل
Quyosh	شمس
yuzasida	على السطح
ifoda	التعبير
Will	سوف
raqamlari&gt;	أرقام وGT.
rol	دور
qoplangan&quot;	المغلفة ومثل؛
huzurida	وجود
WNCI	WNCI
qattiqqo&#39;l	قاس
tanga	عملة
​​quyosh	شمس
partiyalar	الأطراف
aralashtirmang	لا تخلط
(22,238	(22،23
yuzasiga	السطح
asarlar	الأعمال
dir.	دير.
demoqchimisiz?	رأيك؟
jarayonlar	العمليات
Yana	ثانية
Ovropada	الأوروبيون
SKIING	SKIING
shaxs	شخص
taqdim.	.
&lt;mvanheyn@cs.indiana.edu&gt;	العلامة &amp; lt؛ mvanheyn@cs.indiana.edu&amp;gt.
Whethe	سواء
Wizzard)	يزارد)
sizlarning	أنت
muvozanatga	توازن
o&#39;rgatadi,	يعلم،
Qaysi	التي
UNIX	UNIX
Joel	جويل
yillar	سنوات
&quot;sirlarini&quot;	على &amp; quot؛ سر ومثل؛
nagle@netcom.com	html>
Ground	أرض
disk	أسطوانة
boshlanish	بداية
Explorer	المستكشف
spirochetal	ملتوياتي
qurishga?&quot;	لبناء ومثل؛؟
NiCad	NiCad
bo&#39;lsa	إذا
Ottava,	أوتاوا،
namoyon	عرض
paketlar	حزم
Utopia	المدينة الفاضلة
quyida	أقل من
munosabati	بمناسبة
sizni	أنت
palastenians	palastenians
Venera	فينوس
ulysses.att..com	ulysses.att..com
Europa,	أوروبا
algoritm	خوارزمية
(Noqonuniy	(غير شرعي
&quot;SO&quot;	على &amp; quot؛ &amp; SO مثل؛
Frantsiya	فرنسا
qoplangan	مغطى
bolgan	الحقول
90%&quot;	90٪ &amp; مثل؛
&lt;1qkoel$5fr@horus.ap.mchp.sni.de&gt;	العلامة &amp; lt؛ 1qkoel$5fr@horus.ap.mchp.sni.de&amp;gt.
isbotidir?	هو الدليل؟
Columbia,	كولومبيا،
***************	***************
nazorat	تحقق
kirib,	دخل
qismi)	جزء)
avvalgi	سابق
yozadi&gt;:	يكتب &amp; GT؛:
yoqilganda	تحول يوم
savolim:	الأسئلة:
qismi,	جزء
&quot;Yer-Moon	على &amp; quot؛ والأرض والقمر
ezib	سحق
ekran	شاشة
ko&#39;rinadigan	مرئي
qozonmoqda.	كسب.
&quot;Yangi	على &amp; quot؛
&quot;oldin&gt;	على &amp; quot؛ &amp; GT؛
hamkasblari	الزملاء
o&#39;tish,	،
o&#39;rnatilgan	تثبيت
qondiradi	يرضى
adapter	محول
omon.	البقاء على قيد الحياة.
fanlari	العلوم
1980,	1980
-rigth	-rigth
mashhur	مشهور
Bzzt!	Bzzt!
huquqi	حق
taqdir!	مصير!
Timmons)	تيمونس)
Timmons,	تيمونس
Visual	مرئي
derlar;	يقولون؛
istamayman.	أنا لا أريد.
5-11,	11/05،
istamayman,	أنا لا أريد
quyidagi	التالي
Stiven	ستيفن
dumlari	ذيول
hrubin@pop.stat.purdue.edu	html>
etarli	كاف
Ko&#39;p	كثير
hislar	الحواس
Salah)	صلاح)
tamoyillari	مبادئ
arenasi	حلبة
Yaponiya	اليابان
suratga.	الكاميرا.
(Leong	(يونغ
martyj@mrcnext.cso.uiuc.edu	html>
sistemasidagi	نظام
chiqilgan.	.
jamoatini	الكنيسة
konusning.	المخاريط.
o&#39;tishi	للذهاب
o&#39;g&#39;illari	أبناء
&lt;1qnb9tINN7ff@rave.larc.nasa.gov&gt;	العلامة &amp; lt؛ 1qnb9tINN7ff@rave.larc.nasa.gov&amp;gt.
masalalari	قضايا
accuire	accuire
ergonomik	مريح
Yanvar	يناير
97,9	97.9
GSX-145	GSX-145
ozor	آذى
minglab	الآلاف
Kuzatuvlar	الملاحظات
qonuniy	قانوني
okeanlar,	المحيطات،
COM1	COM1
Otamning	والدي
policha	شرطة
vulkanlar	بركاني
bayonotlar	البيانات
sentyabr,	أيلول
markazi,	مركز
Bugungi	اليوم
maqsadida&gt;	وGT.
ozod	حر
yordam?&quot;	؟ ومثل؛
&quot;|	على &amp; quot؛ |
portlashlari	انفجارات
RESP.	RESP.
Mives	Mives
Control	سيطرة
erlar	الأزواج
savdo	تجارة
cfaehl@vesta.unm.edu	html>
ishora	تلميح
AQSh&quot;	US &amp; مثل؛
holatda	حالة
shohi;	الملك.
g&#39;oyalar	أفكار
Enteritis	بادئة معناها معي
markaziy	مركزي
brian@gab.unt.edu	html>
sotuvga	للبيع
joyi	مكان
vodiylari	الوديان
gullab-yashnagan.	الازدهار.
Canucks	كنوكس
(Sam	(سام
hujjatlarida	الوثائق
birikish	مجموعة
Anakart	اللوحة الأم
yashayotgan	المعيشة
xalqaro	دولي
ajrata	للتمييز
sevib	أحب
Livermore,	ليفرمور،
&lt;ateizm	العلامة &amp; lt؛ الإلحاد
Redelfs)	Redelfs)
nstassen@magnus.acs.ohio-state.edu	html>
vitr	لتسليط الضوء على
eshitishni	للاستماع
yugurib	ركض
xudosi.	الله.
barkamol	وئام
buyurish	افترض عليهم
ergashdilar.	تلت ذلك.
xudosi;	الله؛
&quot;	على &amp; quot؛
irodasini	إرادة
uchastkalar	الكثير
undan	له
funktsiya	وظيفة
sun4nl	sun4nl
qurilgan.	بنيت.
okeanlarning	المحيطات
qurilgan,	بنيت،
qadriyatlar	القيم
yashirin	سرا
oqsoqollar,	شيوخ،
umumiy&gt;	عام &amp; gt؛
imputs	ألصق به تهمة ما
TARIX:	HISTORY:
tasdiq	موافقة
sevgi	حب
Electronics	الإلكترونيات
yondirib	حرق
etaklaydigan	شحنة
fikrini	فكرة
ko&#39;rmayapman,	رؤية
ko&#39;rmayapman.	لا أستطيع أن أرى.
o&#39;ldirilishi,	القتل،
Ushbu&gt;	هذا وGT.
Powered	تعمل بالطاقة
bo&#39;yalgan	رسمت
faolligini	نشاط
Kitobda	الكتاب المقدس
mamlakatni	البلد
(yoki	(أو
ta&#39;minlash&gt;	وGT.
Astronomiya	علم الفلك
sotuvda	للبيع
chip	رقاقة
gunohlari	الخطايا،
qaynaydi,	دمل
kraterlardan	krater
tez-harakat	العمل السريع
keltirganlar,	أولئك الذين
ilon,	ثعبان،
==========	==========
(Carl	(كارل
(DES	(DES
&quot;edi	على &amp; quot؛
qonuni,	القانون،
fotoelektr	كهرضوئي كهربائي ضوئي
OLDIN	قبل
Wagner,	واغنر،
o&#39;rgatgan	تدرس
Plains&quot;)	السهول ومثل؛)
Coons)	الراكون)
befarq	غير مبال
maqolada	مقالة
17-asrda,	في القرن ال17،
ekan	أن
-Karl&gt;	كارس &amp; GT؛
zanjirlar,	سلاسل،
sizning	ك
qa&#39;riga	أعماق
(ncsc8!	(Ncsc8!
Optik	بصري
ob&#39;ekt,	وجوه،
fang@en.ecn.purdue.edu	html>
bokiralik,	العذرية،
&quot;bizning	على &amp; quot؛ لدينا
Sharma	شارما
(Yaponiya	(اليابان
tiriladi.	الارتفاع.
yutib	وون
kutadi	ينتظر
mavjudmi?	هل هناك أي؟
paydo	يبدو
arziydi	قيمة
bezatish	زخرفة
doira.	شقة.
foydalanuvchi	المستخدم
qo&#39;shnilar	الجيران
ish-of--tegirmon&gt;	عمل طاحونة &amp; GT؛
&quot;Klaviatura	على &amp; quot؛ مفتاح
fitna]	المؤامرة]
hujjatlar	الوثائق
tadqiqotlar	بحث
pallasida	الدائرة،
tosh	حجر
izohlash.	شرح.
Xudosi	إله
spec&#39;d	spec&#39;d
pimi	دبوس
kutib&gt;	تلبية &amp; GT؛
narsani	كل شىء
yashashi	سكن
yoyib	انتشرت
kamera	كاميرا
biseksual	المخنثين
comp.sys.ibm.pc.hardware:	comp.sys.ibm.pc.hardware:
line	خط
o&#39;yin,&gt;&gt;	وGT؛ &amp; GT؛
istaganini	يريد
ijodimiz,	خلاقة،
turgan	مكانة
aloqada	اتصال
Bizning	لنا
najot	حفظ
yil,	عام
negadir&gt;	والسبب وGT.
pro-kun	الموالية للبندقية
(Bryan	(بريان
HAWK	HAWK
tibbiyot	دواء
(Kevin	(كيفن
ota-deb	الآباء
minnatdorchilik	شكر
SCSI	SCSI
talabalar,	الطلاب،
bo&#39;ldi	كان
dizayni	تصميم
xohlaysizmi?	هل ترغب في ذلك؟
Xaloskorimiz	المخلص
Darryl	داريل
oshkor	إفشاء
nomidan&gt;	نيابة عن وGT.
shifokorlarga	الأطباء
tirildi	قام من
qobig&#39;i	قذيفة
qurilmaning	الجهاز
Karlos	كارلوس
shifokorlari,	الأطباء
viloyatlariga	المناطق
yili	عام
siyanür	السيانيد،
o&#39;rgatadi.&quot;	يعلم ومثل؛
biroz	قليلا
&lt;&lt;	العلامة &amp; lt؛ العلامة &amp; lt؛
===	===
to&#39;qnashuvning	اصطدام
birov	شخص ما
Thomas	توماس
lyme	لايم
parvo&quot;	والعقل مثل؛
etnik	عرقي
qaytdi.	عاد.
biror	ل
RS-6903	RS-6903
Cheers	هتاف
GENIE:	GENIE:
yo&#39;llar	الطرق
tarjima	ترجمة
joy,	مكان
82%,	82٪
Potvin,	Potvin
Gosh..I	Gosh..I
J.David.W.Reeves@dartmouth.edu	html>
teleskop	تلسكوب
buzuq	فاسد
Pioneer	رائد
aep@world.std.com	html>
HAVO	AIR
buyuriladi.	وصفه.
o&#39;rganib	درس
(1430	(1430
Ranger,	الجوال
hodisadan	حادث
zaxiradan	مقعد
Kanadaliklar	كندا
&quot;eng	على &amp; quot؛
agnostik	الملحدون
«a»	&#39;A&#39;
Bentz	بنتز
odam	رجل
tekisliklarni	السهول
chop	نشرت
tafsir	التفسير
&lt;	العلامة &amp; lt؛
kuzatildi.	لوحظ.
bo&#39;lak	جزء
natonal	حلف شمال الاطلسي
toza	نظيف
Suzuki	سوزوكي
qoidani	حكم
Spencer	سبنسر
bo&#39;lar	أراد
Takliflar	عروض
keltirur.	جلب.
qo&#39;llab-quvvatlanadigan,	أيد
Planitia	بلانيتيا
qo&#39;llab-quvvatlanadigan)	أيد)
ijro	تنفيذي
chegaralarini	حدود
yetganida,	عندما،
!!&quot;	!! على &amp; quot؛
Nor	ولا
narsalar	أشياء
oshiradi&quot;&gt;	ومثل؛ &amp; GT؛
savol	سؤال
Winslow,	وينسلو
qaynatiladi,	يغلي،
16804	16804
Yaxshi	خير
tanasini	الجسم
Perfect	مثالي
xilvat	مهجور
AMPS,	الامبير
tasvirlangan.	وصفه.
​​Venusian	متعلق بكوكب الزهرة
foizini	في المئة
(JPS)	(JPS)
qanday,	كيف،
topgan	تتكون من
QOYIL!	نجاح باهر!
g&#39;oya	تصور
sinash	محاولة
monitoring	مراقبة
uchastkalar!	الكثير!
qoplangan.	مغطاة.
jamoatchilik	الجمهور
_in	_in
chiqindilarini	نفاية
boshqaruvidan:	الإدارة:
qiyinchilik	صعوبة
Of,	من
bo&#39;linish	تقسيم
jihatlari	الجوانب
siz	أنت
(______________________________________)	(______________________________________)
Tog&#39;-qizlar	التعدين والفتيات
meros	تراث
yozda,	في فصل الصيف،
bo&#39;lganlarga,	الذي
ayollar	نساء
PIN	PIN
ustida	خلال
10/82	10/82
platosining	هضبة
qilish&gt;,	وGT،،
tuproqdan	الغبار،
qaradi	وقال انه يتطلع في
ajratadigan	تميز
Uran,	اليورانيوم،
ko&#39;rsatdi	أظهر
narsa&gt;	وGT.
Dalillar	حقائق
ekdfc@ttacs1.ttu.edu	html>
shu	هذا
Kitob-sevishganlar	عشاق الكتب
(10000	(10،000
sir	سر
havzalari	أحواض
mamlakatlari	الدول
madaniyat	ثقافة
4Runner&gt;	4RUNNER &amp; GT؛
Oh,	أوه،
yechishga	لحل
mashina	آلة
kechishlari-uni:	الليلة:
qodir	قادر
undamayaptimikin&gt;	هل وGT.
chuqur	عميق
yo&#39;ldoshlari	أقمار
Endi,	الآن،
yoriqlar	الشقوق
yo&#39;qotgan.	خسر.
Angliya	إنجلترا
Telefon:	الهاتف:
Callisto	كاليستو
ligada	عصبة
payini	رفت
tutayotgan	في اشارة الى
Space	الفضاء
6/91	6/91
guruh	مجموعة
Canada,	كندا
Yaman	يمني
ustiga	على
(yahudiylar)	(اليهود)
nasroniylik,	المسيحية،
yer-oy-quyosh	الأرض مون سون
00ECGILLESPIE	00ECGILLESPIE
aqidaparastlar	المتعصبون
yaproqlar	أوراق
bilurlar.	أعرف.
-14	-14
dunyodagi	العالم
keltirgani&quot;.	الأشرطة ومثل؛
diqqat	اهتمام
sinov,	اختبار
Scharfy)	Scharfy)
shamoli	رياح
sex	جنس
barcha	كل
eshitamiz.	نسمع.
lezbiyen	مثليه
Barcha&gt;	وطن.
2230	2230
taqlid	تقليد
PMS	PMS
ko&#39;rsatildi	أظهرت
qoyalar	الصخور
&quot;litsenziyaga	على &amp; quot؛ المرخصة
Services	الخدمات
qaynatiladi	دمل
ko&#39;rmadim.	لم أكن أرى.
(o&#39;ng	(الحق
buyon&gt;	وGT.
(Computer	(الكمبيوتر
kripto	التشفير
ko&#39;rmadim,	لم أكن أرى،
uzoq-uloqtirdi	ورمى به في الطويلة
Franjione	Franjione
HOMOSEXUAL-	HOMOSEXUAL-
«dalillar»	&#39;حقائق&#39;
Kaufman)	كوفمان)
Telecope	Telecope
birga	معا
&quot;qabul&quot;	على &amp; quot؛ &amp; مثل؛
me&#39;yor	من حيث المبدأ،
necha,	قليل،
surilsa,	عزو
Edwin	إدوين
nima&gt;	ما وGT.
sen	أنت
sel	فيضان
butun	ككل
rangdagi	الألوان
chiziq	خط
to&#39;qnashib.	اصطدم.
milya),	ميلا في الساعة)
ekanligini,	أن
bo&#39;lmaganda	على الأقل
agar	إذا
shaxslarni	الأشخاص
shama,	ضمنية،
àmì	AMI
chet	أجنبي
shishgan,	منتفخة،
qamoqda	السجن
Ludwick&quot;	Ludwick ومثل؛
ildizi	جذور
jamoa&gt;	مجوهرات و GT.
nimadir	شيء
qiling&quot;	ومثل؛
Kentukki	كنتاكي
masihiylar	المسيحيين
bilimga	معرفة
(Andrew	(أندرو
shama;	ضمنية.
(3,010	(3010
Dual	مزدوج
(-184	(-184
fotosel	ضوئية
amino	الأمينية
hosil	حصاد
qaerda)	أين)
sol	نظرة
Deb&gt;	وطن.
dalil,	دليل
joyida	مكان
to&#39;lanadigan	المستحقة
xronologik	مرتب زمنيا
tekisligiga	طائرة
litsenziya	ترخيص
Klark	كلارك
---	---
sof	نقي
foydalaning	استعمال
aytish	قول
Ryan	ريان
kishilar	الناس
qaerda,	حيث
(&quot;Oltin	(على &amp; quot؛ الذهب
Hoffman	هوفمان
themon	موضوع
menimcha	أعتقد
sex)	الجنس)
korean,	كوري
qilgan.	.
qilgan,	،
bo&#39;yicha&gt;	وGT.
Ikki	اثنان
majbur&gt;	الأساسية وGT.
Xarid	التسوق
Selsiy	مئوية
qilgan;	؛
Santa	سانتا
Hajmi:	الحجم:
tushunishga	لفهم
qo&#39;llanmalar	كتيبات
botganidan	غروب
&quot;Lyme	على &amp; quot؛ لايم
Stanza	مقطع شعري
jinoiy	مجرم
axloq	سلوك
êonuniyligi	شرعية
tijorat	تجاري
o&#39;rganish,	الدراسة،
a&gt;	و&amp; GT؛
Daraja	مستوى
ligini.	الملون.
bemorlarning	المرضى
chiqaradi	تنتج
mish-mishlarni	الشائعات
Multiprobe	Multiprobe
--clh]	--clh]
chap	اليسار
&lt;C5r60r	العلامة &amp; lt؛ C5r60r
MAQOMOTI&gt;	COM &amp; GT؛
___	___
mish-mishlarga	الشائعات
dasturlar	تطبيقات
o&#39;zingizni	نفسك
harakatini	حركة
qilmaydi.	لم يحدث ذلك.
qilmaydi,	لم يحدث ذلك،
muqobil,	بدلا من ذلك،
Xalqaro	دولي
1993,	1993
qatorda	فضلا عن
floppi	القرص المرن
bevaqt	سابق لأوانه
Ligasi-da,	الدوري،
Stars&quot;	نجوم ومثل؛
Altimas	ألتيما
hujjatlariga	الأعمال
bering.	على النحو التالي.
Candida	المبيضات
Thanks	شكر
bering,	قرأ
Theos	ثيوس
hammangiz	كل
zaryadlash	الشحن
&quot;Ular&quot;	على &amp; quot؛ &amp; مثل؛
cryptoanalysis	cryptoanalysis
&quot;Geiger	على &amp; quot؛ جيجر
tizimidagi	نظام
ko&#39;rsatilib	إشارة
Corp.	شركة
supurib,	تمشيط
ligalari	الحزب الديمقراطي الياباني
bering!	قراءة!
adam@das.harvard.edu	html>
radioed	ويندي
William	وليام
qiziquvchan.	الغريب.
pishirib	اضطرب
Motherboard	اللوحة الأم
Yupiterning	كوكب المشتري
muammolar	قضايا
Lauria)	لوريا)
real	حقيقي
bir-biriga	واحدة-
qotib	التحديق
dalil:	المبررات:
kuzatib	راقب
egalik	حيازة
articals	عناوين مختارة
ayting	الموقع
daviss@sweetpea.jsc.nasa.gov	html>
qilinib,	و
ko&#39;rsatib	عرض
foydalanish	استخدام
kelgan	من
nozil	كشف
19947	19947
nozik	حساس
forsale	FORSALE
Altima,	ألتيما
Biroq	رغم أن
cho&#39;mish&gt;	معمودية &amp; GT؛
^^^^^	^^^^^
Jorjtaun,	جورج تاون،
ko&#39;lamli	-scale
Kontrollerlar	وحدات التحكم
paketlar&quot;	حزم ومثل؛
Gen3:	Gen3:
&#39;s	&#39;S
PCX	PCX
shifokorlar,	الأطباء
nomlari	أسماء
(havo)	(الهواء)
jamoalar,	فرق
Floppy..BURN	Floppy..BURN
hayron.	فاجأ.
xotirlash	قداس
kafolat	ضمان
ekvator	خط الاستواء
xohlagan	الوصايا
isolator&quot;	المعزل ومثل؛
Out	خارج
yaxshiroqdir	أفضل
oshiriladi&gt;&gt;	وGT؛ &amp; GT؛
There	هناك
yakunlandi.	الانتهاء.
o&#39;tirib	الجلوس
strawman	قش
27611@athos.rutgers.edu,	27611@athos.rutgers.edu
halok	قتل
Dunyodagi	العالم
96,5	96.5
folta@zen.holonet.net	html>
Kolorado	كولورادو
masala»	قضية
Skelton	سكيلتون
oyoq	ساق
hamkorlikdagi	المفصل
olishingiz	تلقي
jamoalari	فرق
-oOOO	-oOOO
astein@nysernet.org	html>
shug&#39;ullanish	صفقة
loyiq,	مستحق
etishmasligi	عدم وجود
KUKUNI	POWDER
qildi,	،
qildi.	.
xudo	الله
^^^^^^^^^^^^^^^^^^^^^^^^^^^^^^^^^^^^^^^^^^^^^	^^^^^^^^^^^^^^^^^^^^^^^^^^^^^^^^^^^^^^^^^^^^^
tirilishiga	القيامة
O&#39;g&#39;li	ابن
tomoniga	جانب
narsalardan	أشياء
sharma@monet.vill.edu	html>
dağınıklığı	فوضى
Kolodny	Kolodny
(Dick	(ديك
halqa	عصابة
jalilalik	الجليل
BMP,	BMP،
sguerke@ravel.udel.edu	html>
ko&#39;rsatuv	الافتراضي
oyna	مرآة
tuzatilgan	تصحيح
OTOH,	OTOH،
Oliveira	أوليفيرا
nomidan	نيابة عن
chuqurliklarda	المجوفة
aylantirilayotgan	تحول
GMT,	GMT
kfrank@magnus.acs.ohio-state.edu	html>
terma	فريق
ekspeditsiyalar	البعثات
orasida	بين
buyon	منذ
9600	9600
hayotda	حياة
termo	الحرارية
savol,	السؤال،
avtomatlashtirilgan	الآلي
tekshirish	تفتيش
xabarni	رسالة
hisobiga,	نفقة
hans@xelion.nl	html>
xarakterli	صفة مميزة
qo&#39;llab-quvvatlash	دعم
boshqa,	البعض
Fallout	تداعيات
Foydalanuvchi	المستخدم
hoshiyali	حواف
qildim	لدي
holatini,	الشرط،
yotoqxona	حجرة النوم
kimsadan	الذي
tarixini	تاريخ
SMARTDRV	SMARTDRV
Williams,	وليامز،
yumshoq-og&#39;zaki	لينة الكلام
O&#39;g&#39;il	ابن
dengiz	بحر
tomonida	جانب
kategoriyalari	الفئات
odati	تقليد
ma&#39;noni	الوسائل
soniya	في المرتبة الثانية
masala:	المشكلة:
Jinnimisiz_?	Jinnimisiz_؟
&quot;maqsad	على &amp; quot؛ الهدف
harbiy	عسكري
&quot;dalil-manifatura&quot;	على &amp; quot؛ إثبات الرسائل النصية ومثل؛
sud	محكمة
ligasi	الدوري
orasiga	بين
reja	خطة
Frank)	فرانك)
Accelerator	مسرع
suv	ماء
o&#39;tgan	الماضي
Ishlatilgan	تستخدم
turdagi	نوع من
Accord	اتفاق
dastlabki	أول
kuch	قوة
mantiqiy	منطقي
maqsadida	من أجل
holsend@mhd.moorhead.msus.edu	html>
belgilang	تعريف
yasalgan	مصنوع
osmon.	السماء.
g&#39;alabaga	فوز
cyphers	كيبهيرس
(Robert	(روبرت
shahodat&quot;,	ومثل؛، الشاهد
dookie	dookie
almashish	مشاركة
ketkazguvchi	خداع
oshirmoq,	،
kimning	الذي
FORSALE	FORSALE
hokazo,	الخ،
Callisto,	كاليستو
Kaldis,	KALDILDI
ketmaslik	مغادرة
bo&#39;limida	قسم
Press-demokrat,	الصحافة الديمقراطي
Javob	إجابة
urdi	ضرب
hokazo)	الخ)
grafigini	جدول
maqolada,	مقالة
buyuk	عظيم
yo&#39;ldosh,	الأقمار الصناعية،
Slot	فتحة
o&#39;zgarishi	تغيير
===========================================	===========================================
WP51	WP51
bordingizlar?	هل؟
shamol	رياح
fırlatıcısı	netters
tirilishini	القيامة
oyga	القمر
&lt;1993Apr22.153959.12328@ucsu.Colorado.EDU&gt;	العلامة &amp; lt؛ 1993Apr22.153959.12328@ucsu.Colorado.EDU&amp;gt.
sendan	اليك
10000	10000
topilmadi.	تم العثور عليها.
o&#39;zgartirilgan	تغيير
(125	(125
ma&#39;nosi	معنى
bolta	الفأس
tan	المعترف بها
aytaylik).	على سبيل المثال).
qadar)	)
(JPL)	(JPL)
Darn	الرتق
qadar,	لذلك،
Dark	ظلام
(1500	(1500
soxta	خيالي
engil	ضوء
tozalash	تنظيف
Masalan	على سبيل المثال،
xulq	سلوك
yaratgan	خلق
Avvalgilar	السابق
osmonlaru	السماوات
shuningdek	أيضا
Ona	أم
Lawrence	لورانس
faqat&gt;	وGT.
One	واحد
bepul	حر
bilmayman,	أنا لا أعرف،
bilmayman.	لا أعرف.
uzatdi	الوفاض
oila	عائلة
bilmoqchi	لمعرفة
demokratik	ديمقراطي
kemaning	ظهر السفينة
megatest.com&gt;	megatest.com &amp; GT؛
qarang	رؤية
hujum	هجوم
sug&#39;urta.	التأمين.
o&#39;sayotgan	متزايد
&lt;C5DxBs.5ov@panix.com&gt;	العلامة &amp; lt؛ C5DxBs.5ov@panix.com&amp;gt.
****	****
(12v	(12V
oxir-oqibat	أخيرا
Kimdir	شخص ما
liscenced	liscenced
&lt;1r9j33$4g8@hsdndev.harvard.edu&gt;	العلامة &amp; lt؛ 1r9j33$4g8@hsdndev.harvard.edu&amp;gt.
PS:	PS:
berish	أجرة
amaliyotchilar	الممارسين
prob,	لجنة التحقيق
shtati	دولة
dunyo	عالم
tranzistor?	الترانزستور؟
olmaydi,	ليس
qarash	نظرة
to&#39;satdan	فجأة
Psevdo	زائف
kriptografiya	التشفير
(175	(175
NUNNALLY@acs.harding.edu	html>
[...	[...
qattiq	صلب
foydalanib.	استخدام.
Hozircha,	وفي الوقت نفسه،
yuritadigan.	الزوايا.
kimdir	شخص ما
psyrobtw@ubvms.cc.buffalo.edu	html>
foydalanib,	باستخدام
ko&#39;rinishini	مظهر
aytib,	وقال،
(RvKampen)	(RvKampen)
!!!!	!!!!
olmaydi.	لا.
eshitmadim	لم أسمع
window	نافذة
shtatining,	دايتون،
Phil	فيل
insonlar	الناس
chaqnash	اشتعال
natijasida	ونتيجة ل
kombinatsiyalangan	جنبا إلى جنب
maqsadini	الغرض من
....&gt;&gt;&gt;&gt;	... وطن؛ &amp; GT؛ &amp; GT؛ &amp; GT؛
kamdan-kam	نادر
diskda	أسطوانة
nomlanadi	يشار إلى
U&gt;	U &amp; GT؛
Dana	دانا
banschbach@vms.ocom.okstate.edu	html>
Willis)	ويليس)
drayverini	سائق
kundan	أيام
Amerikaliklar:	الأميركيون:
oktyabr,	أكتوبر
PTO	PTO
sohada,	المنطقة
nomuvofiqlik	التناقض
yirik	كبير
mantiqan	منطقيا
aytilganidek,	كما ذكر،
(Tim	(تيم
(Plutondan	(بلوتو
markazi	مركز
hiylalari	بالتآمر
^^^^^^^^^^^^^^^^^^&gt;	^^^^^^^^^^^^^^^^^^ وطن.
tarixida	في التاريخ
hajmini	حجم
qiziqish	اهتمام
anhuma	anhumâ
Keling,	الآن،
yotipti,	هذا،
serverlarida	خوادم
masihiylar&gt;	كريستيان &amp; GT؛
azot	نتروجين
fosfor)	الفوسفور)
ehtiyotkor	الحذر
o&#39;rnatish,	التثبيت،
yotipti!	هذا كل شيء!
14-19?	14-19؟
radar,	رادار
View,	رأي
ko&#39;rmayapman	أنا لا أرى
azob	عذاب
&quot;yuzasida	على &amp; quot؛ سطح
yotipti)	هذا هو)
oyat	علامات
Point	نقطة
Mana,	هنا،
foiz	اهتمام
gunohlarimiz	الخطايا
toml@boulder.parcplace.com	html>
kenyee	kenyee
sharqqa	شرقي
biz	نحن
bit	قطعة
sichqonchani	الفئران
20-39	20-39
bir	واحد
markerni	المؤشر
qo&#39;yilmaydigan	الاستثمارات
(gregh@niagara.dcrt.nih.gov)	(Gregh@niagara.dcrt.nih.gov)
himoya.	الحماية.
himoya,	حماية
9.256	9.25
....	....
ta&#39;riflarni	تعريف
qiladimi?	أليس كذلك؟
namunalari	عينات
qilingan&gt;	وGT.
exeption	اكسيبشن
orbitasida	مدار
...:	...:
intervyusida	مقابلة
Munns)	مونار)
(39.95)	(39.95)
tayyorlaydi.	يستعد.
...?	...؟
Teleradiokompaniyasi	التلفزيون والراديو
uning&gt;	وGT.
qoldi,	،
keyinchalik	فيما بعد
ostida&gt;	وGT.
qoldi.	.
zarralar	الجسيمات
(Tom	(توم
(Assalamu)	(س س)
Italiya	إيطاليا
boshqalarga	آخرون
sozlanishi	قابل للتعديل
Xavotir	قلق
ketishiga	اذهب
shohiddir:	الشاهد:
hislarni	التصورات
uslubi	أسلوب
Fikr?	تعليقات؟
axloqiy	أخلاقي
yaxshiroq&gt;	أفضل &amp; GT؛
Bormon)	بارمان)
kurs	سعر الصرف
urib	دوفر
Allen	ألين
Goolsbey)	Goolsbey)
Tampa,	تامبا،
gradus	درجة
bob	باب
Shaxsiy	الشخصية
(486-33DX	(486-33DX
oqimlari	تدفقات
-Arlo	-Arlo
Florida	فلوريدا
yangilar	المبتدئين
Avtomobil	سيارة
qiziqtiradigan	مهتم في
oqlanadi&gt;	مبررة &amp; GT؛
Ajablanarli	الدهشة
(no	(لا يوجد
rasman	رسميا
velosiped	دراجة
(1100	(1100
tanilgan.	المعروفة.
balki	ربما
sog&#39;lig&#39;ini	الصحة
zarrachalar	الجسيمات
klassik	كلاسيكي
tayyorlangan	أعدت
kesh	مخبأ
QUACK	QUACK
...)	...)
texnik	تقني
Jozef	جوزيف
orqa-eshik	الخلفي الباب
muhandislik	الهندسة
Yerdagi	الأرض
izchil	متوالي
zarar)	الضرر)
og&#39;ir	ثقيل
yoqib,	حرق
Ikkinchi	في المرتبة الثانية
Cuesta)	كويستا)
kimyo	كيمياء
(Frank	(فرانك
&lt;C4vG3F.Kx3@apollo.hp.com&gt;	العلامة &amp; lt؛ C4vG3F.Kx3@apollo.hp.com&amp;gt.
narsadir.	الشيء.
Avvalroq	في وقت سابق،
kuchlanish	الجهد
mehribon	محب
Deimos	ديموس
qiladigan	أن
qamchilash	كارثة
Cypher	سايفر
ta&#39;minoti	العرض
&quot;non-turli&quot;	على &amp; quot؛ غير مختلفة ومثل؛
&lt;93095@hydra.gatech.EDU&gt;	العلامة &amp; lt؛ 93095@hydra.gatech.EDU&amp;gt.
Xiroki	هيروكي
bo&#39;lsa-da,	وعلى الرغم من
chaqmoq	صاعقة
bo&#39;lsa-da.	بالرغم من ذلك.
bitimlar	اتفاقيات
olaman.	أستطيع.
heteroseksüel,	الغيرية،
Jalb	جذب
caldwell8102@mtroyal.ab.ca:	html>
bor	يوجد
whitsebd@nextwork.rose-hulman.edu	html>
HITEN	هايت
boy	غني
Rauser@sfu.ca	html>
talip	talip
murvat	برغي
yoqing	منعطف
masofada	المسافة
shokolad	شوكولاتة
burchakda	زاوية
4Runner	4RUNNER
hozirda	الآن
suratini	سرعة
chip-majmui	رقاقة مجموعة
ma&#39;noda	إحساس
transformatorlar	محولات
(bu	(هذا
bergan	معطى
keng	واسع
Delaver	ديلاوير
Sayyora	كوكب
&lt;1993Apr21.032427.22464@leland.Stanford.EDU&gt;	العلامة &amp; lt؛ 1993Apr21.032427.22464@leland.Stanford.EDU&amp;gt.
ishg&#39;ol	الاحتلال
masihiylarni	المسيحيين
yozishni	كتابة
kechqurun	مساء
computergenerated	computergenerated
kun)	اليوم)
Sayyoramiz	الكوكب
Ijaraga	تأجير
_your_	_your_
&quot;Robert	على &amp; quot؛ روبرت
o&#39;xshaydi.	مثل.
begunoh	برئ
Bunga	هو
bo&#39;laklari	القطع
Davolash	شفاء
tashvish	قلق
toplar.	قمم.
geologiya	جيولوجيا
chiroqlar	أضواء
foydalanish.	.
ma&#39;noga	معنى
(bentz.e.puryear)	(Bentz.e.puryear)
iymon	نحن نؤمن
&quot;bajo&quot;	على &amp; quot؛ &amp; مثل الوفاء بها؛
uchadi.	أن يطير.
(Portable):	(المحمولة):
Pay	وتر
miqdorda	كمية
qimmat,	تكلفة،
qimmat.	تكلفة.
xorijiy	أجنبي
Stereo	ستيريو
foydalanish:	استخدام:
ishlaydi	أعمال
qilsa&gt;	إذا كان وGT.
Wells	الآبار
narx	السعر
Voyager	رحالة
miscommunication	سوء الفهم
Ibroniylarga	الرسالة إلى العبرانيين
rasmiy	رسمي
hayoti,	حياة
***	***
gchin@Eng.Sun.Com	html>
tuyulardi-da,	على الرغم من أنه يبدو،
o&#39;ng&quot;	الحق ومثل؛
Shaxsan	شخصيا،
puxta&gt;	قوية وGT.
flybys	عملية تحليق
yoqdi.....	مثل .....
Rick.	ريك.
APPRECITATED	APPRECITATED
davrlari	الدوائر،
qiladi:	:
House	منزل
(Klaudio	(كلاوديو
kometa	المذنب
harakat&gt;	وGT.
qiladi?	؟
yutadi,	يوتا
qo&#39;shnilarining	الجيران
missiyaning	مهمة
masofaga	المسافة
hozirgi	تيار
janob	سيد
tupurib,	يبصقون،
iymon.	نعتقد.
tomonidan&gt;	وGT.
qiladi,	،
qiladi.	.
hozirga	الآن
Radioaktiv	المشعة
HIMEM.SYS	HIMEM.SYS
ismli	اسمه
ilmi	علم
hammamiz	كل
kabi&gt;	وGT.
hayotga	حياة
maqolasida	مقالة
yorilish	للقضاء
orêasida	متهور
disklar	أقراص
&quot;yo&#39;ldoshlarini	على &amp; quot؛ الأقمار الصناعية
ko&#39;rsatiladi.	سيتم عرض.
Massalari	الجماهير
mutakabbirlik	متغطرس
tonggi	فجر
yadroviy	نووي
endi&gt;	الآن &amp; GT؛
avlodlari	أحفاد
Chryse	كرايسلر
Masihiyning	كريستيان
kema	سفينة
radyoizotopların	النظائر المشعة
istardim.	وأود أن.
telefon	هاتف
talab	الطلب
Legge	يجي
kuni	يوم
80111	80111
muddati	فترة
davrlarini	التحويلات
Verbatim	حرفيا
&quot;salomatlik&quot;	على &amp; quot؛ صحية ومثل؛
aytganda	كلام
uchrashuv	لقاء
ijtimoiy	اجتماعي
ilmiy	علمي
Pavlus	بول
beri	منذ
navbatda,	في المقام الأول،
qoidalari,	قواعد،
qiyin).	صعوبة).
bera	يمكنك
yozadi	كتب
pop	فرقعة
______________________________________	______________________________________
yangradi	بدت
&quot;Christian»,	على &amp; quot؛ مسيحي &quot;
Allohning	الله،
orbitaga	مدار
tog&#39;li,	جبلي
saytidan	موقع
takabburlik	غطرسة
asosida,	على أساس
Uyali	موبايل
qoidalarga	اللوائح
landshaft	المشهد
sinovlarni	المحاكمات
oddiy&gt;	بسيطة وGT.
qurilgan	بني
Klaudio	كلاوديو
qiladi	سوف
RAM	RAM
Computer	كمبيوتر
Ahdda,	العهد،
ta&#39;rifi	تعريف
amaliyotini	ممارسة
siri	سر
kosmosda	الفضاء
gaz,	الغاز،
buni	هو
yoki&gt;	أو &amp; GT؛
61153	61153
sirt	سطح
kelib	قادمة
(Oila	(الأسرة
qiyomat	يوم القيامة
Shapiro	شابيرو
iloh	إله
uchun&gt;	وGT.
Meksika,	المكسيك،
aynan	بالضبط
ishlatilgan	وتستخدم
resurslarni	موارد
sabablar	الأسباب
Ateizm	الإلحاد
biron-bir	أي
kosmosga	الفضاء
gunohkor	آثم
keladi:	:
chiqildi.	.
urish	نبض
vazifasi.	وظيفة.
Chips	رقائق
Nunnally	Nunnally
turib,	بدون
keladi.	.
besh	خمسة
sizlar	أنت
keladi,	،
miss,	افتقد
narxlar	أسعار
shuningdek,	وكذلك،
(balki	(ولكن
sarmoya	استثمار
583.&gt;	583 &amp; GT؛
ekipajlari	أطقم
qoldirganmiz.	غادر.
&quot;charog&#39;on	على &amp; quot؛ ضوء
hamma	كل
hype	الضجيج
zarralar,	الجسيمات،
kompaniya?	الشركة؟
800mA	800M
aytganda,	باختصار،
sabab	سبب
agnostitsizm	الملحد
2-va	و2
dedi.	قال.
62,4	62.4
kuzatildi	ملاحظ
davrlarida	فترات
(eng	(
tushadi,	السقوط
dedi,	وقال:
keldi	وصل
okeanlar	المحيطات
&quot;gumanitar&quot;	على &amp; quot؛ الإنسان ومثل؛
misollar	أمثلة
dedi?	قال؟
qoplandi.	مغطاة.
metan	الميثان
tutadi	مسرحيات
axloq&gt;	الاخلاقيات و GT.
&quot;ilmiy&quot;	على &amp; quot؛ D &amp; مثل؛
six-	الست
mainstream	التيار
misol	مثال
yoppasiga	يخطأ
haydash?	القيادة؟
Alloh	الله
boshqalar	آخرون
Derazali	نوافذ
klaviatura	لوحة المفاتيح
solishtiring?	مقارنة؟
Ganymede	جانيميد
zid,	عكس
bitnet	البتنت
yangradi.	رن.
to&#39;dasi	سرب
7,329	7،329
Sabres	السيوف
dans@uxa.cso.uiuc.edu	html>
(ular	(وهم
hech&gt;	وGT.
kishilarning	الناس
-------------------	-------------------
xabar	تقرير
ruxsat,	،
Study&quot;	دراسة ومثل؛
ruxsat.	.
Uyg&#39;onish	استيقظ
ishonchsizlik	عدم ثقة
(yuk	(الشحن
Ota-window	النافذة الرئيسية
sigareta	سيجارة
________)	________)
Biz&gt;	نحن وGT.
davolashda	العلاج
*******************	*******************
zich	ضيق
modelga	نموذج
QXI	مستودع
mexanika	الميكانيكي
Company	شركة
pastga.	إلى أسفل.
qo&#39;yildi.	وضع.
kiriting	أدخل
bir-bir	ل
jarayonida	في عملية
İyonosfer,	الأيونوسفير
(Microsoft	(مايكروسوفت
siz,	أنت
dumli	هالي
Wings	أجنحة
o&#39;yin	لعب
Azot	نتروجين
ultrahigh-qaror	الفائق الدقة
eşleştirilir	يتم تعيين
X3153	X3153
og&#39;riqlari	الصداع
WINDOWS	WINDOWS
goon	الحمقى
Sirt	السطح
&lt;ekdfc.14.0@ttacs1.ttu.edu&gt;	العلامة &amp; lt؛ ekdfc.14.0@ttacs1.ttu.edu&amp;gt.
electronics	إلكترونيات
qalin,	سميك
&quot;bosh&quot;	على &amp; quot؛ &amp; مثل؛
(dual	(المزدوج
chiqilishi	تطوير
&lt;Fenton@Kaleida.Com&gt;	العلامة &amp; lt؛ Fenton@Kaleida.Com&amp;gt.
Chin)	الذقن)
kanyonlar,	الأخاديد،
Bos)	بوس)
shafoat	تشفع
xato)	خطأ)
gosh	يا الهي
berilgan,	،
berilgan.	.
oshiradi&quot;	ومثل؛
Xotami,	كراهية
Finlyandiya	فنلندا
versiyasini	نسخة
O&#39;xshash	مماثل
Avenue	شارع
uch,	ثلاثة،
munosabatlarni	العلاقات
hisobga.	حساب.
Pul	نقود
uch.	ثلاثة.
bu,	هذا
Arabic	العربية
(SF	(SF
(Re	(إعادة
Ishtar	عشتار
shartnomasi	معاهدة
nosimmetrik	متماثل
odatiy	معتاد
ayta	قول
(No	(لا يوجد
Emas,	ليس
o&#39;zgardi.	تغيرت.
pul	نقود
tortishish	إطلاق نار
(P.	(P.
so&#39;nggi&gt;	وGT.
Spiros	سبيروس
kiritish	دخول
Foundation	أساس
B2:&gt;	B2: &amp; GT؛
bag&#39;ishlangan.	مخصصة.
Topraklama	التأريض
romantik	رومانسي
Neptun	نيبتون
1Meg	1Meg
past&gt;	منخفض &amp; GT؛
boshlangan	التي
savollar	الأسئلة
makon,	الفضاء
atalishga	أن تكون
belgisi	علامة
sharmandalik.	العار.
avtobus	حافلة
yaqin,	قريب
gap)	GAP)
Titania	تيتانيا
Audio	سمعي
386DX-40	386DX 40
moslamalarni	الأجسام
egalari	أصحاب
&quot;ular&quot;,	على &amp; quot؛ &amp; مثل؛،
Rauser)	RAUS)
fikrlar	الآراء
boshqalarni	آخرون
tarmoqlari	الشبكات
to&#39;lash.	الدفع.
O&#39;n	عشرة
dalillar	حقائق
odatda	عادة
Semiconductor	أشباه الموصلات
to&#39;lash)	الدفع)
Java	جافا
geologik	الجيولوجية
tatbiq	تطبيق
orbitasi	مدار
koordinatalar	تنسق
to&#39;lash?	لدفع؟
Medical	طبي
oshiriladi)	)
xolislik.)	الأسهم.)
ayt.	قل لي.
o&#39;tkaziladi	مقبوض
oshiriladi.	.
Qo&#39;shimcha	إضافي
O&#39;z	خاص
&lt;1993Apr20.102756.1709@mala.bc.ca&gt;	العلامة &amp; lt؛ 1993Apr20.102756.1709@mala.bc.ca&amp;gt.
&quot;break	على &amp; quot؛ كسر
bc744@cleveland.Freenet.Edu	html>
zarralari	الجسيمات
oshiriladi?	؟
Cirelli)	Cirella)
Albertan,	البرتو
millatli	الشركات المتعددة الجنسيات
kitoblar	الكتب
hijrat!	الهجرة!
ko&#39;zalar&gt;	أباريق وGT.
qarashda,	للوهلة الأولى،
tuzish	خلق
sinf	فئة
(Va	(و
tasdiqlash	شهادة
o&#39;liklarning	الموتى
Injil,	الإنجيل،
buyurgan	أمر
«talqin»	&quot;التفسير&quot;
sessiyasi	جلسة
energetika	طاقة
Bible	الكتاب المقدس
da&#39;vat	دعوة
Texnologiya,	التكنولوجيا،
&quot;Siz	على &amp; quot؛
yoqilgan	تمكين
ko&#39;tarildi.	ارتفع.
dumlar	ذيول
​​hozir	الآن
(Emi	(ايمي
so&#39;zni	كلمة
foydalanuvchilar	المستخدمين
Galant	جالانت
deyilgan	يقول
baxtli	سعيد
(yangi)	(جديد)
sotish&gt;	مبيعات &amp; GT؛
miqdor	كمية
Welles	ويلز
qulaylik	ملاءمة
engillashtirish	تيسير
title-	title-
izoh	تعليق
jhardono@nickel.ucs.indiana.edu	html>
ortiqcha	مفرط
tomondan	من ناحية أخرى
qatorida	بين
ayol	امرأة
sayyora-keng	على نطاق الكوكب
shifrlash&quot;&gt;	التشفير ومثل؛ &amp; GT؛
emas	ليس
gchin@ssf.Eng.Sun.COM	html>
ARMM&quot;	مينداناو ومثل؛
nasroniy	مسيحي
(gomoseksual	(المثليون
Gomoseksual	مثلي الجنس
ROM	ROM
ayting.	الموقع.
aka	شقيق
(6.118	(6118
Yamaha	ياماها
ayting)	الموقع)
ayting,	موقع،
Verse	آية
qilmang.	لا.
tarmoqli	شريط
Versa	بالعكس
daromad	دخل
bo&#39;lsangiz&gt;&gt;	وGT؛ &amp; GT؛
oyat-	oyat-
Uilyam	وليام
ommaga	الجمهور
(va,	(و،
pragmatik	واقعية
AUTOEXEC.BAT	AUTOEXEC.BAT
teleskoplar	التلسكوبات
Xudoga	الله
oddiy	بسيط
Chikagodagi	شيكاغو
Email	البريد الإلكتروني
bevosita	فوري
Finney)	فيني)
o&#39;zgaruvchilar	متغير
*****************	*****************
ko&#39;rinadi.&quot;	وسيتم عرض ومثل؛
fikrim	أفكار
Kosmik	الفضاء
aloqa&quot;	ومثل؛
muomala.	العلاج.
chegarani	الحدود
o&#39;zgartirilgan.	تغيرت.
boshlangan,	التي
8300	8300
og&#39;irlik	الوزن،
tomon	حزب
-or-	أو-
mo&#39;ljallangan-yilda	في
rahmat&gt;	وذلك بفضل وGT.
yetkaza	العرض
o&#39;rgatish	لتعليم
O&#39;tmishda	في الماضي،
Evropa,	أوروبا
engp2008@nusunix1.nus.sg	html>
belanchak	في التأرجح
erkin	يبرالي
Yoqubning	يعقوب
teshiklari	الثقوب
sayyoraga	كوكب
noyabr,	تشرين الثاني
Ilmiy	علمي
&quot;bajarildi&quot;	على &amp; quot؛ فعلت &amp; مثل؛
2000	2000
Oldindan	مقدما
zanglagan-qizil	صدئ الحمراء
versiyalari	إصدارات
12-14)	12-14)
termokupl	المزدوجات الحرارية
tadqiqotlar,	بحث
\&gt;	\ &amp; طن.
krater-pocked	فوهة الجيب
normal	طبيعي
O&#39;sha	أن
darajasi	مستوى
tekshiring.	تحقق.
Alabama	ألاباما
quyuq	ظلام
asoslangan	على أساس
ko&#39;mildi	دفن،
Qonundan	القانون
Oyning	شهر
qaytish)	الخلفي)
yuzlab	مئات
^^^^^^^^^^^^^^^^^^^^^^^^^^^^^^	^^^^^^^^^^^^^^^^^^^^^^^^^^^^^^
Lyme	لايم
Universiteti	جامعة
sarma	فولت
yerda	هنا
groove	أخدود
foydalangan	باستخدام
saboq	الدروس
to&#39;qib	مزور
ana	مثل
sayohat	سفر
jonbozlik	إخلاص
professional&gt;	المهنية وGT.
Dual-Sport	المزدوج الرياضة
Hitter,	ضاربا
mol,	بضائع
Return	عودة
Repo	الريبو
Villanova	فيلانوفا
Orson	أورسون
sanktsiya	عقوبات
payg&#39;ambarlar	الأنبياء
amp	أمبير
amr	عمرو
qilaylik,	السماح
hisoblanadi;	هو؛
Kompyuterlar	أجهزة الكمبيوتر
hisoblanadi:	هو:
gravitatsiya	خطورة
stoli	سطح المكتب
tekshirib	الاختيار
Ba&#39;zan	أحيانا
---------------------------------	---------------------------------
qancha	كم
moliyaviy	مالي
fosh,	قناع،
tug&#39;ib	تجويف
Xudo,	الله،
shakar	سكر
Yerni	انقر هنا
qayiqda	القارب
(DOS	(DOS
P7625)	P7625)
sariq	أصفر
yoki?	أو؟
Xudo:	الله:
to&#39;g&#39;riligiga	دقة
ma&#39;naviy	روحي
yolg&#39;iz&gt;	واحد وGT.
fikrni	فكرة
bormi:	هو:
sadoqati	ولاء
bormi?	هو؟
sharoitlari	الشروط
joylashtiriladi	توضع
rejalangan	المخطط
«sekin	ببطء
olamlarning	العالم
;-)	؛-)
+31	+31
biladimi	تعرف
hisoblanadi,	غير
S.)	S.)
Ular,	هم
hisoblanadi.	هو.
aks	انعكاس
&quot;Scooter,&quot;	على &amp; quot؛ سكوتر ومثل؛
tasodifiy	عشوائي
davlat	دولة
birlashgan	متحد
Pluto	بلوتو
(boshqa	(أخرى
uglerod	كربون
uzoqda	بعيدا
atrofga	حول
bilan&gt;	وGT.
hosil;	؛
faolligi	نشاط
=============================	=============================
nazar,	،
kuchaya	لتنتفخ
qurbonlik	تضحية
oyatlarni	علامات
mahrum	حكم عليه بالسجن ل
sirtini	سطح
funktsional	وظيفي
417-4101	417-4101
yaratish	خلق
Randall	راندال
nafrat	كراهية
yoqadi.	مثل.
bo&#39;lsin.	السماح.
willisw@coe-nw.clemson.edu	html>
guruhlar,	المجموعات
sayyoramizdagi	كوكب
Micronics	MICRONICS
tovushi	الصوت
printerni	طابعة
bo&#39;lsin!	السماح!
tushib	تقع
Schuster)	شوستر)
murojaat	عنوان
bo&#39;ylab,	في جميع أنحاء العالم،
Uilyams	ويليامز
kristallari	بلورات
&lt;1993Apr21.182606.6798@ra.royalroads.ca&gt;	العلامة &amp; lt؛ 1993Apr21.182606.6798@ra.royalroads.ca&amp;gt.
hajmi,	حجم،
yirik,	عموما،
DR350S	DR350S
ishlaydi.	العمل.
Qo&#39;shnilari	الجيران
&quot;U	على &amp; quot؛
ichiladi	المعين
kimga	أي شخص
**********	**********
qilinishi	أشياء
ishlaydi?	العمل؟
g&#39;aram	كومة قش
qismidir.	جزء.
Mashina	آلة
RIP	RIP
yetarli	كاف
aytaylik.	على سبيل المثال.
yarim-muz,	نصف الجليد،
&quot;?	على &amp; quot؛؟
ko&#39;p&gt;	وGT.
erkak	ذكر
sovutiladi	تبريد
ayol,	النساء،
(Ibroniylarga	(عبرانيين
Gods	الآلهة
aslida	في الواقع
&quot;,	على &amp; quot؛،
Quyoshning	الشمس
&quot;.	على &amp; quot؛.
orada	وفي الوقت نفسه،
haydash	ركوب
m-it2691@cs.nyu.edu	html>
idish	حاوية
turibsizlar.	الوقوف.
solaman;	سولانا.
ekilgan	زرعت
tashlashdi,	يلقي
dlb@hudson.wash.inmet.com	html>
ishlatiladi,	المستخدمة،
ishlatiladi.	يستخدم.
jamoalar	فرق
solaman,	وسوف
irodasiga	إرادة
Genri	هنري
argon,	الأرجون،
xursand	سعيد
porlaydi.	تلمع.
SUPERVGA	Superve
&quot;Plastinka&quot;	على &amp; quot؛ لوحة ومثل؛
ionlar	الأيونات
teskarisini.	عكس ذلك.
jamoa	مجتمع
rethorical	rethorical
Askew	منحرف
zikr	ذكر
o&#39;xshash	مماثل
bilagini	معصم
chiqarish.	.
chiqarish,	الإنتاج
^^^^&gt;	^^^^ وطن.
aprel,	نيسان
gravitatsion	الجاذبية
ommasi	الجماهير
quacks	الدجالين
meteorologiya	الأرصاد الجوية
nemis	ألماني
sayyorada	كوكب
darajali	مستوى
yadrosining	نواة
o&#39;sha.	.
Whitsell	Whitsell
shimoliy	شمالي
asetilen,	الأسيتيلين،
paneli	شريط الأدوات
etmoqda?	؟
Yerga	الأرض
Yuqori	ارتفاع
qilingan	كانت
ichki	داخلي
oshirish	زيادة
qilmasliklaridandir	ليس
mintaqasini,	منطقة
613)	613)
etmoqda.	.
etmoqda,	،
&lt;15378	واللفتنانت؛ 1537
zondlar	تحقيقات
Costner	كوستنر
mos.	.
Near-bo&#39;ron	شبه عاصفة
mantiya	عباءة
uslublarini	طرق
hambidge@bms.com	html>
dunyodan	العالم
ayollarga	نساء
18:33	18:33
solishtirganda,	مقارنة،
qon	دم
DBD@ICF.HRB.COM	html>
(Clayton	(كلايتون
texnologiyasi,	تكنولوجيا
theists)	الخروج من الملة)
reliz	إطلاق
Guerke,	Guerke
İticiler	الدفاعات
Guerke)	Guerke)
Faqat	فقط
avlodlar	أجيال
Chill.	البرد.
ulkan	ضخم
theists,	الخروج من الملة،
yuborish	إرسال
Project	مشروع
B433EI2	B433EI2
chunki?	ل؟
ateist&quot;	الحادي ومثل؛
darajaga	مستوى
Cape	كيب
amerikaliklar).	الأميركيون).
(ehtimol	(ربما
haq.	الحقيقة.
11:26),	11:26)
Karl	كارل
chunki,	لأنه،
g&#39;oyalarni	أفكار
o&#39;chirildi	حذف
3-8),	3-8)
ikki	اثنان
Surveyor	مساح أراضي
Yerda	هنا
(Herman	(هيرمان
ai843@yfn.ysu.edu	html>
thomasp@ifi.uio.no	html>
To&#39;rt	أربعة
anekdot	anekdot
to&#39;qqiz	تسعة
dunyoda,	العالم
Boshqalar	آخرون
LATONIA)	LATONIA)
tasdiqlagan,	أكد
muhitini	بيئة
Nyu-York	نيويورك
Quebec,&gt;	كيبيك &amp; GT؛
yo&#39;q)	لا)
yo&#39;q,	لا،
o&#39;zimizni	أنفسنا
yo&#39;q.	لا.
Allohga	الله
harf	حرف
Managerda	مدير
hard	من الصعب
(Peter	(بيتر
aralash	مختلط
(21,648	(21648
Stone)	الحجر)
ogohlik	القابض
dono)	الحكمة)
Harakat	عمل
chiqinglar.	الإقلاع عن التدخين.
ostida,	تحت
kesib-nazorat	السيطرة -cut
burchakli	تغذية مرتدة
DELCO	ديلكو
23-26,	23-26،
haqida,	حول
masihiy	مسيحي
xavas,	هافاس،
halo	هالة
uzunligi	طول
pley-off	تلعب خارج
egasidirģ	تلك محظوظا
hali	بعد
o&#39;zlarini,	أنفسهم،
Christian	مسيحي
Uzoq	بعيدا
alung@megatest.com	html>
Sayyoralar	الكواكب
yoritilgan	أشعل
qodir.	قادرة على.
batareyani	بطارية
ham,	،
havoriylariga,	الرسل،
FJ1200	FJ1200
ham.	.
Oyga	القمر
diplomatiya	دبلوماسية
(shapka,	(هات،
oshiriladi	سيكون
haqida?	؟
Detroyt	ديترويت
kichik,	صغيرة،
ham)	)
olishi	أخذ
agentligi	وكالة
kichik)	صغيرة)
ko&#39;plab	كثير
Sarlavha	لقب
haqida.	.
yo&#39;li	طريق
(Dan	(دان
Thorson	Thorson
Reyting:	التقييم:
noto&#39;g&#39;ri,	خاطئ
so&#39;rovnoma	استطلاع
zarur.	لزم الأمر.
Pharasees	Pharasees
yo&#39;l,	،
Oyda	شهر
takomillashtirish	تحسن
suhbatlashdi	محادثة
signal	إشارة
noto&#39;g&#39;ri	خاطئ
Raketa	صاروخ
kech	متأخر
--------------------------	--------------------------
Corolla	تويج
qo&#39;shadi.	إدمان.
Taxta,	الأرضيات،
qum	رمل
kamarning	حزام،
qo&#39;shadi,	إدمان
kitobxonlar	القراء
taraqqiyot	تقدم
Nagle	Nagle
ob&#39;ektlarni	الأجسام
ota-va	وأولياء الأمور
Moon	هلال
oyatlarda	الآيات
==========================================	==========================================
g&#39;oyalarini	أفكار
tushunib	فهم
maqola	مقالة
Rauser	RAUS
adolatli	معرض
çökmekte	المتداعية
darajada	مستوى
(2.544	(2544
olgan&gt;	وGT.
bog&#39;liq	ذات الصلة
ekan.	.
topish	تجد
ekan,	لذلك،
foto	صور
qadriga	نقدر
Rossiya,	روسيا،
HAMZA	HAMZA
yo&#39;l)	)
talqini.	التفسير.
qizg&#39;in	مسخن
Coord.	COORD.
#&gt;	# &amp; طن.
drama	دراما
Filip)	فيليب)
bilgan	كنت أعرف
vositalarini	الوسائل
Ulysses	أوليسيس
Kaliforniya	كاليفورنيا
g&#39;oyasini	فكرة
itrakonazol	يتراكونازول
reja,	خطة
415-688-8231	415-688-8231
Turli&gt;	وطن.
Que	كيو
tashlangan	إزالة
Nobuaki	نوبواكي
20Meg	20Meg
Nowadys	Nowadys
Keyinchalik	فيما بعد
Brooks	بروكس
Rendezvous	موعد
topsangiz,	الحصول على
muddat	مصطلح
o&#39;tib,	في وقت لاحق،
Pioneers	الرواد
Momo	حواء
asl	أصلي
fosh	يتعرض
shogirdidan,	الطلاب،
--------	--------
donut	دونات
ehtiyot	احتياطي
darslari	فصول
JESUSCHRIST	JESUSCHRIST
firibgarlik	احتيال
o&#39;zgartirishda	تحول
Apriori	APRIORI
olish:	المشاهدات:
buyuradi.	على الدفع.
mo&#39;minlarga&gt;	المؤمنين وGT.
boshqalar,	آخرون
natija	نتيجة
qopqog&#39;ini	غطاء
emasmiz,	ليس
saraton	سرطان
Maksvell	ماكسويل
Kokomo,	كوكومو
ishlar	شئون
ayollarni	نساء
do&#39;zaxdan	النار،
olish,	،
tomchi	تقطر
Maydoni	منطقة
orbitasini	مدار
gumanitar	إنساني
refering	الإحالات
ibodat	عبادة
bag&#39;ishlangan	مخصص ل
markaziy&gt;	الوسطى و GT.
aql	استخبارات
ishlab	الإنتاج
tasvirlarni	الصور
aniqlashdi.	اكتشفت.
shgichlar:	الموصلات:
abadiylashtirish	تديم
Maktab,	مدرسة
(der	(دير
Cary	كاري
bermadi.	لم أكن.
uyg&#39;onish	استيقظ
Oyni	القمر
eshitildi	سمعت
bosqichga	مستوى
davolash	شفاء
erkaklar,	الرجال
avj	التصعيد
Askew,	منحرف
Seminar	ندوة
reasonning	الأسباب
majburlash	إكراه
Proper	مناسب
qobiq	خلع الملابس
o&#39;qish,	قرأ
unclumped	unclumped
(1,170	(1170
o&#39;qish)	القراءة)
Freq.	التكرار.
Arablar	العرب
hokazo	إلخ
kasalliklar	أمراض
Palmer	مسعف
(Darvoqe,	(بالمناسبة،
qaytarmoqchi	لثني
Nunnally)	Nunnally)
&lt;bo&#39;sh	العلامة &amp; lt؛ فارغة
asr	قرن
bashorat	تنبأ
nurlarini	أشعة
nazarda	من
masala	قضية
&quot;haqida	على &amp; quot؛
bosqichda	مرحلة
mashg&#39;ulotlari	احتلال
Alyosha	Alyosha
majlislarida&gt;	الاجتماعات &amp; GT؛
eslab	تذكر
yozib	سجل
ato	معطى
(va	(و
havo	هواء
VL-avtobus	VL حافلة
Buning	هو
Plus	زائد
Askew)	منحرف)
eshitib	سمعت
Lankford	Lankford
tushirish	بداية
buy-orqa	إعادة شراء
RSEVERY	RSEVERY
(faqat	(فقط
yo&#39;qol	يذهب بعيدا
o&#39;rganamiz.	تعلم.
Carl	كارل
universiteti	جامعة
parokandalik	اضطراب
Card	بطاقة
eslay	تذكر
xavfsizligi&quot;	الأمانة و مثل؛
tortiladi,	تخضع ل،
jiddiy	جدي
Qoida	حكم
tezligi	سرعة
Ichida	ضمن
Justification_,	Justification_
yana&gt;&gt;,	وGT؛ &amp; GT؛،
tabiatda	طبيعة
sessiya	جلسة
pgf@srl03.cacs.usl.edu	html>
Uy-pishirmoq	المطبوخ في البيت
hujjat	وثيقة
kashfiyotlar	الاكتشافات
roli	دور
sekin	بطيء
emasmi?	هو؟
Xudosi&quot;,	والله مثل؛،
oldin,	قبل
asteroit	الكويكب
oldin.	قبل.
homosexal	homosexal
[386Enh]	[386Enh]
yuborilgan	أرسلت
o&#39;zgartiradi	المتحولون
ishonasizmi?	هل تصدق ذلك؟
Iso	يسوع
kim&gt;	وGT.
native	مواطن
etadi,	،
kutaman	انتظار
e&#39;lon	إعلان
o&#39;tish	إذهب إلى
etadi.	.
o&#39;zimni.	نفسي.
oldim.	I.
bog&#39;liq.	.
AT)	AT)
(non-Duo)	(غير الميت)
eshitmagan?	سمعت؟
shartnoma.	العقد.
_____	_____
Qodir.	سبحانه وتعالى.
olish	للحصول على
gumon	اشتباه
hukmron	حكم
dizaynerlari	المصممين
oldini	منع
yozilgan,	كتابي
huquqdan	حق
asteroid	الكويكب
omad	حظ
fitna	مؤامرة
Isoni	يسوع
[Ibroniylarga	[العبرانيين
teskari	عكس
Hozir&gt;	الآن &amp; GT؛
Communications	الإتصالات
yarimsharda	نصف كرة
dasturlarda	تطبيقات
(va&gt;	(&amp; طن.
bo&#39;lmagan.	.
040	040
yog&#39;dirilgan.	النساء فضلا عن الرجال.
20X-60X60mm,	20X-60X60mm
qaroqchi,	لصوص،
hetero	مغاير
universiteti:	الجامعة:
o&#39;ylash	تركيز
ateistlar	الملحدين
qilayotganini.	أن.
AIAA	AIAA
derazasiga	نافذة
dinamikasi,	ديناميات،
qaynoq	غليان
emasmi	هل
_______________________	_______________________
o&#39;chirilishi	حذف
azot,	النيتروجين،
Phobos	فوبوس
yangilanadi.	محدث.
fabrikalar	المصانع
&lt;C5xxq0.18M@cs.columbia.edu&gt;	العلامة &amp; lt؛ C5xxq0.18M@cs.columbia.edu&amp;gt.
narigi	الجانب الآخر
DH-kabi	كما DH
Comet	المذنب
versiyasi.	الإصدار.
===============	===============
adabiyotlarda	أدب
ko&#39;tarib,	أثار
Galiley,	غاليليو،
sovuq,	البرد،
N-8-1	N-8-1
piramida}	الهرم}
kimdir,	شخص ما
Panoramic	طريقة إدارة آلة التصوير
mo&#39;g&#39;ullar	المغول
tananing	الجسم
organlari	الهيئات
daryo	نهر
Baseball	البيسبول
mumkin	يمكنك
Madyanga	ومدين
boshlaydi.	.
javob:&gt;	الإجابة: &amp; GT؛
ufqda	في الأفق
WinJPEG	WinJPEG
Magellan,	ماجلان
Okay,	حسنا،
koloniya	مستعمرة
ko&#39;rinishi,	مظهر
komikslar	رسوم هزلية
&quot;&gt;	على &amp; quot؛ &amp; GT؛
000	000
[masihiylar]	[المسيحيين]
tizimi	نظام
qutblar	أعمدة
gazetasi	صحيفة
(UNT-CAS	(UNT-CAS
kun-litsenziya	رخصة -يوم
atmosferasida	الجو
S5R3.2	S5R3.2
chiqardi.	صدر.
muzlatilgan	مجمد
Humphreys	همفريز
tushunchasi.	المفهوم.
meniki	منجم
3.1,	3.1
xudosizlar	الملحدين
omma	كتلة
erkinligi	حرية
yükseltilebilir	ترقية
duchor	يتعرض
Odam,	الرجل،
sababi&quot;	سبب ومثل؛
rang	اللون
&quot;velopoygachi»	على &amp; quot؛ المنشطات
ya&#39;ni	وهذا هو،
Quddus	القدس
oling	تعلم
(Nik	(نيك
etyolojik	سببياتي
ko&#39;rsatadi,	عروض
​​non-tajovuzkor,	غير عدوانية،
132,252	132،252
Qarshi	ضد
Active	نشط
bosimini	الضغط
toml@boulder.ParcPlace.COM	html>
Herman,	هيرمان،
Kreyg	كريغ
kabellar:	السيارات:
ko&#39;rsatadi.	.
mars,	المريخ،
balandlik	ارتفاع
Asosiy	رئيسي
oldingi	سابق
^^^^^^	^^^^^^
tajriba.	التجربة.
emasman	أنا لست
fikr-mulohazalaringizni	تعليقات
oldinga	قدما
missiyalari	البعثات
Merkuriy,	الزئبق،
nomga	لقب
gapirdingizmi!	gapirdingizmi!
resurslari	موارد
Teleskop	تلسكوب
shayton	إبليس
olaman	وسوف أكون
tabiblarga	المعالجين
​​Mars	المريخ
Maftunkorliliga	Maftunkorliliga
olasizmi,&gt;	هل أنت &amp; GT؛
tushlar)	أحلام)
Felix	فيليكس
ulushi	حصة
Heterosexuel	متباين الجنس
o&#39;qi	READ
qiluvchi	مشتر
paytida	خلال
tevaragida	غامضة
chipset	شرائح
symbolisms&gt;	Symbolisme &amp; GT؛
g&#39;alaba	فوز
Bake	خبز
da&#39;vo&gt;,	وGT؛، مطالبة
Newton	نيوتن
(Bill	(بيل
aslida&gt;&gt;	كولينز &amp; GT؛ &amp; GT؛
aytaman	أقول
sabablari:	الأسباب:
oynaning	نافذة
lekin,	ولكن،
zarba	تأثير
jahon	عالم
urinishlariga	جهود
Sichqonchasi;	الماوس؛
zarar	ضرر
|&gt;&gt;	| &amp; طن؛ &amp; GT؛
yer-out-of-biznes	الأراضي خارج العمل
mashinalar	موقف
kriptografik	التشفير
marly	مسمد بالمرل
belbog&#39;larini	أحزمة
qonun	القانون
TIFF	TIFF
yozgan	كتب
musibat	كارثة
istiqomat	يعيش في
Timmons	تيمونس
urinishlar	محاولات
geografik	الجغرافية
ikki&gt;	وGT.
mamlakat	بلد
Fisher	الصياد
o&#39;rniga&gt;	بدلا من &amp; GT؛
nomi	اسم
ma&#39;muriyatining	إدارة
6/92,	6/92
olishda	لاذع
topishingiz	تجد
tuman	منطقة
shakllari,	أشكال،
dasturlarga	تطبيقات
katta&gt;	و&amp; GT؛
Germaniya,	ألمانيا،
mlee@post.RoyalRoads.ca	html>
qabr	قبر
o&#39;ng	حق
15-siz&gt;	15 &amp; GT؛
v124p7kk@ubvmsc.cc.buffalo.edu	html>
ishlarni	عمل
neccacery	neccacery
(Yusuf	(يوسف
berishi	منح
Placebo	دواء وهمي
emasmi.	هو.
Qizil	أحمر
____________________________________________	____________________________________________
1992/93	1992-1993
chiqdi.	.
bo&#39;yicha,	في
qilmadi	لم
zichlikka	كثافة
bo&#39;lmasdan	بدون
KELDI	صلوا اليها
AAS	AAS
Jet	طائرة نفاثة
qulflangan,	مؤمن،
Inc.	شركة
tarbiyasida	تعليم
qulflangan.	مؤمن.
&quot;jargonese&quot;)	على &amp; quot؛ jargonese ومثل؛)
Yee)	يي)
olmaysiz.	لا يمكنك.
Inc,	المؤتمر الوطني العراقي
kuzatganman.	لوحظ.
to&#39;rttaga	أربعة
qo&#39;ng&#39;iroqning	الدعوة
Triantafyllopoulos)	Triantafyllopoulos)
uzoqlashib,	بعيدا،
BO&#39;LGAN	مع
(myslef	(ميسليف
yo&#39;qdan	بديع
qurolga	سلاح ناري
salomatligini	الصحة،
qatnashdi	شارك في
Safety	سلامة
Mitchum)	Mitchum)
teginish	لمس
nazardan,	وفقا لذلك،
berdi,	،
berdi.	.
molekulalari	جزيئات
aniqlangan.	التي تم تحديدها.
raqamlarini	أرقام
Atrofida	حول
reklama	إعلان
asosiy-kamar	والحزام الرئيسي
ob-havo	طقس
Englewood,	إنجلوود،
bemor	المريض
to&#39;lgan	متخم
&quot;dinamik&quot;.	على &amp; quot؛ دينامية ومثل؛
ikkita	اثنان
noorganik	غير العضوية
ANTI-Trust	ANTI-TRUST
KES	KES
olov	حريق
&quot;uzoq	على &amp; quot؛
mitti&quot;	صغيرة ومثل؛
qaytganida,	عاد
tanlagan	اختيار
Albatta,	وبطبيعة الحال،
(CRAF)	(الحرف)
o&#39;zi	نفسه
futbolchilar?	اللاعبين؟
rozi	توافق
talqinlar	التفسيرات
(Mayk	(مايك
knifes	سكاكين
omadli	محظوظ
(Hans	(هانز
jaskew@spam.maths.adelaide.edu.au	html>
chodirlarda	الخيام
antennalar	هوائيات
Pasadena,	باسادينا،
aylanib	أصبح
hududlari	المناطق
Jay	جاي
Vancouver	فانكوفر
magnit	مغناطيس
fanlar	العلوم
Faehl)	Faehl)
meva,	الفاكهة،
ikkisi	على حد سواء
nur	شعاع
mening	لي
Odam	رجل
e&#39;tiqodlari	المعتقدات
iste&#39;mol	استهلاك
sig&#39;maydigan	تتفوق
cho&#39;zilgan	إطالة
xaridorning	مشتر
tanqidga	نقد
oynani	منبثقة
o&#39;yinni	لعبة
(Mark	(مارك
(Mat.	(مات.
vositachi	متوسط
Yahudiylar,	اليهود،
yordamida,	باستخدام
&quot;electroglow.&quot;	على &amp; quot؛ electroglow على &amp; quot؛
ruhiy	عقلي
Adams	آدامز
tektonik	معماري
(sianid	(السيانيد
heterojenlik	عدم التجانس
Masters,	الماجستير
Lore	تقاليد
Oxir-oqibat,	في النهاية،
Shuning	لذلك،
(afzal	(تفضيلات
^),	^)
yulduzning	النجم
ADC	ADC
so&#39;ngra	ثم
(303)488-6120	(303)488-6120
451-0815,	451-0815،
(_______________________)	(_______________________)
chap?	اليسار؟
Evro-urish)	اليورو بالس)
chunki&gt;	وGT.
to&#39;g&#39;ri!	الحق!
(Ethan	(إيثان
Masihga	يسوع المسيح
(Matt	(مات
qilmoqchi	تريد
rahmat	شكرا لك
taxmin	تخمين
alohida-alohida	على حدة
fungal	الفطرية
kirdi.	دخل.
Viking	الإسكندينافي
kengliklarida.	العصابات.
Nagle)	Nagle)
katta	كبير
&quot;ism	على &amp; quot؛ اسم
olma	تفاحة
kuzatilmoqda.	لوحظ.
atraction	Atractii
sintez	تركيب
tiriladi	سيتم احياء
laetril	laetril
scan	تفحص
Info	معلومات
radiatsiya	إشعاع
chang	غبار
keladi	جاء
MacRae)	ماكراي)
Look	نظرة
&lt;1993Apr17.125545.22457@rose.com&gt;	العلامة &amp; lt؛ 1993Apr17.125545.22457@rose.com&amp;gt.
instituti&gt;	معهد &amp; GT؛
(Keyt	(كيث
qotillik	قتل
AIR	AIR
^^^^^^^^^^^^^^^^^^^^^^^	^^^^^^^^^^^^^^^^^^^^^^^
gapirganda	يتحدث
biz&gt;	نحن وGT.
beraman	عقد الإيجار
Horus	حورس
ko&#39;rindi	ظهر
shafqatsiz	قاس
ishtirok	مشاركة في
bechora	بائس
Joseph	يوسف
xx155@yfn.ysu.edu	html>
nom	لقب
non	خبز
ahvoli	حالة
&quot;savdo	على &amp; quot؛
jinsiy	جنسي
Microsystems	مايكروسيستمز
muammo	مشكلة
Qancha	كم
ko&#39;ring.	.
(Rick	(ريك
(437	(437
ko&#39;ring,	،
&quot;biz&quot;	على &amp; quot؛ &amp; مثل؛
rangi	اللون
tanish	اعتراف
Bloomberg,	بلومبرغ،
hech,	لا،
​​muayyan	مؤكد
Faks:	الفاكس:
Management	إدارة
o&#39;yinda	مباراة
parodiya	باروديا
oynada	نافذة
&quot;uzuk,	على &amp; quot؛ خاتم
qismini	جزء
******************	******************
[ajoyib	[العظمى
axloqi	أخلاق
yoqilg&#39;i	وقود
yo&#39;lida,	على الطريق
100&gt;	100 &amp; GT؛
chiqadi.	.
Korinfliklarga	كورينثيانز
axloq]	الأخلاق]
(Brian	(بريان
&quot;Xudo&quot;	على &amp; quot؛ الله &amp; مثل؛
ming	ألف
ammo,	ولكن،
Iltimos	من فضلك
Erning	الأرض
803-654-8817	803-654-8817
masalalarni	قضايا
sochlari	شعر
British	البريطانيون
kuzatuvchi	مراقب
inson-Mürettebatlı	طاقم -man،
so&#39;nggi	آخر
sahifalar	صفحات
erkaklar&gt;	رجل &amp; GT؛
davrlar	فترات
qaror:	القرار:
karışıklığından	الاضطرابات
fayllar	ملفات
jangda	معركة
»bilan	»
borish	اذهب إلى
chamadonni	حقيبة سفر
qilgach,	بعد
kalitlari	مفاتيح
&quot;nisbiy.&quot;	على &amp; quot؛ النسبية على &amp; quot؛
Sotuvchining	بائع
Shtatlari	الدول
kiritishingiz	لإضافة
tarbiyalashda	في التربية
34,839	34،839
muzli	جليدي
sci.crypt	sci.crypt
miqdorda,	المبلغ،
tasdiqladi.	وقد أكد.
olti	ستة
aholi	عدد السكان
Qariyb	تقريبا
manziliga	عنوان
&quot;yuz	على &amp; quot؛
​​murakkab	صعب
Jon	جون
(447	(447
sharqdan	الشرق
samarasiz	غير فعال
Joe	جو
-club	-club
Agressive	عدوانية
hollarda,	الحالات
qilmang	لا
dioksid	ثاني أكسيد
tasma	وشاح
[LDS]	[LDS]
40Meg	40Meg
namunalarini	عينات
ta&#39;lim	تعليم
distributorga	موزع
molesters	جرائم الاعتداء
Emulator	منافس
qoldiqlari.	الأنقاض.
Yangiliklar	أنباء
qoldiqlari,	أطلال،
aylandi	أصبح
o&#39;tkazgandan	الإنفاق
chiqaylik.	السماح.
(siz	(أنت
qilishingiz	إلى
Ju)	جو)
anglatadi.	يعني.
Shvetsiya	السويد
15:	15:
ingliz	الإنجليزية
kamchiliklarni	أوجه القصور
qadr-qimmatini	كرامة
Harvey)	هارفي)
shifrlash&gt;	التشفير &amp; GT؛
tinchlikda	باريستا
150	150
15,	15
anglatadi?	يعني؟
Stanley	ستانلي
qurilmalar	الأجهزة
insoniyat	الجنس البشري
kurashsagina	النضالات
Norvegiya	النرويج
qurilma,	الجهاز،
xristian	مسيحي
joylashtirish	وضع
Apple	تفاحة
yuborgan	أرسلت
ibtidoiy	بدائي
Wizzard	يزارد
ohm	أوم
162	162
ovozli	صوت
(215)645-6463	(215)645-6463
umuman	عام
piksel	بكسل
bokira	عذراء
Jadvalga	جدول
dedi:&quot;	قال: ومثل؛
sotilgan.	المباعة.
Havoriylar	أعمال الرسل
kegani	لها
o&#39;ylaysiz	اعتقد
ma&#39;lumot)	معلومات)
176	176
ok,	طيب،
qidiruv&gt;	بحث &amp; GT؛
chaqirib,	دعوة
170	170
ekanligini	أن
_hard_	_hard_
masihiylar,	المسيحيين،
tuzildi	قدم
yuboriladi.	أرسلت.
örtülmemesidir	التعتيم
xudolarsiz,	الآلهة،
nihoyatda	جدا
Ba&#39;zi	بعض
nafratlanaman.)	أنا أكره).
to&#39;pi	الكرة
oqlanishni	مبرر
Sukunatga	الصمت
Menga	لي
sana	تاريخ
zarur	ضروري
o&#39;rab,	محاط
X-Window	X-النافذة
(Brian@gab.unt.edu)	(Brian@gab.unt.edu)
hayoti	حياة
yuzasiga,	السطح،
muzliklarning	الأنهار الجليدية
[&quot;Isoning	[&amp; قووت]؛ يسوع
&quot;yoki	على &amp; quot؛ أو
ajoyib	رائع
masihiylar?	المسيحيين؟
&quot;Bir	على &amp; quot؛
yo&#39;ldoshlarini	الأقمار الصناعية
xarakterdagi	حرف
va&#39;zgo&#39;ylik	وعظ
(David	(ديفيد
21-22	21-22
o&#39;n	عشرة
moddiy&gt;&gt;	المواد وGT؛ &amp; GT؛
(post	(المشاركة
&quot;Biz	على &amp; quot؛ نحن
imkonsiz	مستحيل
oqish	تسرب
o&#39;z	خاص
wrap,	لف
Karamazovlar	كارامازوف
pole	قطب
ismingiz	اسمك
bemorlarga	المرضى
Noring)	نوري)
20850	20850
xavf	خطر
kasalliklarni	أمراض
cramer@optilink.COM	html>
Yulduzning	النجم
122	122
Shack	كوخ
kabi.	.
Mags	أكواب
yahudiy	اليهودي
ta&#39;siri&quot;	تأثير ومثل؛
muhimdir.	فمن المهم.
hayot.	الحياة.
saqlanayotgan	تخزين
&lt;1993Apr16.173252.7393@asd.com&gt;	العلامة &amp; lt؛ 1993Apr16.173252.7393@asd.com&amp;gt.
guruhi	مجموعة
kabi,	مثل،
arab,	العربية،
muqobil&gt;	بديل &amp; GT؛
120	120
kabi)	)
Saturn,	زحل،
namozda)	صلاح)
Quinn)	كوين)
Butrus&gt;	بيتر &amp; GT؛
mikser	خلاط
qolgan	المتبقية
Payg&#39;ambarlarni	الأنبياء
Hisoblash	حساب
tushuntirib	شرح
Fridman	فريدمان
(408)	(408)
Keyinchalik,	ثم،
Orbiter	المتتبع
Camary	كامارينا
imkoniyatiga	إلى
13,	13
joylashgan	تقع
bo&#39;lganlar	منها
Mail	البريد الإلكتروني
safarlarimiz	الرحلات
isloh	إصلاح
yo&#39;qligi	عدم وجود
Isroil	إسرائيل
------------------------------	------------------------------
&lt;timmbake@mcl.ucsb.edu&gt;&gt;&gt;	العلامة &amp; lt؛ timmbake@mcl.ucsb.edu&amp;gt؛ &amp; GT؛ &amp; GT؛
ko&#39;rib	نظر
xato	خطأ
Taxminan	تقريبا
149	149
14:	14:
********	********
&quot;Isoni	على &amp; quot؛ يسوع
92.8	92.8
liniyalari	خطوط
dasturi	برنامج
yotoqlari	اتجاهات
orbitasida,	مدار
off	بعيدا
guruh,	مجموعة،
140	140
xastaligidan	مرض
oqibatida	ونتيجة ل
turing	عقد
ochiladi	يفتح
Frantsiya,	فرنسا،
Jonson,&gt;	جونسون آند جي تي؛
tormoz	فرامل
Torre	توري
Yevropa	أوروبا
o&#39;ylamayman.	لا أعتقد.
xavfsiz	تأمين
Masihiy	مسيحي
qaysi&gt;	وGT.
o&#39;g&#39;illari,	أبناء،
Kasallik	مرض
yo&#39;qligini	سواء
faxrlanib,	فخور
qurilma	الجهاز
Mototsikllar	الدراجات النارية
nazardan	ضمن
olmadi.	فشل.
Xulosa	ملخص
ofset	تعويض
Qadimgi	القديمة
wagner@mala.bc.ca	html>
&quot;Sizning	على &amp; quot؛ حسابك
dastur.	برنامج.
Oltingugurt	كبريت
yopilishi	إغلاق
(Noring	(نوريو
gapirayotganim	يتحدث
boshlaydi	تبدأ
etsa,	إذا كان
&quot;Shifrlash	على &amp; quot؛ التشفير
shunday	هكذا
o&#39;lgan	ميت
oynasi	نافذة
edi&gt;	وGT.
indicting&gt;	إنديكا &amp; GT؛
nuqtalari	نقاط
berilgan	معطى
dollar	دولار
(shunday	(
niyatlarini	النوايا
LA,	LA
CRAF	حرفة
readiing	readiing
o&#39;zgaradi,	التغيير،
oqimi	تدفق
ilovasidan	التطبيق
obo	OBO
nazorati	سيطرة
xursandman.	أنا سعيد.
kitobida	في كتاب
(deyarli)	(تقريبا)
qora	أسود
tomir,	الأوعية الدموية،
tıklatırsa	نقرات
yutuqlari	الإنجازات
19,	19
poda	قطيع
mouse@thunder.mcrcim.mcgill.edu	html>
Fraering	Fraering
vakolatxonalari	مكاتب تمثيلية
(Oh,	(أوه،
VESA	VESA
daqiqa	دقيقة
a&#39;zolari	أعضاء
RA&gt;	RA &amp; GT؛
bakterial	بكتيريا
pitching	نصب
Masihni	يسوع المسيح
balki!	ولكن!
qo&#39;llab-quvvatlaydi	الدعم
Qadimiy	عتيق الزي
Yupiter,	كوكب المشتري،
ierarxik	الهرمية
19:	19:
vodiylarda	الوديان
berur.	يشاء.
Aksariyat	أغلبية
o&#39;zini	نفسه
balki,	ولكن،
tugadi	انتهى
zahirasini	احتياطي
tergov	تحقيق
Halley	هالي
Tabiblar	المعالجين
Deb,	أن
bemalol,	مجانا،
professional	محترف
vositalari	أدوات
payg&#39;ambar	نبي
&lt;C51nLs.7As@boi.hp.com&gt;	العلامة &amp; lt؛ C51nLs.7As@boi.hp.com&amp;gt.
trillionth	تريليون
27.2.	27.2.
&quot;Magic&quot;&gt;&gt;	على &amp; quot؛ ماجيك ومثل؛ &amp; GT؛ &amp; GT؛
jarrohlik,	الجراحية،
yuqorisida	في الجزء العلوي
talabgor	مزايد
(Tinglash).	(CAL).
o&#39;qildi	قرأ
chiqishidan	اترك
Mercury	زئبق
Boyd	بويد
ijobiy	إيجابي
emas.	هو ليس كذلك.
emas,	ليس
VE7GDA	VE7GDA
rishiz	التحليق
---------------	---------------
&quot;eshkaklar	على &amp; quot؛ معاول
bekor	ألغيت
asteroitler	الكويكبات
emas)	ليس)
LDS	LDS
BO&#39;LMAGAN	NOT
Jahannam&gt;	الجحيم &amp; GT؛
boshlagan	التي
tushirilishi	إطلاق
to&#39;xtadi.	توقفت.
LED	الصمام
mulohaza	منطق
sun&#39;iy	مصطنع
qismida	الشرقية
emas?	أليس كذلك؟
tunda	ليل
turish	إقامة
oniy	لحظة
emas;	لا؛
viloyatlariga&quot;	مناطق ومثل؛
&quot;sub&#39;ektiv&quot;	على &amp; quot؛ &amp; ذاتية مثل؛
Lvc@cbnews.cb.att.com	html>
~~~	~~~
xalq	الناس
Millatiga	عرقي
ishlatish	استخدام
sarf	الإنفاق
aralashmasidir.	الخليط.
to&#39;g&#39;ridan-to&#39;g&#39;ri	مباشرة
himoya	حماية
olish&gt;	وGT.
Ken	كين
qator	سلسلة
oshiradi.	يزيد.
yuborilgan.	أرسلت.
kiriting:	أدخل:
Venera,	فينوس،
Matt	مات
chunki	ل
yashiringan.	المخفية.
astronomi	عالم الفلك
oz,	القليل
murabbiyi	مدرب
farqni	الفرق
ko&#39;rinishi	مظهر
gravitacional	gravitacional
&lt;1993Apr4.221228.17577@bsu-ucs&gt;	العلامة &amp; lt؛ 1993Apr4.221228.17577@bsu-ucs&amp;gt.
kuzatilishi	يمكن عزوها
ovoz&gt;	وGT.
to&#39;laqonli	كامل
ohista	بهدوء
gapning	جملة
odamlarga	الشعب
(liscened	(Liscened
endi	الآن
ko&#39;rikdan	فحص
o&#39;ynaymiz.	اللعب.
Ayniqsa	خاصة
tilaymiz!	حظا سعيدا!
oy,	شهر
tezlikda	سرعة
ULARNING&gt;	DA &amp; GT؛
raqamini	عدد
rivojlanishi	تنمية
tizimli&gt;	الهيكلية وGT.
Bo&#39;ron	عاصفة
(Gordon	(جوردون
(510)	(510)
o&#39;tib&gt;	صالون &amp; GT؛
so&#39;radi.	سأل.
&quot;kasallik	على &amp; quot؛ المرض
Rechargeable	القابلة لإعادة الشحن
Scandinavians	الدول الاسكندنافية
astronom,	الفلكي،
qismi	جزء
kerakki,	وتجدر الإشارة إلى أنه،
cho&#39;ponlik	يرعى
uchib	طيران
rost»,	صحيح،
farqli	خلافا ل
&quot;rag&#39;batlantirish&quot;	على &amp; quot؛ التحفيز ومثل؛
qolish!	البقاء!
astein@israel.nysernet.org	html>
jismoniy	المادية
Qanday	كيف
qimmat	غالية
shifokorga	طبيب
Texnikaning&gt;	تكنيك &amp; GT؛
muvofiqligini	الامتثال
biridan	واحدة من
orbita	المدار
mehmon	ضيف
100,000	100،000
sobiq	سابق
so&#39;rashi	تطلب
xafa	قلب
Qachon	عندما
ko&#39;z	عين
ruxsatsiz	غير مصرح بها
Express	التعبير
o&#39;ziga	نفسه
unutmang.	لا ننسى.
singari	مثل
Infiniti	إنفينيتي
​​Masih	يسوع المسيح
aylanishlar	أوربت
o&#39;zga	آخر
izlaydi.	عرعر.
Rossiya	روسيا
kuyruklu	المذنب
metodlarni	تقنيات
Kim	الذي
bo&#39;rilar	الذئاب
sobit	ثابت
qilmadi.	فعل.
scott@asd.com	html>
(astronomik	(الفلكي
qilmadi,	لم أكن
sug&#39;urta	تأمين
Maqolada	مقالة
Maqola	مقالة
ishlashi	أداء
yangi	جديد
(Yuhanno	(يوحنا
tepasida	فوق
1-26	26/01
Kipling	كيبلينغ
aqldan	مجنون
&quot;sport&quot;	على &amp; quot؛ &amp; الرياضة مثل؛
mart,	مسيرة
etildi	كان
Qaerda	حيث
ko&#39;k	أزرق
omon	البقاء على قيد الحياة
starowl@rahul.net	html>
tasmasi	BAND
ko&#39;p	كثير
ma&#39;nolari	المعاني
avval	قبل
paradoks	المفارقة
surunkali	مزمن
so&#39;rash)	مطالبات)
zarurligini	الحاجة إلى
qisqa	باختصار
o&#39;zim	أنا نفسي
bo&#39;lgan	التي
4-savol,	Q4،
bozor	سوق
​​bir	واحد
ma&#39;qul	مقبول
qatra	قطرة
qozig&#39;ini	وتد
nisbiy	بالنسبة
yozuvlar	تسجيل
odamlarni	الناس
..:.:	..:.:
(Alan	(آلان
oqib,	تدفق
Gordon	جوردون
tufayli	نظرا ل
hodisaga	عادة،
qamariy	قمري
Mayk	ميكروفون
o&#39;zida	في
o&#39;zgaruvchan	متغير
reparented	reparented
ishonchli	موثوق
qilindi,	كان،
qilindi.	.
Benedikt	بنديكت السادس عشر
plitalarning	لوحات
Keyin	بعد
PB170	PB170
xalqining	الناس
marta	مرات
hamrohlik	مرافقة
(aprel	(أبريل
Infinity	لانهاية
M.)	M.)
kemiruvchilar	القوارض
out	خارج
Man,	الرجل،
(tez	(
«Xudo	&#39;الله
iyun	حزيران
yuboring.	إرسال.
betayin	الغرور،
to&#39;qnashuv	تصادم
Jo&#39;sh	اضطراب
yaxshiroq	أفضل
bir-yarim	نصف
Folta	فولتس
so&#39;z	كلمة
(bir	(A
yuqori.	عالية.
xalta	حقيبة
oq,	أبيض
katta,	عظيم
tajribasiga	تجربة
supurib	تمشيط
kasalman	مريض
katta.	عظيم.
yuqori,	عالية،
topdik.	تم العثور عليها.
qalqonsimon	درقي
(biz	(نحن
bep1@cbnewsg.cb.att.com	html>
silikat	السليكات
g&#39;alati	غريب
ishonchni	الثقة
qaramasdan	على الرغم من
Shoh	ملك
ko&#39;chib	خطوة
&lt;lsj4ruINNl7o@saltillo.cs.utexas.edu&gt;	العلامة &amp; lt؛ lsj4ruINNl7o@saltillo.cs.utexas.edu&amp;gt.
uning	له
majusiy	وثني
Reeves)	ريفز)
&#39;edi.	&quot;.
oldiga	ل
1-2	1-2
10,	10
Kor	كور
xususiyatlari	ملامح
yuqoridan	من فوق
sozlash	الإعدادات
Erog&#39;lu)	روث)
(Malcolm	(مالكولم
intollerent	intollerent
Jonson)	جونسون)
Havoriy	الرسول
Jonson,	جونسون،
Kou	كو
saing	قديس
keltira	جلب
oldida	بواسطة
tadqiqot.	البحث.
egalik.	الملكية.
100	100
joylarini	الأماكن
gapirib	يتحدث
o&#39;g&#39;illari&gt;	أبناء &amp; GT؛
qo&#39;ymaguncha	وضع
uchayotganda	طيران
Edmonton	ادمونتون
tosh,	الحجر،
faks	فاكس
Vica	فيكا
O&#39;g&#39;li&quot;	نجل ومثل؛
fan.	مروحة.
1/2	02/01
munozarasi	حديث
tabib	طبيب
Elektron	إلكتروني
tarqatish	التوزيع
old	الجبهة
xarajatlarni	نفقات
odamlarda	الناس
oldik.	وصلنا.
yashash	المعيشة
&quot;jargonu&quot;	على &amp; quot؛ &amp; مثل المصطلحات.
on-line	على الخط
clueless	جاهل
Pichoq	سكين
ma&#39;nosidir.	معنى.
(Gary	(غاري
yuboraman.	إرسال.
sezgir	حساس
qo&#39;rqdilar	يخاف من
deydi:&gt;&gt;	وقال: &amp; GT؛ &amp; GT؛
Adams)	آدامز)
ko&#39;tarilgan	ارتفاع
yaqinmiz	أقرب
tutashuv	دائرة كهربائية
harorati	درجة الحرارة
Tiff	شجار
Bernard)	برنار)
global	عالمي
_National	_National
keyin	بعد
MIniVas	MIniVas
to&#39;rt	أربعة
muhosaba	مقبولة
yuziga	وجه
Onadan	الأم
o&#39;ldiradilar	قتل
ona	أم
Bures	بوريش
Iyun	حزيران
tushish	ركود
&quot;T&quot;	على &amp; quot؛ T &amp; مثل؛
assult	Assouline
tushundim	وأنا أفهم
sotib	شراء
Mart	مسيرة
Mars	المريخ
aslida&gt;	كولينز &amp; GT؛
yo&#39;nalish	اتجاه
minib	ركوب الخيل
uchta	ثلاثة
hunarmandchilik	الحرف
Blomberg	بلومبرغ
1,1	1.1
vakolatli	مخول
Mark	علامة
eng.	.
indeksi	مؤشر
kelmagan,	ليس
infrastrukturaning	البنى التحتية
yuzida	أرض
1,3	1.3
o&#39;rta-1993	منتصف عام 1993
faol	نشط
tvtwm	tvtwm
asoslarini	أساسيات
rad.	رفض.
yozadi:	كتب ما يلي:
saqlab	حفظ
harorat,	درجة الحرارة،
sug&#39;urib	تمزق
rag&#39;batlantirish	ترويج
muvaffaqiyat	نجاح
GIF,	GIF،
gacha	حتى
Saturnning	زحل
ko&#39;ra.	.
rad)	RED)
ko&#39;ra,	وفقا ل
qat&#39;iy	صارم
yozadi.	يكتب.
uchun	إلى
o&#39;tkir	حاد
stargazers	مراقبوا النجوم
ExposureMask	ExposureMask
bilasizmi?	هل تعلم؟
shakllantirish	تشكيل
atmosfera,	الغلاف الجوي،
egasining	المالك
inson	بشري
Chunki	لأن
alomatlar.	الأعراض.
adovat	عداء
Timo&#39;tiyga	الثيموثية عشب
hajmining	حجم
Uning	له
(hollar	(الحالات
(38,8	(38.8
ranglar	الألوان
ob&#39;ekt	موضوع
Neal	نيل
bahor	ربيع
aytish.	أقول.
boshqarish	إدارة
aytish,	أقول،
Kanadaliklar:	الكنديين:
Suriya	سوريا
faxr	كبرياء
vshield	vshield
ular&gt;	وGT.
joylarda	الأماكن
iconified	iconified
...	...
So&#39;ngra,	ثم،
Fang)	فانغ)
Neptunning	نبتون
Ana,	وهذا هو،
Eurosport	يوروسبورت
..:	..:
sotib&quot;	ومثل؛
Midwest	الغرب الأوسط
Cipriani)	تشبرياني)
joylarga	الأماكن
o&#39;tkazish	انتقال
kasal	مريض
o&#39;rtasida	بين
ta&#39;kidlanadi.	أشار.
jargon	رطانة
Rabbiyning	الرب
Nea.	وكالة الطاقة النووية.
qo&#39;ltiq	إبط
Word	كلمة
aytishi	قول
*&gt;	* &amp; طن.
jinsdoshlarini	LGBT
&quot;Siz&quot;	على &amp; quot؛ أنت ومثل؛
qo&#39;shing.	إضافة.
osmonni	السماء
jirkanch	مقرف
loyqa	موحل
Qonunda	القانون
jihatidan,	من ناحية،
organlarining	جثث
biladi	من يدري
Larri	لاري
so&#39;ng,	بعد
surib	جانبا
inkor.	نفى.
bermaydi	لا
oozed	أووزيد
yashayman.	م.
qilganlar	أولئك الذين
xokkey,	الهوكي،
so&#39;ng.	ثم.
sudlanuvchi)	أفضل الممارسات البيئية)
ortiq,	أكثر من
kompyuter	كمبيوتر
qilinganidan	كان
hissa	إسهام
tushing	اذهب الى الأسفل
belgilash	تقرير
tashqariga	خارج
jumladan,	بما في ذلك،
menga.	لي.
terminal	محطة
Marokash,	المغرب
yonga	رقاقة
tana	لحم
kasallik	مرض
kınanması	الشجب
yetarlicha	كاف
bo&#39;lish&gt;	وGT.
o&#39;tirgan	الجلوس
osmon	سماء
etagida	على مشارف
Cloud	سحابة
belgilari	علامات
sarflayapsiz,	إنفاق
Nega	لماذا
qanchadan-qancha	كم عدد
batafsil	شامل
balandliklardan	ارتفاعات
States	الدول
bo&#39;lganlarga	أولئك الذين
tushunmadilar.	فهم.
-Karl	كارس
o&#39;xshaydi	على غرار
Bilaman)	وأنا أعلم)
qirish	السطوح
(hammasi	(جميع
kuchi	قوة
(kamida	(ما لا يقل عن
Skeptitsizm	الشك
Natijada,	ونتيجة لذلك،
Brendan	بريندان
qilamiz.	.
zichroq	أكثر كثافة
o&#39;qimagan	أمي
yoshgacha	سنوات من العمر
Consulting,	الاستشارات
&lt;15464@optilink.COM&gt;	العلامة &amp; lt؛ 15464@optilink.COM&amp;gt.
farq	فرق
lekin&gt;	ولكن وGT.
deydi:&gt;	وقال: &amp; GT؛
to&#39;qson	تسعون
Kun	يوم
eshitish	سمع
HELP:	HELP:
ixtiloflar,	خلافات،
Kaldis	KALDILDI
Mariner	بحار
tasvir	صورة
tashqarida	خارج
yordam!	مساعدة!
dastani	SAP،
tadqiqotlarning	بحث
rangli	غني بالألوان
bemorlarni&gt;	المرضى وGT.
sex&quot;.	الجنس ومثل؛
«kasalliklar	أمراض
o&#39;ylaydi.	أعتقد.
Qiladi	سوف
yordam,	مساعدة
xabardor	علم
yuzi	وجه
kashf	اكتشف
qismlar,	أجزاء
Miranda	ميراندا
tark	ترك
jamoat	جمهور
emasman&gt;	أنا &amp; GT؛
beraman.	وسوف.
kuz	تقع
tomosha&gt;	مشاهدة &amp; GT؛
kun	يوم
tashxis	التشخيص
yonilg&#39;i	نقد
oshirilmoqda	يجري
miloddan	BC
kriptoanaliz,	تحليل الشفرات،
mls@panix.com	html>
holda	حالة
bukilib-bukilib,	الساقين،
ketgan,	،
Lee	لي
tarqatib,	انحلال
odamlar	الناس
chizig&#39;i	خط
joy&gt;	وGT.
qo&#39;llanilishi	تطبيقي
bir&gt;	و&amp; GT؛
sog&#39;liqni	الصحة
qilib&gt;	وGT.
tavakkal	خطر
virtual	واقعي
haqda	حول
bo&#39;lishi:&gt;&gt;	: &amp; GT؛ &amp; GT؛
England	إنجلترا
Thorson)	Thorson)
Shapiro)	شابيرو)
tugmalaridan	أزرار
(Haqiqat)	(الحقيقة)
loyiq	مستحق
Bounce	وثب
alomatlar	الأعراض
gomoseksualistlar,	مثليون جنسيا،
Dr.Banzai	Dr.Banzai
ohangini	نغمة
(0,0)	(0،0)
........	........
muassasada	مؤسسة
Support)	الدعم)
relizlar),	الإفراج)
restart	إعادة تشغيل
MDs	حركة الديمقراطيين الاشتراكيين
kerak.	.
hunarmandlikni	الحرف
kerak,	،
qismlari	أجزاء
.45	0.45
Vodorod	هيدروجين
dbd@icf.hrb.com	html>
klavishlar	اختصارات
afzal	بالأحرى
Aviatsiya	طيران
kodini	رمز
yakka	وحيد
metan,	الميثان،
kerak?	تحتاج؟
1-800-344-4539.	1-800-344-4539.
bozorlarida	الأسواق
kerak;	؛
metall	معدن
400&gt;	400 &amp; GT؛
MC)	MC)
ustalari	الماجستير
maslahatlashing	تشاور
Foydalanish	استخدام
sekundiga	ثانيا،
Rubin)	روبين)
yuksaltirish	ترقيات
Qonunga	القانون
FJ1200&gt;	FJ1200 &amp; GT؛
holat	حالة
axloq&quot;.	أخلاقيات ومثل؛
argument	حجة
demadi-ku	لم يكن لدينا
X11R5	X11R5
X11R4	X11R4
fikrdamiz.	أقترح.
amaldagi&quot;	تيار &amp; مثل؛
qilinishi.	.
alüminyumdan	الألومنيوم،
olganda,	عندما
elektr	كهربائي
yo&#39;ldoshlar	زميل
filtri	مرشح
miqyosda	نقيب
kmac@cisco.com	html>
laboratoriya	مختبر
o&#39;laroq,	في المقابل،
(ning&gt;	(&amp; طن.
hal@cco.caltech.edu	html>
amerikaliklar	الأميركيون
tartibi	الإجراء ل
osondir.	من السهل.
sohalari	المجالات
dept.	قسم.
topdingiz.	الاسترخاء.
(aytaylik,	(على سبيل المثال،
shubhali	مشكوك فيه
minnatdor.	التقدير.
olgandan	تلقي
minnatdor,	تقدير
8000	8000
Kometa	المذنب
kelmaymiz,	لا
joshuaf@yang.earlham.edu	html>
Kashshoflar	الرواد
fayl	ملف
SETVER.EXE	SETVER.EXE
&quot;o&#39;sha	على &amp; quot؛
munns@cae.wisc.edu	html>
istayman	وأود أن
Model	نموذج
e-mail	البريد الإلكتروني
IMHO	IMHO
maydonida	مربع
qochish,	الهروب،
Marsda	المريخ
xususiyatlari;	ملامح؛
ro&#39;yobga	تحقيق
Steve.Shapiro@f440.n101.z1.fidonet.org	html>
Brenner)	برينر)
Fransiya	فرنسا
yillarning	سنوات
sotiladi	ستباع
Siemon	Siemon
xususiyatlari.	الميزات.
xususiyatlari,	ملامح
qismlar	أجزاء
pop&quot;.	البوب ​​ومثل؛
parchalanib	انهيار
uskunalar	معدات
&quot;qismiga	على &amp; quot؛
Isoning)	يسوع)
XR250L	XR250L
Andreas	أندرياس
Asteroitler	الكويكبات
kelishi	سبب
kelsa,	يأتي،
Lo!	لو!
(Xuan	(خوان
Terra	تيرا
ro&#39;yxat	قائمة
Mormonizm	المورمونية
statik	ساكن
Luis&gt;	لويس &amp; GT؛
loy	طين
albatta,	وبطبيعة الحال،
miltiq	بندقية
albatta.	بالطبع.
Patricia	باتريشيا
&quot;tizimli&quot;	على &amp; quot؛ النظامية ومثل؛
arzimas	خردة
Terrorizmga	إرهاب
ro&#39;y	حدث
futbolchi.	لاعب.
yilda&gt;&gt;	وGT؛ &amp; GT؛
berasiz.	هل أنت الغريب.
p.s.	سكرتير خاص
Olimlar	العلماء
xamirturush	خميرة
boshladi	التي
(Uzr,	(عذرا،
formuladan	صيغة
&lt;Apr.9.01.09.22.1993.16580@athos.rutgers.edu&gt;	العلامة &amp; lt؛ Apr.9.01.09.22.1993.16580@athos.rutgers.edu&amp;gt.
ahmoq	مجنون
baham	حصة
havo-paket	كيس الهواء
Ulardan&gt;	وطن.
o&#39;ldirilgan	قتل
Yapon	اليابانية
atsetilen,	الأسيتيلين،
reboot	تمهيد
holatlardan	المسائل
original	أصلي
torre	توري
yomon	سيئة
nissan	نيسان
bo&#39;lishidir.	هو.
albatta?	حقا؟
o&#39;xshashliklar	التشابه
qilishi	إلى
ko&#39;rinmaydi	خفي
Missiya,	مهمة
Cisco	سيسكو
axborot	معلومات
qilish]	]
Lin	لين
qulfni	فتح
Salom,	مرحبا،
bo&#39;lishi	أن تكون
brauzer	المتصفح
Voizlik&gt;	الحقل وGT.
Korenek	Korenek
(Ryan	(ريان
maydoniga	مربع
southeners	southeners
_ARE_	_ARE_
chekka	هامشي
vulqonlardan	البراكين
foizi:&gt;&gt;	٪: &amp; GT؛ &amp; GT؛
ehtimol,	ربما
inson,	الإنسان،
qurollar	أسلحة
orbitasining	مدار
bezatilgan.	زينت.
192.100.81.100	html>
Marsga	المريخ
qilish.	.
3&quot;,	3 ومثل،،
qilish,	إلى
derazalar	نوافذ
lmh@juliet.caltech.edu	html>
sehr	سحر
bo&#39;lish.	.
endi,	الآن،
nuqtasi	نقطة
yükseltici	مكبر للصوت
teleskopik	تلسكوبي
emaslikda	ليست
federal	الاتحادية
Davis	ديفيس
Internet:	الإنترنت:
sayyoramizga	كوكب
Aniq	واضح
yetib.	تم التوصل إليها.
repopulation	إعادة تعمير
Axir,	بعد كل شيء،
futbolchi	اللاعبين
Mail:	البريد الإلكتروني:
ta&#39;sirida	تحت تأثير
bo&#39;lish,	،
lsa	ومن المقرر
o&#39;rash	حزم
David	ديفيد
ehtimoli	إمكانية
Dekabr	كانون الاول
(starowl@a2i.rahul.net)	(Starowl@a2i.rahul.net)
(iltimos	(الرجاء
oshirish,	زيادة
orangizda	بين
og&#39;irligi,	الوزن،
kabi,&gt;	وGT.
tushuntirish	تفسير
Planetoloji	النظام الكواكب
PCX,	PCX،
aloqa	صلة
Orqaga&quot;	الظهر ومثل؛
???	؟؟؟
tabib&quot;	الطبيب ومثل؛
(Yordam!)	(مساعدة!)
zamburug&#39;li	الفطرية
5-7)	5-7)
saxiy	سخي
ta&#39;sirini	تأثير
turing,	عقد
&lt;May.7.01.08.16.1993.14381@athos.rutgers.edu&gt;	العلامة &amp; lt؛ May.7.01.08.16.1993.14381@athos.rutgers.edu&amp;gt.
havoriylar,	الرسل،
ishonchliligi	الموثوقية
sel,	الفيضانات،
Yuhanno	جون
yuki	عبء
Pitsburg	بيتسبرغ
Prism	موشور
baho	تقدير
&quot;Buy	على &amp; quot؛ شراء
muzliklarning:	الأنهار الجليدية:
(225	(225
Things	أشياء
osmonda	السماء
qarsillamoq	ن
sizlarga	أنت
Albatta	قطعا
Beyond,	بعدها،
yaratilgan	خلق
kishining	رجل
endi.	الآن.
NatLamp	NatLamp
Bucky	بوكي
jinsi	جنس
holda,	،
shafoatga	شفاعة
parametrlarini	المعلمات
uy-o&#39;lchamli	حجم الأسرة
5-6.	5-6.
zo&#39;rg&#39;a	بالكاد
N81	N81
holda)	)
Canaveral	كانافيرال
port	ميناء
qilmasa,	لا
faxrlanamiz	نحن فخورون
...&gt;	... وطن.
shahzoda	أمير
shish.	الورم.
gaplashib	الحديث
yopishqoq	لزج
orbital	مداري
safar	مرة
muomalasi	التداول
bemorlarni	المرضى
Yo&#39;lovchilardan	الركاب
bajo	الوفاء
gazsimon	غازي
deb).	).
post	بعد
(Life	(الحياة
yaqinda	مؤخرا
shisha	زجاج
(g&#39;arbiy	(الغربية
m-it2691@DOC.CS.NYU.EDU	html>
ekansiz	إذا كنت
chiziqlarga	المماس
bozorida	سوق
qarang.	نرى.
seni	أنت
NASA,	وكالة ناسا
fotosuratlarni	الصور
(quyosh	(إن الشمس
er-xotin	زوج
Nima?	ماذا؟
xayriya.	جمعية خيرية.
sirlarini	أسرار
sent	سنتا
Roman	رواية
Nima,	ما
---------------------------&gt;	--------------------------- وطن.
bilaman.	وأنا أعلم.
folta@well.sf.ca.us	html>
&quot;munosib	على &amp; quot؛ من المرجح
O&#39;liklar	ميت
pedalına,	دواسة،
bepusht	قاحل
Landmann)	Landmann)
bilan,	مع
bilan.	.
bilaman,	وأنا أعلم،
Falastinda,	فلسطين
yozishni,	الكتابة،
symbolisms	Symbolisme
(Blez	(بليز
bilan)	)
TIDSA	Tidser
dentin	عاج
Triton	تريتون نصف إله عند الإغريق
kuchining	كورف
o&#39;ylaysiz?	رأيك؟
koordinatalarini	الإحداثيات
Pan-Evropa	لعموم أوروبا
1742a	1742
&quot;standart&quot;	على &amp; quot؛ ستاندرد اند مثل؛
soluvchi	محطم
muhtoj	حاجة
intizom	انضباط
ikkala,	اثنين،
jilo	حساسية
Masihiylar	المسيحيين
Loc	لوك
Aylend	رود ايلاند
bo&#39;ladi;&gt;	؛ &amp; GT؛
===================================	===================================
(800)	(800)
beqaror	غير مستقر
standart,	المعيار،
umumiy	عام
Magellan	ماجلان
kulgili.	مضحك.
o&#39;ynashga	لعب
CHARON	كارون
karta	بطاقة
manbalarini	مصادر
millionlab	ملايين
welshed	welshed
dalgalıdır	متموج
boshlab,	من
Schaufenbuel)	Schaufenbuel)
dushmanlari	الأعداء
suiiste&#39;mol	إساءة
qaytmoqda,	يتجمد،
LM350T	LM350T
nomlangan	دعا
hisobidan	نفقة
yo&#39;lini	الطريق
randomize	العشوائية،
ishonaman,	أعتقد،
manbaidir	مصدر
bo&#39;lish	أن تكون
tizim	نظام
beruvchi	صاحب العمل
ishonaman.	أعتقد ذلك.
qarshilik	معارضة
o&#39;ylardim	ظننت
turdagi)	أنواع)
murakkabligi	تعقيد
taklif	اقتراح
Va&#39;zi	خطب
qilyapsan,	فعل
qilyapsan.	به.
voltgacha	فولت
temir-boy	الغنية بالحديد
18EB	18EB
(Norvegiya)	(النرويج)
&gt;,	وطن،،
o&#39;rnatilgan,	مونتي،
nuqtaga	نقطة
kamtarlik	تواضع
qilyapsiz»,	القيام &#39;
amin	بالتأكيد
Postbus	Postbus
shaxsi	شخصية
qasam	يمين
ommaviy	كتلة
&quot;hal	على &amp; quot؛
tariflanadi.	تهمة.
{uunet,	{UUNET
qulay	مريح
Chiqish	خروج
bug&#39;ining	بخار
ateizm	الإلحاد
fortay	قلعة
bayon	وأوضح
hayotimda	حياة
-km	-km
///	///
Boshlovchi	سلوك
Musoning	موسى
MC05A	MC05A
.signature	.signature
(keyingi	(التالي
vaziyat	ظروف
mag	المجموعة الاستشارية للألغام
Rind	قشرة
aylanish	تناوب
kutib	لقاء
bilingki	تعرف
River	نهر
man	رجل
oyoqlari	الساقين
qaytishingiz	عودة
bemorning	المريض
(Billy	(بيلي
etiladi	ومن
chiqarilishi	إنتاج
shaxsiy-kompyuter	الحواسيب الشخصية
g&#39;ildirak	عجلة
etamiz.	العرض.
izsiz	Bosham
modomiki	طالما
nosimmetrikliklar&gt;	المخالفات و GT.
tezligini	سرعة
Matt&gt;	مات &amp; GT؛
hizmatkorlari)	عمال النظام)
10--	10--
Xonda	هوندا
gt4417a@prism.gatech.edu	html>
gravitatsiyaviy	بنطلون الجينز
MWm	MWM
mavjudligining	وجود
o&#39;likdan	الموتى
Saturn	زحل
aytaman,	أقول،
nuqtada	نقطة
eshitdim.	سمعت.
tushiradi.	النقصان.
Borland	بورلاند
marta,	مرة واحدة،
Expo	المعرض
tahlil	تحليل
marta.	مرات.
generatorlari,	المولدات الكهربائية،
qochqinlar	اللاجئين
tashqari,	بالإضافة إلى ذلك،
tashqari)	)
Terminal	محطة
niyatlarda	الدوافع
nomimdan	نيابة
&quot;kaltaklashdi&quot;	على &amp; quot؛ فاز ومثل؛
ammo	لكن
oylik.	الشهر.
gapiryapsiz&gt;	الحديث و GT.
(yangilash):	(تحديث):
yoshda	سنوات
elektromexanik	الكهروميكانيكية
**************************************************	**************************************************
bilaman	وأنا أعلم
EISA	EISA
Xato	خطأ
(Qanday	(كيف
vahiy	كشف
organlari,	الهيئات
harakatlanish	الانتقال السريع ل
Gregory	غريغوري
-------------------------------------------------	-------------------------------------------------
qorong&#39;u,	الظلام،
(Elaine	(إلين
fotoelektrik	كهرضوئي كهربائي ضوئي
hünirini	احتيال
o&#39;limi	الموت
inobatga	النظر في
datchiklari	أجهزة الاستشعار
men	أنا
mezbon	مضيف
topmasangiz	لا يمكنك العثور على
marta)	مرات)
parallel	مواز
savollarga	الأسئلة
oxirgi	آخر
qoyaga	صخرة
ketish	رحيل
signallari	إشارات
dunyoviy	علماني
yana))	مرة أخرى))
kometalar,	المذنبات،
amaliyot&gt;	ممارسة &amp; GT؛
___________________	___________________
so&#39;rovda	مسح
erishish	تحقيق
ammo&gt;	ولكن وGT.
o&#39;lim.	الموت.
lmh@shakes.caltech.edu	html>
chips,	رقائق،
va&#39;dalari	وعود
Joshuaf	جوشوا
ko&#39;ylak,	قميص
maqsad	الهدف
bitimi	صفقة
xotin	الزوج
kuzatilgan.	لوحظ.
qora,	أسود
Men	أنا
23:17:25	23:17:25
go&#39;yo	كما
Cl056@cleveland.Freenet.Edu	html>
&lt;pgf.735012282@srl03.cacs.usl.edu&gt;	العلامة &amp; lt؛ pgf.735012282@srl03.cacs.usl.edu&amp;gt.
Great	عظيم
dileriga	التجزئة
sahobaning	رفيق
Sizchi?	هل؟
Meg	ميج
yashamadi.	يعيش.
qo&#39;shimcha	إضافي
pokiza	تصرف بطريقة صحيحة
sayyoramizni	كوكب
suratlarni	الصور
Shamol	رياح
NHL	NHL
bu&gt;	وGT.
sattellite	sattellite
kuponlar	كوبونات
qo&#39;shish	إضافة
Toronto	تورونتو
«barcha	&#39;جميع
lozim	ينبغي
o&#39;qituvchi,	المعلم،
kirishlar&gt;	المدخلات وGT.
Mariners	البحارة
an&#39;analarini	تقاليد
kanallari	القنوات
Future	مستقبل
saçmalýklarý	هراء
EUROPA	EUROPA
Parsli	قسيس بروتستانتي
sayyora,	الكوكب،
davlat.	الدولة.
sayyora.	الكوكب.
Guthrie	غوثري
bo&#39;lmasa	ليس
ateist	الملحد
haqida	حول
halqalarni	خواتم
Windows	نوافذ
rejalashtirilgan	المخطط
tashish	نقل
kirishlar	المدخلات
davolash,	علاج
(tovarlar	(السلع
biologik	بيولوجي
ob&#39;ektlarini	الأجسام
bo&#39;limi	قسم
davolash)	العلاج)
so&#39;raysizlar	تطلب
tugmalari	أزرار
bankrot	مفلس
qolmoqda.	لا يزال قائما.
cliffs	المنحدرات
Williams	ويليامز
individual	فرد
albatta	قطعا
SMARTDRV.EXE	SMARTDRV.EXE
o&#39;qing.	قراءة المزيد.
yadrolari	النوى
Greg,	جريج،
^^^^^^^^^^^^^^^^^^^^^^^^^^^^^	^^^^^^^^^^^^^^^^^^^^^^^^^^^^^
etadi	العروض
yordamni	العلاجات
olib	خارج
km@cs.pitt.edu	html>
Kevin	كيفن
ko&#39;rsatadi	عروض
tezlik	سرعة
missiyalari,	البعثات
Man	رجل
amerikalik	أمريكي
Mariner,	بحار
Misol	مثال
NCI	NCI
etiladi)	)
shakllantirish,	تشكيل
Mac	ماك
tajribalar	تجارب
etiladi,	هو،
versiya	رأي
plakat	الملصق
etiladi.	.
va&#39;dalari&gt;	كلمات &amp; GT؛
o&#39;tmish	الماضي
uzatadi	ينقل
Xristianlikni	مسيحية
elementlar	عناصر
Pastda	أقل من
rls@uihepa.hep.uiuc.edu	html>
to&#39;g&#39;ri,	الحق،
Klaviaturadan,	لوحة المفاتيح،
qoldirardi.	السماح.
o&#39;tmay	قريبا
anti-kun	معاداة أيام
May	مايو
kelajak	مستقبل
faraz&gt;	على افتراض &amp; GT؛
boshlash	استهلال
tushunmadim.	أنا لا أفهم.
ethan@cs.columbia.edu	html>
olim	عالم
NET	NET
kishilarga	الناس
saqlanishi	تخزين
olis	بعيد
shamollarni	الرياح
apelsin	البرتقالي
(Benedikt	(بنديكت السادس عشر
muayyan	مؤكد
[insoniyat]	[الإنسان]
oliy	سامي
qondirish.	الارتياح.
so&#39;nggi,	آخر
o&#39;liklarni	الموتى
qolish	إقامة
tarbiyachimiz	مدرس
hokimiyat	سلطات
ushlab,	،
--------------------------------------------------	--------------------------------------------------
va&gt;	و &amp; GT؛
shahrida	مدينة
jamoalarning	فرق
shack	كوخ
&gt;&gt;&gt;&gt;&gt;	وطن؛ &amp; GT؛ &amp; GT؛ &amp; GT؛ &amp; GT؛
yopish	إغلاق
faoliyat	نشاط
o&#39;lim	الموت
o&#39;lik	ميت
bo&#39;ylab	على طول
1970	1970
Kirish	مساهمة
xursandman	ويسعدني
ichida:	في:
1971	1971
doirada	وفقا لذلك،
qaror	قرار
1972	1972
1973	1973
1974	1974
1975	1975
(Re:	(إعادة:
1976	1976
birovga	شخص ما
1977	1977
1978	1978
1979	1979
ichida)	)
yashirincha	سرا
Instruments	أدوات
C.O.D.	الدفع عندالتسليم
chuqurga	حفرة
_____________________________________________________________________	_____________________________________________________________________
o&#39;rgandim.	تعلمت.
-&gt;&gt;	- وطن؛ &amp; GT؛
aralashmalar	المركبات
1990	1990
alyoung@kiwi.ucs	alyoung@kiwi.ucs
ko&#39;rinish	رأي
mol	بضائع
mamlakatlarida	الدول
1983	1983
1980	1980
1981	1981
shifokor	طبيب
1986	1986
boshchiligidagi,	ذو رأس
mos	مناسب
1984	1984
1985	1985
486/33	486/33
1989	1989
achingan	يشفق
Xiroshi	هيروشي
muvaffaqiyatsiz	غير ناجح
Aprel	نيسان
judayam	أيضا
qayd	ذكر
(Red	(الأحمر
Ammo	لكن
(HAWK	(HAWK
masallar	الأمثال
davosi	علاج
sovuq	برد
«xolis»	&quot;المحايدة&quot;
1995	1995
o&#39;zgarish	تغيير
boshqaruvchiName)	مدير)
1991	1991
diametri	في قطر
bedavo	عضال
1992	1992
1993	1993
LM350K:	LM350K:
haydovchilar-litsenziya	رخصة القيادة
1994	1994
bilmasdim.	لم أكن أعرف.
armiya	جيش
1999	1999
|&gt;	| &amp; طن.
birodarim	شقيق
uzoqdan	بعيد
Yordam:	مساعدة:
xunasa	مثلي الجنس
xavfsizlik&quot;	الأمانة و مثل؛
Qabul	قبلت
ZENON	ZENON
telefonni	هاتف
Note	مذكرة
kerakmi?	؟
Javoblar.	إجابات.
davom	استمرار
Alicea,	Alicelik
o&#39;lib	يموت
3:31	03:31
shahridagi	مدينة
&lt;1993Apr22.153000.1@vms.ocom.okstate.edu&gt;&gt;	العلامة &amp; lt؛ 1993Apr22.153000.1@vms.ocom.okstate.edu&amp;gt؛ &amp; GT؛
Mount	جبل
dushman&gt;	دش وGT.
instituti	معهد
kislotalar	الأحماض
------------------------------------------	------------------------------------------
(360	(360
hamohang	تزامن
hujayralar	الخلايا
MacRae	ماكراي
irodasi	موجه،
bordik)	التشيكية)
viloyatida	منطقة
emas&gt;	وGT.
mamlakatlariga	الدول
hududga	حسب المنطقة
Gazlar	الغازات
bo&#39;lsangiz.	إذا.
&lt;thomasp@ifi.uio.no&gt;	العلامة &amp; lt؛ thomasp@ifi.uio.no&amp;gt.
bo&#39;lsangiz,	إذا
yo&#39;qolib	اختفاء
ulamolar	الطابعات،
carl_f_hoffman@cup.portal.com	html>
uyiga	المنزل
Quyoshdan	الشمس
qoidalari	قواعد
jodfishe@silver.ucs.indiana.edu	html>
shapiro@sofbas.enet.dec.com	html>
&quot;biznes&quot;	على &amp; quot؛ &amp; مثل؛
unsurlar	العناصر
Fotokimya	Fotokimya
dushmanlik&quot;	ومعادية مثل؛
bajarilishi	تنفيذ
o&#39;quvchilar	طلاب
jinoyatlar	جرائم
O&#39;qish	قراءة
davri	فترة
zararli	مضر
rejalashtirish	تخطيط
Observer	مراقب
qaytadi	عائدات
komissiya	لجنة
vodorod	هيدروجين
masalasidir	مسألة
ziyorat	زيارة
arziydi.	يستحق.
Kawaguchi,	الوزيرة،
Bell-Shimoliy	جرس الشمالية
Jamoatning	الكنيسة
....&gt;	... وطن.
masofalarga,	بعد،
nazariyasi	نظرية
Hizqiyo)	حزقيال)
-----------------------------	-----------------------------
(Larry	(لاري
kibr	غطرسة
Steve.	ستيف.
yulduzlar,	النجوم
bo&#39;lib,	،
jumladan	بما فيه
uzoqdagi	بعيد
Diffie-Hellman,	ديفي هيلمان
slegge@kean.ucs.mun.ca	html>
talqin	تفسير
suratlar	الصور
NASA	وكالة ناسا
tayyorlash,&gt;	التدريب وGT.
sharafini	شرف
ularni,	لهم،
muz	جليد
Evolution	تطور
joylari	الأماكن
xulosa	ملخص
qadimiy	عتيق الزي
taqdir	مصير
ota-)	أمي)
sotish,	مبيعات،
amal	تابع
yotipti	هذا
Uranian	أورانيا
Ctrl-Alt-Del	السيطرة، البديل، ديل
asboblari	الأجهزة
shakl	شكل
erkinlik	حرية
taqdim	المقدمة
turli,	مختلفة،
retrograd	رجعي
behuda,	عبثا،
va.&quot;	. ومثل؛
(323	(323
mahsulot	نتاج
Hatto	حتى
tarqalgan	مشترك
joylarni	الأماكن
ta&#39;siri	تأثير
jamiyatda	مجتمع
Kou)	كو)
Ariel,	ارييل،
materiallar.	المواد.
====================================	====================================
bo&#39;lmasa,	على الأقل،
tarix	تاريخ
(Earth	(الأرض
sodda	بدائي
o&#39;lsa	يموت
yuguruvchi	عداء
CHIPS	شيبس
qiyin.	صعوبة.
Steven	ستيفن
tushunmayman.	أنا لا أفهم.
tark.	ترك.
theists	الخروج من الملة
og&#39;rig&#39;i	صداع
5,25	5.25
turli?	مختلفة؟
Nicji,	Nicji
qiyin,	من الصعب،
-dk	-dk
kino	فيلم
shama	الضمنية
kelishidan	وصول
axloqsiz	غير أخلاقي
Xudoning	الله
My,	لي
go&#39;zallik	الجمال
»(yo&#39;q	(لا يوجد
ta&#39;sir,	تؤثر
yordamisiz	دون مساعدة
yakshanba	يوم الأحد
Vulkanizm	البركاني
matnlari	النصوص
berildi,	معطى
yakuniy	أقصى
mil	مغزل
vertikal	عمودي
almashtirish	استبدل
cho&#39;kkan	كمبيوتر محمول
tarixga	تاريخ
adabiyotni	أدب
behuda.	عبثا.
chiroq,	مصباح،
yuqori	ارتفاع
(818)	(818)
O&#39;qisak	بقدر
tarixi.	التاريخ.
yahudiylar	اليهود،
andozalari	قوالب
masihiylarga:	المسيحيون:
iboralar	بيان
...&quot;	... &amp; قووت]؛
yo&#39;lida	في الطريق
qutulmoqchi	علاج
zichlikdagi	كثافة
tarixi,	التاريخ،
Crater	فوهة البركان
1938	1938
Mart&gt;	مسيرة &amp; GT؛
kim?	من؟
mls	MLS
chunki&gt;&gt;	وGT؛ &amp; GT؛
ma&#39;lumotlari	المعلومات
1930	في عام 1930
orziqib	إلى الأمام
birining	واحدة من
sodir	ملتزم
Masihiylikda	مسيحية
martin	مارتن
haqingizda	حول
bunday&gt;	وGT.
qo&#39;yadi	سوف
keldi,	،
keldi.	.
Isoga	يسوع
Gravitational	الجاذبية
1947	1947
1949	1949
1948	1948
Fine	غرامة
o&#39;nlab	عشرات
spekülasyon	من التكهنات
stantsiyalarda	محطات
Enterprise,	مشروع
kasallikning	المرض
sevganlar)	عشاق)
&quot;bemorlarning	على &amp; quot؛ المرضى
nusxa	نسخة
Mr.	سيد
aytilmoqda,	وقال،
sayyoralarning	الكواكب
kichik	صغير
sanoqsiz	لا يحصى
Technology	تكنولوجيا
1959	1959
1958	1958
tiklanadi	مرمم
bilan),	)
mototsikl	دراجة نارية
zaiflashishi	قطع
(xamirturush)	(الخميرة)
astronomik	فلكي
saytida	الموقع
qarab	تبعا ل
muhandis	مهندس
tekshiruvi	فاحص
osmondan	من السماء
qachon,	أبدا
qachon.	أبدا.
quloq	إذن
vaqtning	مرة
kamida	على الأقل
hisoblanadi&gt;	وGT.
Barry	باري
bo&#39;lishidan	في كل مكان
keldim	جئت
INFJ	INFJ
xatolar	أخطاء
===========================	===========================
1967	1967
1969	1969
1968	1968
chiqmaysiz,	أنا لا،
1962	1962
chiqmaysiz.	أنا لا.
1965	1965
birovni	شخص ما
1964	1964
kim,	الذين،
keldi:	:
kengaytmalari,	ملحقات
qarshi,	ضد
a&#39;zosi	عضو في
(Ray	(راي
INF)	INF)
qilmoqchiman.	أود أن.
qaramay	وعلى الرغم من
(310	(310
ketyapman,	وانا ذاهب الى
-----------------&gt;&quot;	----------------- وطن؛ &amp; مثل؛
rivojlangan.	المتقدمة.
qadimgi	القديمة
(&quot;zohiriy	(على &amp; quot؛ اضحة
