Fayllar	Files
yuzdan	one hundred
XR650L	XR650L
taklifni	proposal
(Erik	(Erik
&quot;bulut	&amp; Quot; cloud
535	535
rivojlantirish	development
Kosmosdan	Space
ruhoniylikni	priesthood
jet	jet
jilo,	Sensitivity
pochta	mail
orbitalar	Orbit
#	#
mehnat,	labor,
Guruhlar:	Groups:
James	James
noyabr	November
$	$
*	*
Yagona	Only
+	+
(Jon	(Jon
(	(
shimoliy-janubiy	north-south
)	)
accusors	accusors
&quot;bo&#39;sh	&amp; Quot; empty
Team	Team
.	.
RKBA	RKBA
/	/
,	,
mahbuslar	prisoners
-	-
natijasida,	As a result,
3	3
2	2
qaytdi	returned
1	1
7	7
6	6
5	5
odamni	man
4	4
:	:
9	9
8	8
&lt;94318@hydra.gatech.EDU&gt;	&amp; Lt; 94318@hydra.gatech.EDU&amp;gt;
ma&#39;no	meaning
Gauche	Gauche
=	=
spec	spec
D	D
Kickback	Kickback
Norvegiyada	Norway
muhitni	the environment
E	E
F	F
SetWUTime	SetWUTime
@	@
A	A
B	B
qo&#39;llaydi	supports
C	C
L	L
faoliyati&gt;,	&amp; gt ;,
tufayli,	because,
M	M
H	H
I	I
tufayli.	.
J	J
U	SHE IS
T	T
tarbiyalang.	Educate.
&quot;Men	&amp; Quot; I
(713)	(713)
Q	Q
S	S
R	R
(balki,	(But,
\	\
_	_
^	^
bosish	pressing
hukumat	government
X	X
qo&#39;lga	catch
1846	1846
ongli	conscious
mmm@cup.portal.com	html>
asboblarini	instruments
g	g
c	c
a	a
&lt;1r10jcINNt1g@lynx.unm.edu&gt;	&amp; Lt; 1r10jcINNt1g@lynx.unm.edu&amp;gt;
berilmaydi	not
yilda	In
tarkibda	squad
o	o
aholiga	the population
narxi	The price of
m	m
ixcham	compact
i	i
uchish	flight
w	w
v	v
u	she is
so&#39;zlashish,	talk
empirik&gt;	Experimental &amp; gt;
520	520
p	p
Stiv	Steve
~	~
qanotga	agent
|	|
x	x
yutuqlar	achievements
og&#39;irligi	weight
Wonder?	Wonder?
yoqdi	I liked
g&#39;arbiy	western
karakollardan	outposts
Melnick)	Melnick)
uzoq,	long,
shohlik	kingdom
&quot;ochiq&quot;,	&amp; Quot; open &amp; quot ;,
bosimi	pressure
muharriridan	regulators
JPEG,	JPEG,
qayta,	,
0.14	0.14
ocom.okstate.edu	html>
MAX641	MAX641
580	580
Adam	Adam
GIF	GIF
rahbar?	Leader?
583	583
tuproqli	earthed
va&#39;dalarining	promises
darajasi:	rate:
(__)	(__)
olishga,	from
haddan	excessive
&quot;vaqtinchalik	&amp; Quot; temporary
hisobot	reports
hududlarida,	areas,
ochiq.	free.
raqami:	number:
ochiq,	open,
XBell	XBEL
chiziladi	drawn
Quyosh,	Sun,
brigadasi	brigade
tufaylidir.	because of that.
559	559
muntazam	regular
hududlarida	regions
birga,	However,
yo&#39;qotish	loss
xabardordir	Aware of
Sugar	Sugar
kompaniyalari	companies
lpt1	lpt1
giyohvandlik	addiction
aytaylik	say,
o&#39;tadi.	will be.
materiallar	materials
va&#39;z.	preach.
aholining	the population
zaryadlangan	charged
xotirasida	memory,
bosing	Click
pgf@srl02.cacs.usl.edu|Like	pgf@srl02.cacs.usl.edu|Like
olingan.	.
ostida	below
kashshof,	pioneer,
Division	Division
boshchiligida	led by
sifatida	as
guys,	guys,
okean	ocean
yo&#39;nalishda	direction
yaqin	close
(Artur	(Arthur
kengligi	width
Tasco	Tasco
murojaatlarni	references
DR250ES	DR250ES
suhbatlashdi.	and talked.
murakkab	difficult
vesterman.	Western.
dinim	religion
maqtana	boast
&gt;&gt;	&amp; Gt; &amp; gt;
ichidagi	in
ildizlari,	roots,
muhitda	environment
zichligi	The density
diniy	religious
oqimining	the flow
ko&#39;rishadi.	see.
Payg&#39;ambar;	The prophet;
Detriot,	Detritus,
identifikatorlari,	IDs
bo&#39;limi&gt;	Care &amp; gt;
PATH	PATH
shunchaki	just
etilgan.	.
ma&#39;no,	meaning,
meni	me
hisobga	taking into
QURILMA	DEVICE
sirli	mysterious
termoq	Differential Equations
o&#39;rtacha	average
Falastinliklar	Palestinians
shubha.	no doubt.
sotuvchi	vendor
suyuq-suv	liquid water
og&#39;ir-qarab	heavy-looking
issiqxonada	greenhouse
orasida,	between
joy	place
tozalaydi,	clean,
tushunchasini	the concept
mumkin&gt;	&amp; gt;
qaytib	back
ma&#39;noda,	sense,
raqami	number
vakolatxonalar	Offices
bulutlar	clouds
Converter	Converter
integratsiya	integration
xil&gt;	&amp; gt;
internet:	internet:
kiradi	include
&quot;xamirturush	&amp; Quot; Yeast
bayon.	explained.
010-A	010-A
mustasno	exception
men,	I
dizaynlashtirilgan	designs
qilinadi	will be
majbur.	Required.
mahkum	condemned
4H7	4H7
falsafiy	philosophical
g&#39;arbga	westwards
eski	old
echilishi	Preface
indepth	indepth
sozlanmasi	Setup
1ff&gt;	1ff &amp; gt;
Bo&#39;lishi	To be
Hozirgi	Current
Quyoshga	The sun
eshik&quot;	door &amp; quot;
Tibbiyot	Medicine
NASAning	NASA
jip	CIP
boshlash)	Start)
mulk	property
bordik	We went
Neptune	Neptune
&quot;oq	&amp; Quot; white
ko&#39;tardi.	raised.
olmas.	far.
to&#39;g&#39;risida	regarding
tranfer	Mirren
qismlariga	components,
daqiqa.	minutes.
yo&#39;nalishi,	direction,
&quot;hislar&quot;	&amp; Quot; sense &amp; quot;
orolida,	On the island,
davrning	the period
DOUBLE_BUFFER	DOUBLE_BUFFER
500	500
&quot;muqobil&quot;	&amp; Quot; alternative &amp; quot;
hujayra	cell
--------------------------------------------	--------------------------------------------
12:26	12:26
Aslida,	Actually,
unumdor	productive
P.s.	P.s.
Edmond	Edmond
Iroq	Iraq
ta&#39;siridan	the effects of
tizmasiga	the axis
nusxasini	copy
mezbonlar	the hosts
ish.	business.
kludgy,	kludgy
cometa	Comet
kengaytirish	expansion
Neptun,	Neptun
drum	Drum
qopqoq	lid
5,7	5.7
kuzatuvchilar	observers
Stein)	Stein)
chaqirdi)	called)
5.0	5.0
namuna	sample
variantlari	options
1870	1870
mashinasini	the camera
^^^^^^^^^^^^^^^^^^^^^^^^^^^^^^^^^^^^^^^^^^^^^^^^^^	^^^^^^^^^^^^^^^^^^^^^^^^^^^^^^^^^^^^^^^^^^^^^^^^^^
763-5889	763-5889
Ro&#39;yxatdan	Register
berilmaydi,	not
avgust	August
3:&gt;	3: &amp; gt;
qiziqarli	interesting
qo&#39;l	hand
olasizmi,	Are
timmbake@mcl.ucsb.edu	html>
qilishga	to
olasizmi.	Are.
Window	Window
Kabolsuz	Kabolsuz
Cyrix	Pentium
aksincha	on the contrary
uchida	at the end of
maslahat	advice
va&#39;dasiga	the promise
olasizmi?	Are you?
xudosi	the god
olamlar	Worlds
arxeologiya	archeology
orollari	Islands
nashr	publication
16-169	16-169
jihatidan	In terms of
bazasi	The database
quyosh	sun
Deyarli	Almost
ulanish	connection
mavsumiy	seasonal
nazorati&quot;	control &amp; quot;
1ff,	1ff
tashvishlanib	to worry
mingdan	thousand
ilmiy-fantastik	science fiction
zahirasi	reserve
Etc	Etc
tushunib.	Explain.
pastga	down
yahudiylar&gt;	Jews &amp; gt;
qilishim	do
kontaktlar	Contacts
Cyric	Cyric
NUETZMAN	NUETZMAN
qamchilagan	scourged
Yozuvlarga	Scriptures
erda,	here,
sharoitida	conditions
Ero	Ira
FTP	FTP
erda.	here.
davolanish	treatment
&lt;sl3b+@andrew.cmu.edu&gt;	&amp; Lt; sl3b+@andrew.cmu.edu&amp;gt;
(plus,	(Plus,
qabul	accepted
mo&#39;ljallangan	designed
e&#39;tiqod	religion
Honda	Honda
superencipherment	superencipherment
vaqti-vaqti	From time to time
&lt;1rbn60$gs7@usenet.INS.CWRU.Edu&gt;	&amp; Lt; 1rbn60$gs7@usenet.INS.CWRU.Edu&amp;gt;
Kanada,	Canada
bo&#39;ladi&gt;	&amp; gt;
irim	superstition
alohida	separate
hayotida	the life
nasli	degeneration
vaqt	time
tugagach	At the end of
(82,178	(82,178
Inson	Human
topaklı	lumpy
vaqo	nothing
bir-biridan	a one-
(«real»	(&#39;Real&#39;
Panjobcha)	Punjabi)
maxsus).	Special).
mahsuldorlikka	Productivity
ilg&#39;or	advanced
kerak	should
quvonamiz.	rejoice.
muhabbat	love
noring@netcom.com	html>
otilishiga	ejected
688-8231	688-8231
energiyasi,	energy,
XXX	XXX
anglatdi.	Income.
uchib,	flying
kometa,	comet
uchib.	flying.
muzlatib.	frozen.
thumb	thumb
hays@ssd.intel.com	html>
og&#39;irroq	heavier
fikrlar.	opinions.
...........	...........
Kimnidir	Someone
soni	The number of
joriy	current
pastki	lower
bor&gt;	&amp; gt;
esa,	,
ish	business
taslim	surrender
Quyoshni	The sun
&quot;men	&amp; Quot; I
Tsai)	Tsai)
qilinadi.	.
Earth	Earth
mavjud	there is
taqqoslab,	comparing,
11:25	11:25
yanada	further
(604)	(604)
tovonini	heel
GMT&gt;:	GMT &amp; gt ;:
bosmoqchi	flooded
sevinglar	Sevim
yondirib,	burned
Pilat	Pilate
tafovutlar	differences
trafikni	traffic
PPM,	PPM
narsalarni	things
tuproqqa	soil
o&#39;yinchoqlar	toys
qaradi,	looked at,
yaqinroq	closer
gapiradigan	speak
qurol	weapon
tegish	touch
qiyin	hard
PowerPC	PowerPC
o&#39;ng&gt;&gt;	Right &amp; gt; &amp; gt;
(xotira	(Memory
kelayotgan?	coming from?
Muolajalar	Treatments
ro&#39;yxatdan	register
zo&#39;ravon	violent
o&#39;zlari	themselves
&lt;rauser.734062608@sfu.ca&gt;	&amp; Lt; rauser.734062608@sfu.ca&amp;gt;
Crawford)	Crawford)
Rind)	Rind)
Internet	Internet
moyli	oily
============ECHO	============ ECHO
kechqurun,	in the evening,
biznes	business
o&#39;chirilgan	Deleted
AYNAN	EXACTLY
talabalar	students
premade	Topspeed
sol.	Look.
halqalar	rings
qit&#39;ada	continents
Deydi	Says
prob	probe
Pontiy	Pontius
yuqorida	above
qilmoq	make
Tomas	Thomas
sayohatchilar	travelers
mehribon)	loving)
Qoldi	Stayed
roziligi	consent
tillo	of gold
jamoasi	The team
tarkibiy	structural
diametri,	diameter,
tubsizlik	abyss
jaskew@spam.maths.adelaide.edu	html>
unutilmas	unforgettable
Eng	Most
​​Venera	Venus
Psevdo-o&#39;qituvchi&gt;	Pseudo-teachers &amp; gt;
Clint	Clint
fotosuratlar	Photography
ochiq-oydin	clear
Technologies,	Technologies,
teging	Tap
Accord,	Accord
vazn	weight
biseksüel	Bisexual
Jordan	Jordan
kutayapmiz.	waiting for.
soha	sector
moyil	prone to
ataladi.	called.
so&#39;zning	the word
Quddusda	Jerusalem
eshitdim	I heard
maqsadlari,	Goals,
hayotini	life
Marty,	Marty
tugagan)	finished)
yaroqsiz	invalid
chiroq	lamp
kulminatsion	The culmination
energiyasidan	energy
kaliti	The key to
1.770	1.770
percieved	percieved
NEGA	WHY
(Ayollar	(Women
afsona	myth
-391	-391
ning?]&quot;]	?] &amp; quot;]
Usmonlilar	The Ottomans
shifrlangan	encrypted
hollarda	cases
quvnoq	merry
Columbia	Columbia
ko&#39;proq,	more
yirtilib	torn
Original	Original
ko&#39;proq.	and more.
dramatik	dramatic
quruq	dry
post,	post
(chaqaloq	(Baby
tug-of-urush	tug-of-war
noaniq	unclear
qayiq	boat
&amp;	&amp; Amp;
Dances	Dances
ergashish	Tracking
&lt;C5r60r.4ID@megatest.com&gt;	&amp; Lt; C5r60r.4ID@megatest.com&amp;gt;
rscharfy@magnus.acs.ohio-state.edu	html>
ishlaydigan,	working
lekin	but
&quot;osmon	&amp; Quot; the sky
xizmatini	service
eshitdi?	heard?
G20	G20
sezilarli	significantly
«Agar	&#39;
bugungi	today
oqib	flow
Serbiya	Serb
Isroilga	Israel
ta&#39;kidladi.	he said.
chiqarila	production
dalil	evidence
kim	who
behuda	wasted
dasturiy	software
.4ID	.4ID
tizimiga	system
postlar	Positions
Louis	Louis
o&#39;rnini	the role of
boshqa	other
himoya&quot;	protection &amp; quot;
boshqaruvchisini	manager
usuli	method
#,	#
istasangiz,	If you want to
ma&#39;nosini	meaning
&quot;xavfsizlik	&amp; Quot; security
qobig&#39;ini	crust
meteoroid	meteoroid
arablar	Arabs
yubordi.	sent.
algoritmi	algorithm
qilaman	I
ultrabinafsha	ultraviolet
shug&#39;ullanadi	engaged
354-1333,	354-1333,
niyat,	Goodwill,
#:	#:
401	401
400	400
Xo&#39;sh	So
viski	whiskey
henling	Henly
soat	hour
Yuqori&gt;	&amp; Gt;
bosimli	pressure
mahalliy,	local,
Cryptologia	Cryptologia
narsalarga	things
omadli.	We were lucky.
klub	club
&quot;^^^^^^^^^^^^^^^^^^^^^^^^^^^^^^^^	&amp; Quot; ^^^^^^^^^^^^^^^^^^^^^^^^^^^^^^^^
harakat	action
1.610	1610
oldindan	in advance
qaysar	stubborn
(62-mil)	(62-mile)
ta&#39;sir	effect
bezaklar	decorations
taklifi	proposal
javob	answer
foydasiz	useless
qilyapman!	I am!
guruhini	group
SEVGINI	LOVE
non-shifokorlar	non-doctors
qilyapman,	I&#39;m
yaqindan	closely
integer	integer
sabablari	Reasons for
securital	Security
qayta	again
qaralganda,	Overall,
!!	!!
qilyapman.	I am.
erkinliklarini	freedoms
qurbonligi	sacrifice
tushunish	comprehension
artmel@well.sf.ca.us	html>
(______	(______
erta	early
Jinoyatchilik	Crime
qilyapman;	I am;
foyda	benefit
body	body
************	************
Elvis	Elvis
reponse	reponse
kimyoviy	chemical
14-19	14-19
Milliy	National
qoplama	cover
(Karl	(Karl
Martin,	Martin,
qilmoqchisiz?	are you going to do?
qaysi	which
&lt;RVESTERM@vma.cc.nd.edu&gt;	&amp; Lt; RVESTERM@vma.cc.nd.edu&amp;gt;
engp2008@nusvm.nus.sg	html>
funt)	Pound)
bo&#39;lsa,)	If)
Kanada	Canada
Avvalgi	Previous
ken	ken
Tech.	Tech.
paneli,	Desk,
bulut	cloud
&quot;yuksak	&amp; Quot; high
amrlarning	commandments
dasturni	app
tanasi.	body.
to&#39;g&#39;ri	correct
imkonini	the ability to
35.789	35,789
u&gt;	&amp; gt;
o&#39;rni,	The role,
taklif,	offers
salqinlash	freshen
asrlar	centuries
to&#39;lqinlar	waves
dalda	encouraging
100&gt;&gt;	100 &amp; gt; &amp; gt;
manbai	source
chiqarib	remove
8:31	8:31
chiqishdan	to ride
tizimida	the system
Evropa	Europe
nomlanuvchi	known
yubordi,	sent
qo&#39;shnilari	neighbors
Jalilalik	Galilean
Boston	Boston
o&#39;simlik	plant
yalang&#39;och,	naked,
Sun,	Sun,
xarajatlar	expenses
hissiy	emotional
animatsiya	animation
inoyati	The grace of
Bunday-va-,	In such a situation,
xudolarga	the gods
liniyalarida.	lines.
Stassen	Stassen
edim	I was
ko&#39;prik	bridge
audio	audio
jabbor	compelling
sabablarini	the reasons for the
emulyatorlarni	emulyatorlarni
chiqdi	came out
(odatda	(Usually
467	467
niyati	the intention of
-&gt;	- &amp; Gt;
birinchi,	First,
afzallik	superiority
erigan	molten
e&#39;tiborsiz	ignored
ning	s
o&#39;qib.	u.
oltin	gold
ta&#39;qib,	followed by
o&#39;qib,	read
osongina	easily
yarim	half
olgan	which
ringlets	ringlets
kimligi	The identity of
Driver	Driver
hammasi	all
&quot;ko&#39;rish&quot;,	&amp; Quot; &amp; quot ;,
adashgan	gone astray
Tanlab	Selected
masofadagi	Remote
*,	*
mantiq	logic
gacha,	to
**	**
koinot	space
eriy	to melt
tirilmas	resurrection
Sue,	Sue,
Wai	Wai
Yupiter	Jupiter
yilda,	In
Chap	Left
amalga	out
yilda.	In.
guruhiga	group
uyg&#39;otishning	wake up
Qonunni	Law
birinchi	first
zaiflashtirish	Crippling
nima	what
(hozirga	(Now
+1	+1
++	++
supper.	supper.
mavqeini	the status of
Maykl	Michael
(A	(A
phj@remus.rutgers.edu	html>
bo&#39;ladi&quot;	&amp; quot;
*************************************	*************************************
mavsumda	season
bola-ligada	Child-league
look-	look-
ta&#39;minlaydi,	provides,
(;	(;
amalda	in practice
plexiglassso	plexiglassso
(:	(:
4.094	4,094
tashvishlantirgandir	perturbed
(?	(?
&quot;soğukluk&quot;	&amp; Quot; cold &amp; quot;
franko	Franko
(2	(2
hozir	now
CSHOW	CSHOW
o&#39;rinlarini	jobs
(1	(1
(7	(7
maqsadi	The purpose of
etgan	which
narsa&gt;&gt;	&amp; gt; &amp; gt;
()	()
(a	(A
ba&#39;zi	some
egasi.	owner.
keltirilgan	listed
Magic	Magic
(\	(\
Deydilar,	They say,
&quot;haqiqiy&quot;&gt;	&amp; Quot; real &amp; quot; &amp; gt;
Iso,	Jesus,
samoviy	heavenly
ritley@uimrl7.mrl.uiuc.edu	html>
(T	(T
professionallar.	professionals.
ota-o&#39;rtasida	between parents
o&#39;sadi	grow
(I	(I
yosh-Leith)	Young-Leith)
),	)
Cometary	Cometary
Puryear	Puryear
ekvatorial	equatorial
hatto	even
halokatli	disastrous
Qo&#39;shma	The joint
AMERIKA	AMERICA
Maqolasidan	Article
platsebo	placebo
hardcore	hardcore
amaliy	practical
..	..
gonzaled@ucsu.Colorado.EDU	html>
Altima	Altima
(korenek@nmti.com)	(Korenek@nmti.com)
oqilona,	rational,
tashlaydi.]	throw.]
oshdi.	increased.
4,6	4.6
guruhda	groups
1759	1759
Chiroq	Lamp
istagan	Desired
1,610	1,610
barpo	built
//	//
ko&#39;proq	more
majburiyatini	commitment
tugmasini	button
evropaliklar	Europeans
ixtiyori	discretion
-!	-!
qaychi	Scissors
ge!severy%severy@uunet.UU.NET	html>
ofisiga	office
yilda:	In:
Farangeyt).	Fahrenheit).
Farangeyt),	Fahrenheit),
[Gen	[Gen
o&#39;lasizlar	die
chegarasida	the border
xatarlar	risks
algoritm,	algorithm,
e-mail:	e-mail:
yildan	Since
Yahudiylar	Jews,
ILV20078@UDELVM.UDEL.EDU	html>
Gay	Gay
bo&#39;lsa&gt;	&amp; gt;
Sovet	Soviet
Cramer	Cramer
-.	-.
raster	raster
kalit&quot;	key &amp; quot;
&quot;Borshevshky&quot;	&amp; Quot; Borshevshky &amp; quot;
e-mail,	e-mail,
algoritm?	algorithm?
HCI	HCI
ma&#39;yus	sad
Kloo	Kloo
birikmasi	a combination of
necha	several
namelplate	namelplate
bor.	.
xatti:	Behavior:
bor)	)
35	35
bor,	There are,
ofisida	in the office
3:	3:
&lt;1993Apr21.170403.22855@yang.earlham.edu&gt;	&amp; Lt; 1993Apr21.170403.22855@yang.earlham.edu&amp;gt;
ko&#39;ringan	appearing
sug&#39;orish	irrigation
4.	4.
sanasi	Date
4,	4
King)	King)
42	42
bor?	There?
40	40
tushunchasiga	the concept
cheklash	restriction
ligini	stained
bor:	There are:
ishlayotgan	working
o&#39;ng?	right?
(613)	(613)
tushgan	received
dinni	religion
2:	2:
ogohlantirish.	warning.
anti	Anti
turi	Type
yarmidan	half of
sotish	sale
22	22
severy	Severn
senga	thee
23	23
befor	befor
24	24
25	25
TAKOZLARI	MOUNTING
o&#39;zgarishlar	changes
tura	stand
26	26
Spin;	Spin;
27	27
28	28
1W	1W
29	29
3,	3
3.	3.
stephen.guerke@mvs.udel.edu	html>
30	30
1m	1m
32	32
Ishii,	Ishii
31	31
davrida	period
fasllari	the tide
eroziyasi,	erosion,
chiziqli	linear
3)	3)
qaerda	Where
nashrida	The brightness
qo&#39;llab-quvvatlanadigan	supported
kamchilikka	lack of
19	19
tutish.	Behaviour.
1:	1:
qilyapman	I&#39;m
17	17
18	18
e&#39;tirof	recognized
15	15
16	16
13	13
14	14
11	11
12	12
tutish?	Behavior?
21	21
20	20
2.	2.
8.20)	8.20)
2)	2)
yo&#39;ldoshlarini,	satellites,
2%	2%
erda	here
Kompyuter	Computer
bosh	head
erikb@idt.unit.no	html>
aytdi.	he said.
aytdi,	he said,
litsenziya,	license
1.	1.
10	10
Islom	Islam
1)	1)
1,	1
qarash,	look,
1%	1%
Swartz	Swartz
5VDC	5VDC
formatlash	formatting
7:	7:
narxi)	Price)
78	78
Shubhasiz,	Obviously,
faoliyatini	the activities of
yotgan	B
prohipiting	prohipiting
Ato,	Adam,
tashqarisiga	out of
niyat	intention
uzgan?	shot?
kometasi	comet
Erta	Early
butterscotch	butterscotch
qonuniyligini	the legitimacy
Yerning	The earth
6:	6:
so&#39;zlari	the words
insonlar,	people
Lunar	Lunar
olmaydilar&quot;,	&amp; quot ;, not
soatiga	per hour
maqsad,	target
Lekin,	However,
(o&#39;sha	(
7)	7)
Shifokorlar	Doctors
!!!!&quot;	!!!! &amp; Quot;
zum	moment
70	70
qariyb	almost
72	72
76	76
kasaliga	The diagnosis
modem	modem
Noqonuniy-Key	Illegal-Key
5:	5:
inoyati.	grace.
martyj@uiuc.edu	html>
Solomita)	Solomita)
56	56
Update	Update
ba&#39;zan,	Sometimes,
55	55
qoidalar	The rules
ancha	much
sayyoraning	the planet
o&#39;g&#39;irlab	abducted
chindan	really
Suvga	The water
xato-line	fault-line
ayblov	prosecution
60	60
guruhni	group
&quot;barcha	&amp; Quot;
belgilangan	defined
yonayotgan	burning
tutib,	holding
istamayman	I do not want
^^^^^^^^^^^^^^^^^^^^^^^^^^^^^^^^^^^	^^^^^^^^^^^^^^^^^^^^^^^^^^^^^^^^^^^
4:	4:
organik	organic
orqa	back
______	______
4?	4?
vaqtincha	temporary
WW2	WW2
70,000th	70,000th
ko&#39;paydi.	increased.
5,	5
mahallada	neighborhood
oralig&#39;i	range
Clipper	Clipper
gapirganda];	Speaking];
Narsa	Thing
ko&#39;zlarini	eyes,
suvni	water
5.	5.
Torre:	Torre:
50	50
vakuum	vacuum
(508)	(508)
imkoniyatlari	options
masofa	distance
o&#39;ylayman-da,	I think, though,
Azzam)	Azzam)
otasi	his father
qurol-qonunchiligi	-gun legislation
olingan	obtained
astronomlar	astronomers
edi:	were:
edi;	;
486	486
Thanks,	Thanks
*************************************************	*************************************************
edi?	?
99,86	99.8
chiqarish	release
tibbiy	medical
482	482
paytda,	time
to&#39;xtating	Stop
edi,	,
Erga	Here
edi.	.
o&#39;ylamanglar,	Do not think,
xalqiga	people
&lt;/	&amp; Lt; /
tartibsizlik	chaos
o&#39;limi,	Death,
ehtiyojlarini	needs
Madrid	Madrid
kam	less than
telematik	telematic
tashkil	organized
tomir&gt;	Cardiovascular &amp; gt;
maydonchada?	landing?
Thanks!	Thanks!
qaroqchi	bandit
Ulker	Ulker
payg&#39;ambarlarning	the prophets
Lankform,	Lankford
::	::
O&#39;quvchilarning	Readers
10:39:15	10:39:15
Fla	Fla
tizimini	the system
dekabr,	December
tozalanadi	cleared
bosing.	Click.
aniq	clear
ekspertiza	the examination
(yunoncha	(Greek
kundalik	daily
ishlamaydi.	work.
singan	broken
Sayyoraning	The planet
:)	:)
MDs,	MDs
yulduzlarni	stars
ruxsat	permission
o&#39;qigan	read
moyilligiga,	predisposition,
edi)	)
Lankford&gt;	Lankford &amp; gt;
95	95
Tavrot	Mosaic
sbp002@acad.drake.edu	html>
yadrosi	kernel
93	93
90	90
edi!	!
tekislash	Straightening
Erda	Here
qoniqmagan	unsatisfied
uchuvchi	pilot
ma&#39;lumot	Information
&quot;dumlar.&quot;	&amp; Quot; tails. &amp; Quot;
Imkoniyat	Opportunity
funktsiyasi	function
​​ular	they
Oktyabr	October
Alt.atheism	Alt.atheism
Voz	Waiver
donali	grained
sotilgan	sold
chiqib	out
==================================================	==================================================
88	88
Sichqoncha)	Mouse)
ko&#39;rsatmoqda	shows
xavfsiz,	a safe,
Muayyan	Certain
&quot;Oh,	&amp; Quot; Oh,
dekabr	December
??	??
bola	boy
safari	trip
MacRae):&gt;&gt;&gt;	MacRae): &amp; gt; &amp; gt; &amp; gt;
binoning	building
kiritish,	,
foizi	percent
yopib	closed
maqolalar	Articles
nizo	dispute
birodarlar,	brothers and sisters,
qilmaydi	It does not
Statistika&gt;	Statistics &amp; gt;
nuqtai	opinion
?!	?!
qo&#39;nganda	when
printsiplari	The principles
buyuradi	to pay
Leong,	Leong
formatlar,	formats,
qolaman.	required.
muammolar,	problems,
kartopu	Snowball
zoti	brood
X11	X11
suvga	the water
xalqini	people
(LGV	(LGV
imkoniga	the ability to
biladimi?!?	?!?
Bure	Bure
yopiq	closed
(Ken	(Ken
tarzda	the way
muammolar?	problems?
qusur	defect
aslida,	in fact,
Erik	Erik
gt4417a@prism.gatech.EDU	html>
foizga	percent
WNI	WNI
Portable	Portable
narsa	thing
Lotin	Latin
bor!	There!
o&#39;qish	reading
topilmalar	findings
media-tadbir	media event
tabiiy	natural
ko&#39;rinadi.)	will be shown.)
yorig&#39;i	Fault
(5000	(5000
motherships	motherships
mantiqiy.	logical.
teng	equal
Da	At
Db	Db
xizmat	service
4,850	4,850
nomukammal	imperfect
rasmlar	Pictures
E.	E.
Land,	Land
razvedka	reconnaissance
anti-qo&#39;ziqorin	anti-fungal
(korenek@nmti.com)&gt;&gt;&gt;	(Korenek@nmti.com) &amp; gt; &amp; gt; &amp; gt;
qilish	to
DH	DH
(Detroyt,	(Detroit,
vulqon	volcano
nashr,	published
(ya&#39;ni,	(That is,
kolleji	College
&quot;kasalliklar	&amp; Quot; disease
ma&#39;lum	known
sharoiti	conditions
(«oxirgi&gt;	(Past &amp; gt;
Bures&gt;	Bures &amp; gt;
bo&#39;lmas	not
boshini	his head
ekstraditsiya	extradition
musulmon	Muslim
virus..It	virus..It
340	340
endi.&quot;,	Now. &amp; quot ;,
yuzasining	the surface
temp	temp
nusxasidan	replica
hisobotlarida	reports
da&#39;vo	lawsuit
boshqaruvchiName	manager
konfiguratsiya	configuration
GE	GE
Wen-Cheng	Wen-Cheng
diniy&gt;	Religious &amp; gt;
Shundan	That
ha,	yes,
Shunday	So
eşlenen	mapped to
qilish?)	?)
Er	Land
amp&gt;	amp &amp; gt;
Sichqoncha	Mouse
asteroitler,	Asteroids
G.	G.
FM	FM
yulduzlarga	the stars
gnomes	Gnomes
qulay.	comfortable.
ammiak,	ammonia,
kilometrlik	kilometer
differensial	DIFFERENTIAL
HG	HG
&lt;C5t7Gs.7v3@news.iastate.edu&gt;	&amp; Lt; C5t7Gs.7v3@news.iastate.edu&amp;gt;
Incorporated	Incorporated
davlatlar,	states,
IP:	IP:
763-2626	763-2626
ishlatilgan,	used
GP	GP
beradi	provides
GM	GM
H.	H.
tarkibidan	the composition of
(Paul	(Paul
recomendations	recomendations
oddball	oddball
ham	and
QUACK,	QUACK
mish-mish	rumors
itself_	itself_
(Martin	(Martin
From:	From:
davomida	for
hal	the solution
5:17	5:17
qoldi	stayed
jusgement	jusgement
haq	fee
Oort	Oort
har	every
Vaqt	Time
Titan	Titan
(emas,	(it&#39;s not,
matbuot	press
kelayotgan	coming
From,	From
kelishida	coming
Falakda	Orbit
A.	A.
Singapur	Singapore
======================================&gt;	====================================== &amp; Gt;
AT	AT
300	300
Home	Home
monitor	monitor
IMMMMMMMMMMMMMMMMMMMMMMMMMMMMMMMMMMMMMMMMMMMMMMMMMMMMMMMMMMM;	IMMMMMMMMMMMMMMMMMMMMMMMMMMMMMMMMMMMMMMMMMMMMMMMMMMMMMMMMMMM;
kutilayotgan	expected
bekor,	the cancellation,
kanallari,	channels,
qarama-qarshi.	the opposite.
Boshqa	Other
Tiroid	Thyroid
xislat	quality
30%	30%
Everest	Everest
III	III
bo&#39;lagini	piece
AM	AM
B.	B.
BV	BV
C:	C:
&lt;C5qsBF.IEK@ms.uky.edu&gt;	&amp; Lt; C5qsBF.IEK@ms.uky.edu&amp;gt;
baribir	anyway
&quot;muhokama&quot;	&amp; Quot; &amp; quot discussed;
yashovchi	inhabitant
vodiylar	valleys
CA	CA
musht	fist
mamlakati	country
BI	BI
ta&#39;qiqlangan	banned
avtomatik	automatic
tarzda&gt;	&amp; gt;
havoriy	The apostle
sayyora	planet
An	An
virtual-ildiz	virtual root
namoyish	demonstration
C,	C
stol	table
Al	Al
kiritilgan	included
missiyasi	mission
foydalanayotgan?	using?
3.0	3.0
javobgar	responsible
&quot;mergan&quot;,&gt;	&amp; Quot; shooter &amp; quot; &amp; gt;
3.1	3.1
(&quot;vasiyatini&quot;	(&amp; Quot; my &amp; quot;
Eastwood	Eastwood
Bu	This
tutish	keep
shug&#39;ullanadi.	engaged.
iborat,	,
iborat.	.
botir	botir
&lt;o&#39;rniga	&amp; Lt; instead
shunga	so
yoyib.	spreading.
iltimos.	Please.
Jovian	Jovi
Ganimedes	Ganimedes
iltimos,	Please,
xarajat,	cost,
botil	Falsehood
CD	CD
qaratilgan	aimed at
ekan.&quot;	. &amp; quot;
D.	D.
ko&#39;pchilik	most
!!)	!!)
boshiga	per
uzog&#39;i	the treatment
Assad	Assad
Ehtimol,	Perhaps,
!!!	!!!
Ogayo	Ohio
bizga	us
zbekiston	PA
Twin	Twin
ichiga	contains
zot	He
(root	(Root
hey	hey
(NASA	(NASA
Xudo	God
assimetrik	asymmetrical
cratered	cratered
Cardinals	Cardinals
egalarining	owners
Leonard	Leonard
MD	MD
cheklanishiga	the restriction
jasur	brave
MB	MB
He,	He,
resurslarini	resources
da&gt;	&amp; gt;
mobil	mobile
kvadrat	square
tashlamoqchi	throw
N.	N.
Vulqon	Volcano
qaerda&gt;	Where &amp; gt;
guvohlar	witnesses
Gilkey	Gilkes
&quot;X9&quot;	&amp; Quot; X9 &amp; quot;
MS	MS
elektron	Electronic
tarozida	weighing
NI	NI
3,8	3.8
3,5	3.5
tirilaman.	rise.
NA	NA
(oxirgi	(Last
dlb@fanny.wash.inmet.com	html>
imoningiz	faith
gapirdi?	He spoke?
Jazoir	Algeria
My	My
ya&#39;ni,	that is,
Electronics,	Electronics
kimsiz?	Who?
---------------------------	---------------------------
Kommutatsiya&gt;	Switching &amp; gt;
NO	NO
tuman,	district,
P.	P.
kalitiga	the key
ON	ON
bo&#39;ron	storm
OK	OK
chaldi	I rang the
fuqarolari	citizens
PowerBook?	PowerBook?
Sayt	Site
(Scooter	(Scooter
diskdan	Disc
nisbatan,	,
shohidlik:	witness:
hamjamiyat	community
&quot;magnit	&amp; Quot; magnetic
(6200	(6200
P5	P5
&quot;..	&amp; Quot;
mikrosxemalar	circuits
maslahatlar?	tips?
yopildi:	closed:
No	No
oralig&#39;i.	range.
OP	OP
lei@rtsg.mot.com	html>
OR	OR
o&#39;chirildi,	deleted,
PL	PL
On	On
Shohligida	Kingdom
(Wen-Cheng	(Wen-Cheng
Oh	Oh
qaytarib	return
Od	Ad
Ligasi	League
PB	PB
PC	PC
bilim	knowledge
qorong&#39;u	dark
tarixi	History of
emissiya	emission
Go	Go
Barringer	Barringer
o&#39;tkaziladi.	will be held.
jingalak	curly
&quot;ochiq&quot;	&amp; Quot; open &amp; quot;
qorong&#39;i	obscure
nomaqbul	Alphanumeric
&quot;Etarli	&amp; Quot; Enough
biologiya	biology
his	feel
taxta	board
ID	ID
Ha	Yes
o&#39;rganish	to learn
He	He
nuet_ke@pts.mot.com	html>
dog&#39;larni	spots
Hi	Hi
Club,	Club
Tom&gt;	Tom &amp; gt;
Lander	Lander
iyul,	July
J.	J.
IN	IN
IO	IO
qilasiz?	are you going to do?
bajarish	performance
sohasida	in the field
yuzasi	The surface
o&#39;g&#39;irlangan	stolen
IS	IS
IT	IT
dh782@cleveland.Freenet.Edu	html>
mevalaridan	the fruits of
Club.	Club.
Ha.	Yes.
Hz	Hz
Ha,	Yes,
o&#39;rgatsa,	teaches,
Network	Network
bilib	learn
kuzatuvlar	The observations
EGALON)	Possession)
JB	JB
Io	Io
&quot;),	&amp; Quot;),
vafot	died
In	In
kanal	channel
shuncha	so
kinoya	Kina
marhamatli&gt;	gracious &amp; gt;
JT	JT
demak	means
kelishini	to come
AUTOCAD	AUTOCAD
(Hamaza	(Hamas
kulgili	ridiculous
qo&#39;lga,	,
IBM	IBM
zid	contrary
&quot;Faqat	&amp; Quot; Only
st1ge@Elroy.UH.EDU	html>
Toyota	Toyota
mustaqil	independent
uxlab,	sleeping
(Joseph	(Joseph
To&#39;g&#39;ri,	Correct
emulator	emulator
L.	L.
raqib	rival
zaxira	backup
kishi,	People
sport	sport
o&#39;zlarini	themselves
sinf,	class,
past	low
chaqasan.	bruise.
IBMning	IBM
Hal	The solution
ichida	within
negadir	for some reason
qiymati	The value of
Ham	And
Birodarlar,	Brothers and sisters,
LH	LH
Har	Every
FROMTHEDEAD:	FROMTHEDEAD:
Masihdir.&quot;	Christ. &amp; Quot;
boshqacha	different
aytishim	say
VL	VL
W.	W.
Ulysses&#39;in,	Ulysses
hisoboti	Report
Isreal	İşret
huquqlarini	rights
parda	curtain
dunyolar	worlds
Tx	Tx
bizni	us
ko&#39;rganlar.	seen.
qoldi&gt;	&amp; gt;
bo&#39;sh	empty
dotsent	Associate Professor
heteroseksüel	a heterosexual
saqlaydi,	stores
Antarktida	Antarctica
unutmang	Do not forget
rahmat.	Thank you.
qurboni	the victim
yuz	face
Gelişigüzel	Indiscriminately
kechish!	Disclaimer!
Th	Th
erta,	early
oziqlangan	fed
ishga	launched
PROOFOF:::	PROOFOF :::
olaysız	uneventful
yuk	load
foydalanadi	uses
TV	TV
hamkorlar	partners
&quot;bilan.	&amp; Quot;.
wnk@aquifer.geology.uiuc.edu	html>
Muqaddas	Holy
kechish?	Disclaimer?
turar	accommodation
Charter	Charter
kalitini	the key
[erkak]	[Male]
XT	XT
Norton	Norton
Landmann	Landmann
Oldingi	Previous
ikkinchisi,	second,
maxfiy	confidential
ko&#39;rsatmalar	instructions
&quot;soat&quot;	&amp; Quot; &amp; quot;
darajada,	level
zerikarli,	boring
Yevropaga	To Europe
simob	mercury
burchak)	corner)
ertak	tale
muammolarni	problems
yozida	In the summer
burchak,	corner,
Va	And
------------------------	------------------------
Jun&#39;ichiro	Junichiro
porlab	shine
emasman-da,	Although I am not
Open	Open
isbotlash	to prove
Pathfinder&gt;&gt;&gt;	Pathfinder &amp; gt; &amp; gt; &amp; gt;
S.	S.
loyiha,	The project,
qoralangan	stains
xona	room
chiqish	exit
murojaat,	contact
Qani,	Where
Folta)	Foltz)
blok.	block.
tirilmagan	raised
yaxshi!	Good!
RA	RA
qaratib	focus
Qurol	Weapon
shoxini	horns
pastga&gt;	Down &amp; gt;
Meni	Me
muqobil	alternative
o&#39;qib	read
bo&#39;lsa,&gt;&gt;	&amp; gt; &amp; gt;
ildiz	root
&quot;Bu	&amp; Quot;
aylantirilib	Bonds
turib	without
singari)	like)
to&#39;siqlar	obstacles
qilinsa	If
R.	R.
alin@nyx.cs.du.edu	html>
xatoyim.	fault.
(1.5-mil)	(1.5 miles)
haysi)	Hays)
fuqarolar,	citizens,
yaxshi,	well,
arziydi.&quot;	worth. &amp; quot;
Mavzu:	Topic:
gol	goal
qaytishini	to return
kapasitif	The capacitive
Oy	Month
Vayss)	Weiss)
yurishni	to walk
qilib,	,
oynasini	window
jinoyat	crime
oooo	oooo
bo&#39;lmasa&gt;	or &amp; gt;
qo&#39;ng&#39;iroq	bell
o&#39;rganildi.	studied.
So	So
qoldiqlari	The ruins of
dori	medication
SS	SS
yoz	summer
uchun;	for;
nazaridan	in terms of
uchun?	?
imkoniyatlarini	opportunities
Chin	True
urg&#39;u	emphasis
uchun:	to:
Men,	I
uchun,	to
Re	Re
Aql,	Intelligence,
uchun.	.
ketdi	gone
joylashtirish.	.
SI	SI
rahmati	the mercy of
uchun%	%
ertalab,	in the morning,
-120	-120
yoq	Team
uchun)	)
RR	RR
kelgan;	;
Insondir	The man
uchun!	!
///////	///////
&quot;sekin	&amp; Quot; slow
franjion@spot.colorado.edu	html>
qilib.	.
minalar	mines
Driver&gt;	Driver &amp; gt;
topildi.	found.
chaqmoqni	lightning,
So&#39;zga	Speaking
Eski	Old
Campus	Campus
Snail	Snail
orqali	across
gul	flower
N3JXP	N3JXP
turli	diverse
yashagan.	lived.
shogird	disciple
yoqishingiz	Aloha
bemorlar,	patients,
^)	^)
sayyoramizning	the planet
(xohlagan	(Wills
birini	one
o&#39;sayotgan,	growing
Severy	Severn
xotira	memory
sevib,	love,
yuqoridagi	upper
sulfat	sulphate
xos,	original,
qadimiy,	ancient,
\\	\\
uchun.&quot;,	. &amp; quot ;,
CONFIG.SYS	CONFIG.SYS
Mavzu	Theme
=============================================	=============================================
Xo&#39;sh,	Well,
mediator	mediator
Ogohlantirishlar	Disclaimers
risolaning	the brochure
ahamiyatga	importance
mutakabbir	arrogant
sharqqa)	east)
buyuriladi	prescribing
&quot;qovun&quot;	&amp; Quot; fruit &amp; quot;
kutish	expectation
qirg&#39;in	massacre
o&#39;quvchi	reader
astronavtlar	astronauts
__	__
(Lin	(Lin
switch	switch
sichqoncha	mouse
yo&#39;nalishini	the direction of
tushdi.	toast.
tushdi,	Toast,
MouseWare	MouseWare
safarga	a journey
dbernard@clesun.Central.Sun.COM	html>
tubdan	cardinal
jo&#39;natish,	dispatch
Hutchison&quot;	Hutchison &amp; quot;
murojaat?	contact?
naqsh	pattern
qonunlarini	laws
`.	.
[2]	[2]
^^	^^
Kosmosda	In space
Taoloning	Almighty,
xudolar	the gods
3-8),&gt;	3-8), &amp; gt;
ixtisoslashtirilgan	Specialized
singlim,	sister,
-183	-183
oyna&gt;	Window &amp; gt;
ustuvor	priority
mustahkam-rock	a solid-rock
382	382
hafa&gt;	sad &amp; gt;
AQShda	In the United States
&quot;insonparvarlik&quot;	&amp; Quot; humanization &amp; quot;
&quot;Shaxsiy	&amp; Quot;
Falastin	Palestine
konservativ.	conservative.
cho&#39;mish	baptism
muallifi	author
(Skelton	(Skelton
-179	-179
ko&#39;rinmaydi.	appear.
&quot;loyqa	&amp; Quot; fuzzy
ustoz	teacher
orqaga	back
Davlat	State
portlatishga	blow
modellari	models
yoylari	arcs
sozlamoq	tune
yozish	write
yalang&#39;och	naked
(Douglas	(Douglas
375	375
oxirida,	At the end,
boshga	the head
qamashtiruvchi	Dazzling
&quot;:`	&amp; Quot;:
pizza-rangli	Pizza-colored
[a	[A
Kosmosga	Space
(masalan),	(For example)
Nanaimo,	Nanaimo,
biriga	one of the
israel	israel
360	360
turmush	living
Sana	Date
o&#39;rniga	instead
o&#39;sish)	growth)
Minglab	Thousands
Yuz	Face
G&#39;azo	Gaza
[u	[she is
HRB	HRB
o&#39;rganib,	study,
o&#39;rganib.	examined.
Sams	Sams
mo&#39;minlar	believers
[I	[I
Chris	Chris
chaqirishni	convocation
\)	\)
chiqarilgan	Model
organ	organ
»Siz	&#39;You
\;	\;
48?)	48?)
fotokimyo&quot;	photochemical &amp; quot;
o&#39;rganib;	study;
chaqiriq	call
tashlash	remove
K1Y	K1Y
&quot;bekor	&amp; Quot; Cancel
Land	Land
hayron	surprised
o&#39;ynaydi.	play.
nisbatan	relatively
ge	ge
qiluvchilarni	Buyers
Uran	Uranium
muammo,	the problem,
infektsiyalari,	infections
ga	to
qutblarda	poles
&lt;1qksc2$2mr@fido.asd.sgi.com&gt;	&amp; Lt; 1qksc2$2mr@fido.asd.sgi.com&amp;gt;
chiqaruvchi	manufacturer
yo&#39;ldosh	satellite
o&#39;zimning	my
JPL	JPL
tashlaydi,	throw
bunday	such
Paul	Paul
milya)	mph)
203	203
bolalarni	children
200	200
lug&#39;at	dictionary
20:	20:
&quot;Va	&amp; Quot;
shogirdlari	disciples
SLEGGE@kean.ucs.munc.ca	html>
&quot;Uy	&amp; Quot;
kuchlari	forces
20%	20%
kengaytirish-nafs)	the expansion of the soul)
i,	i
imkon	possible
tuyulardi	it seemed
bizning	our
dedi	said
oxirgi):&gt;	final): &amp; gt;
qildim.	I did.
fayllarni	files
xizmati	Service
stantsiyani	station
qoldirgan.	left.
Corollas	Corollas
Beta	Beta
kashshof	pioneer
talqini	interpretation
shogirdlariga	His disciples,
munosib	worthy
In:	In:
gapirish).	speaking).
o&#39;tgan.	.
&quot;...	&amp; Quot; ...
Gruziya	Georgia
oniy&gt;	Instant &amp; gt;
yulduz	star
ailin	Aili in
etti	seven
sanaladi.	is.
munozaralar	debate
21)	21)
do	do
Iftccu:	Iftccu:
In.	In.
portretlar	portraits
doim	constantly
21,	21
ko&#39;ra	According to
qo&#39;shni	neighbor
bo&#39;sh,	free,
kamon	bows
bundan	In addition,
JPB	JPB
ashyo	material
Agnostitsizm	Agnosticism
maqbul	acceptable
delusional&gt;	delusional &amp; gt;
Necha	Several
ishora,	sign,
yer	earth
Advanced	Advanced
Io,	Io
meteoritlarning	meteorites
qildik.	We have.
ishora;	sign;
er	land
Past	Low
Fraering)	Fraering)
dizayn	design
Bu!&quot;	! &amp; Quot;
yaxshi&quot;.	&amp; quot ;.
Lantz)	Lantz)
qanday&gt;	&amp; gt;
bu	this
ko&#39;za	pitcher
bf	bf
qilingan.	.
qilingan,	,
foydalangandan	using
bi	bi
Topraklama.	The grounding.
Bugun	Today
deb;	that;
juft	pair
da	at
deb:	that:
havzasi	Basin
deb?	that?
2,5	2.5
kemada	the ship
Teemu	Teemu
(xotinim)	(My wife)
bosh.]	.]
faqat,	only
deb,	,
maydon,	area
deb.	.
kompyuterga	a computer
shippak	slipper
tekshiriladi)	checked)
yumshatish	to mitigate
XT350	XT350
ab245@cleveland.Freenet.Edu	html>
Tarix	History
jele	jelly
edi).	).
ko&#39;chmas	real
yaratadi.	creates.
deyarli	almost
edi),	)
geb@cs.pitt.edu	html>
yomonroq	worse
holatiga	mode
Tahrir:	Edit:
``	``
uunet	uunet
Oynasida,	Window
Recyle	Recyle
zambilda	stretcher
Texnikasi&gt;&gt;	&amp; Gt; &amp; gt;
hujjatsiz	documentary
hurmat	respect
qo&#39;liga,	Safety,
boruvchi	leading
tomosha	watch
c:	c:
franjion@spot.Colorado.EDU	html>
narxlari,	Prices
JKN	JKN
BIROR	ANY
maydoni	area
juda	very
ad	ed
[1]	[1]
bosim	pressure
narxlari.	Prices.
no	no
hujjatni	document
nuriga	sunlight
&quot;platsebo	&amp; Quot; placebo
ilovalar	applications
Cadillac&quot;	Cadillac &amp; quot;
ayollarning	women&#39;s
maqsadi,	The purpose of
qo&#39;shilmayman.	I disagree.
of	of
laboratoriyalari	laboratories
nizomiga	overlapping
aralashmalari	The compounds of the
Savolingizga	Question
schuster@panix.com	html>
Meteor	Meteor
bayroq	flag
In:&gt;&gt;	In: &amp; gt; &amp; gt;
yorqin	bright
dizaynlar	designs
yovvoyi	wild
kosmik)	Space)
qo&#39;yish,	,
kosmik,	space
o`yini	qualifying
oq	white
Ko&#39;proq,	More
dono	wise
o&#39;rniga,	Instead,
Lippard)	Lippard)
etib	as
Observer,	Observer
oz	little
oy	month
ham&gt;	&amp; gt;
mehmon,	guest
ko&#39;rdik.	seen.
pe	PE
ko&#39;rdik,	We have seen,
pm	pm
ustiga,	on
chiptalar	Tickets for
psyrobtw@ubvmsb.cc.buffalo.edu	html>
Member	Member
emasligini	not
myselfe	beside myselff
jadvallar	tables
BBS:	BBS:
Galatiyaliklarga	Galatians
mas&#39;uliyatni	responsibility
dos;	dos;
platalar	boards
Agar&gt;	A &amp; gt;
1500	1500
kompaniya	company
me	me
Ditto.	Ditto.
Yakshanba	Sunday
Messier	Messier
ruhoniylar	priests
46904	46904
kvant	quantum
boshpana	asylum
&quot;tajovuzkor&quot;	&amp; Quot; aggressive &amp; quot;
tinch	quiet
chiqaradi.	.
hukmronlik	rule
kamarini	belt
qarashda&quot;	glance &amp; quot;
jonsiz	lifeless
xanjar	dagger
olib,	,
na	na
Erkaklar	Men
o&#39;ldirish	killing
ortodoksal	orthodoxy
ko&#39;rdim.	I saw.
instituti:	Institute:
Arizona	Arizona
o&#39;liklar,	dead
ni	option
do&#39;konlar	Stores
olib.	.
p.	p.
boshdan	experience
(Ispaniya)	(Spain)
itoat	obey
Orbiters	Orbiters
Kontaktlarni	The contacts
P.S.	P.S.
ta&#39;minot	Supplied
mock@watt.support.Corp.Sun.COM	html>
tekshirish:	Check:
ro&#39;yxatda	the list
egilib	bent
Afsuski,	It&#39;s a pity,
XQueryTree	XQueryTree
EMAS	IT&#39;S NOT
oxir-oqibatda	eventually
AVTOMATIK	AUTOMATIC
quvg&#39;in	persecuted
Bressler)	Bresson)
vazifalari	functions
holatini	the status of the
Tabib	Tabib
emasman,	I am,
emasman.	I am not.
boshladi;	began;
ku	KU
Evropadan	Europe
tirilishi	The resurrection
boshladi,	,
emasman!	I am not!
boshladi.	.
ing	ing
Xudosiman,	God
qurish	construction
Rubenfeld)	Rubenfeld)
emasman;	I am not;
ko&#39;r)	Blind)
iqlim	climate
Yo&#39;q,	No,
qat&#39;i	Regardless of
pog&#39;ona	splash
kamar	belt
===========	===========
EMAS.	IT&#39;S NOT.
Orbiter,	Orbiter
istayman.	I would like to.
istayman,	I would like to,
hi	hi
Yer	Earth
Meeting,	Meeting
o&#39;zgartirish	replacement
yil	year
Sizga	You
livesey@solntze.wpd.sgi.com	html>
yo&#39;qolganda,	loss
Xelion	Xelil
Salbchilar	Crusaders
avlod	generation
JPS&gt;	JPS &amp; gt;
____	____
mayda	May
tengdoshlari	peers
to&#39;plash	collect
shifokorlar	doctors
ilm	education
ko&#39;p,	many,
in	in
ip	thread
TranslateCoordinates&gt;	TranslateCoordinates &amp; gt;
impedans	Impedance
so&#39;rab	ask
(&gt;,	(&amp; Gt ;,
iz	trail
suratga	pictures
Fred&#39;S	Fred&#39;S
ko&#39;p!	More!
faraz,	Assuming,
COEGALON@LARC.NASA.GOV	html>
Sharma)	Sharma)
[Iso]	[Jesus]
etc,	etc,
porloq.	bright.
zanjir	chain
YYY	YYY
etan	ethane
xt	xt
spot	spot
yilgacha	years
rejalashtirilgan,	planned
ismi	name
Test	Test
rejalashtirilgan.	planned.
emasman&quot;,	&amp; quot ;, am
to&#39;qnashdi	clash
tavsiflovchi	describing the
aktsiyalarning	shares
modernizatsiya	modernization
boshlanadi	begins
Powerbook	Powerbook
Schaufenbuel	Schaufenbuel
aylanishi	dizziness
apparat	apparatus
yarim-rock	Half-rock
Calling	Calling
ortiq&gt;	&amp; gt;
bading@cs.tu-	bading@cs.tu-
vv	vv
etar	Despair
davolash.&quot;	treatment. &amp; quot;
upperleft	upperleft
ekanini	that
tanlangan	selected
paytda	while
yorug	bright
masofalarga	distances
xarakterli&gt;	characteristic &amp; gt;
(amerikaliklar)	(The Americans)
(Barcha	(All
Radio-Shack-ega	Radio Shack
Lantz	Lantz
nodrog@hardy.u.washington.edu	html>
keltirishi	cause
&lt;C4Hyou.1Iz@mentor.cc.purdue.edu&gt;	&amp; Lt; C4Hyou.1Iz@mentor.cc.purdue.edu&amp;gt;
yechim	solution
to&#39;lanadi	be paid
uz	Posts
ko&#39;chib&gt;	&amp; gt move;
uy	home
va	and
(James	(James
yana	again
chidamli	resistant
Buyuk	Great
tovar	goods
o&#39;chdi	swish
ko&#39;zlar,	eyes
etdi	St.
ta&#39;riflaydi:	It describes:
anakart	The motherboard
matrix	matrix
kuzatiladi:	observed:
`joylashtiring]	Insert]
&quot;qizil	&amp; Quot; red
ko&#39;pincha	often
chiziqlar	lines
bildirdi	said
keltirganlar	Those who
Kinsley	Kinsley
tushunchasi&gt;	The concept of &amp; gt;
up	up
tomoshabinlar	viewers
&quot;gi	&amp; Quot;
jarayoni	The process
modelini	model
sezuvchanlik	sensitivity
sinov	test
&quot;ga	&amp; Quot;
&quot;Minnesota	&amp; Quot; Minnesota
etildi,	It was,
kuzatiladi.	observed.
Zich	Tight
terimiga	pick
kuzatiladi,	There,
etildi.	.
to	to
tuproq	soil
Siyosiy	Political
v.	c.
-235	-235
Shaxsan,	Personally,
halihamon	infancy
ISA)	ISA)
(Marcus	(Marcus
te	te
yomon,	bad,
kunduzi	afternoon
ochilishi	opening
kashfiyotchining	discoverer
sayyoralar	Planets
welcome	welcome
Osmon	Sky
Teng	Equal
gipotezasi,	hypothesis,
chiqildi	Views
Yonga	Chip
hte	hte
o&#39;lchagan,	measured,
Masih,	Christ,
o&#39;lik-tugasa	dead-ends
kuchaytirgich	enhancer
axloq&quot;	Ethics &amp; quot;
amper	ampere
ko&#39;zlari	eyes
Texas	Texas
u,	she is,
sudga	court
brenner@ldgo.columbia.edu	html>
asoslanadi.	is based.
chorak	quarter
Xokkey,	Hockey,
suvlari,	waters
ilgari	ago
Hududingizda	In your area
&quot;taslim&quot;	&amp; Quot; lead &amp; quot;
to&#39;plangan	collected
yugurish	run
degan?	that?
zoting	seed
​​&gt;&gt;	&amp; Gt; &amp; gt;
yoyish	spread
ota-LED	LED parents
(Men	(I
plitalari	plates
rivojlanish	growth
sharqiy-to-g&#39;arbda	east-to-west
sharoitlarda	conditions
xos	specific
-221	-221
bilan	with
raqam	number
bressler@iftccu.ca.boeing.com	html>
transfer&gt;	Transfer &amp; gt;
xok	Ad Hoc
xom	raw
shartlarda,	conditions,
&#39;&#39;	&#39;&#39;
cherkovi	Church
dilemma	dilemma
foydalanadi.	uses.
jamiyat	society
ba&#39;zilari	Some of
gapiryapsiz?	are you talking about?
foydali	helpful
test	test
izhor&gt;	express &amp; gt;
(Stiven	(Stephen
280	280
kelganlar	arrivals
Arab	Arab
Yerdan	Thence
Brooks)	Brooks)
Xon	Khan
Individual:	Individual:
Texnologiya	Technology
so&#39;zlarini	the words
28:	28:
Boulder	Boulder
etdi.	.
ishonsangiz,	If you believe that,
&quot;Bure&quot;	&amp; Quot; Bure &amp; quot;
yonqutisi	yonqutisi
ular&gt;&gt;	&amp; gt; &amp; gt;
tasavvur	imagination
engp2008@nusunix.nus.sg	html>
qachon	when
o&#39;tmishda	in the past
kecha	yesterday
winfrvk@dutiws.twi.tudelft.nl	html>
qayta-post	re-post
&quot;^^^^&gt;	&amp; Quot; ^^^^ &amp; gt;
40-22k	40-22k
tejamkorlik	Coelho
willisw@willisw.ENG.CLEMSON.edu	html>
Systems	Systems
eshkaklar	Shovels
g&#39;amxo&#39;rlik?	Interested?
propter	propter
hitter	hitter
voqealar	events
Munosabatlar,	Relationships
Egalon	Possession
o&#39;rtasidagi	between
tiriltirgan,	raised
sharafiga,	honor
fazogirlar	astronauts
tortib	from
o&#39;lchamli	size
qisqa&gt;	short &amp; gt;
qadar	up to
adolatsizlik	injustice
Hayot	Life
Yer&gt;	Earth &amp; gt;
(men	(I
Ularning	Their
logo	logo
shaharlari	cities
talk.politics.guns	talk.politics.guns
&lt;BADING.93Apr23105229@athene.cs.tu-berlin.de&gt;	&amp; Lt; BADING.93Apr23105229@athene.cs.tu-berlin.de&amp;gt;
1971-yillar	1971
Stalin&gt;	Stalin &amp; gt;
muvaffaqiyatsiz.	failed.
rivojlanayotgan	developing
Xavfsizlik&quot;	Security &amp; quot;
ko&#39;rsatdi.	.
pubinfo.jpl.nasa.gov	html>
yaxlitlanadi,	is rounded,
&quot;keyin	&amp; Quot;
caltech.edu	html>
tasvirlar	images
240	240
Bruklin	Brooklyn
14-19&gt;	14-19 &amp; gt;
xalqi	people
qayirida	flood plains
istardim	I would like to
shahar)	city)
Besh	Five
kutilmagan	unexpected
Journal	Journal
manfaatdor	interested
jihozlangan.	equipped.
243	243
Ming)	Ming)
aniqligi	accuracy
1975-yillar	1975
gazlar	gases
abadiy	forever
ular,	they
munosabatlar	relationships
yarador	wounded
24-bit	24-bit
nazarini	angle
ISA	ISA
(Yoki	(Or
masalasidir.	issue.
oshiradi	increases
raqamlar	numbers
qilmagan	not
belgilari,	brands,
statistika	statistics
kesib	cut
sajda	sajda
yordam	help
Argo	Argo
sohillarni,	bank,
(Walter	(Walter
12.00	12.00
eritilgan	melted
yurtini	land
orangecar&#39;ait	LMH
250	250
happed.	Happening.
(Henling,	(Henly,
J23	J23
tubsiz	bottomless
silindir	cylinders
25.	25.
*****	*****
yomonlik	evil
yuqori&gt;	&amp; gt;
Telefon	Telephone
White	White
saylov	election
o&#39;ldi,	died,
yr	yr
ishonish	to believe
Rahmat.	Thank you.
Vashingtonda	Washington, DC
ma&#39;nosiz	meaningless
vakili	The representative of
yo	or
berlin.de	html>
&lt;1r0vk6INNaft@cronkite.Central.Sun.COM&gt;	&amp; Lt; 1r0vk6INNaft@cronkite.Central.Sun.COM&amp;gt;
tarixchisi	historian
Brenner	Brenner
GetGeometry	GetGeometry
boshqaruvchisi	Manager
Iaccoca	Iaccoca
yurib,	walking,
Shopper	Shopper
Matrix	Matrix
namuna,	model,
o&#39;rta	medium
tizimidan	system
theist	Theisen
Ushbu	This
yolg&#39;iz	lonely
qo&#39;yish	put
«Alloh)	Allah)
topilgan	was found
qo&#39;liga	the hand
g&#39;arbdan	the west
narsa)	)
narsa,	nothing
zimmasiga	the lead
Mitsubishi	Mitsubishi
Fazogirlar	Astronauts
**************	**************
xokkey	hockey
amatuer	amatuer
(Phil	(Phil
Pathfinder	Pathfinder
narsa:	things:
Falastinda	Palestine
vaqtini	time
qutqarishni	to deliver
soddalashtirilgan	simplified
App	App
Hard	Hard
Apr	Apr
Zabur	Psalm
Sport	Sport
qila	do
urush	war
o&#39;ylagan	thought
bo&#39;lardi	it would be
vfintd.386:	vfintd.386:
tavsiya	recommended
Stony	Stony
meniki)	mine)
sivilizatsiyasida	civilization
So&#39;nggi	Latest
vatt:	Watts:
qamrovli	FORUMS
muvaffaqiyatli	successful
tomonga	toward
almashishni,	exchange
shilmoq	graze
tashxis,	diagnosis,
heteroseksüel,&gt;,	heterosexual, &amp; gt ;,
Ongida	In the minds of
yahudiy,	Jewish,
baliqchi)	fishing)
baxtsiz	accidents
hall@boi.hp.com	html>
binoan	According to the
91%	91%
pharvey@quack.kfu.com	html>
noqonuniy	illegal
jazo	punishment
iqtisodiy	economic
balandligi	height
lippard@skyblu.ccit.arizona.edu	html>
Giants	Giants
Zbib)	Zbib)
faraz	Assuming
bor&quot;.	&amp; quot ;.
(GIF,	(GIF,
Brian	Brian
nosimmetrikliklar	the irregularities
kitoblarida	books
ta&#39;minlash	supply
Mariya	Maria
chiqish?	?
Ko&#39;rishlar	Views
Hawk	Hawk
shartlariga	the terms of the
allaqachon	already
kamroq	less
mag&#39;lub	defeated
jihozlandi.	equipped.
dunyoning	world
Havo	Air
&quot;un-vakolatli&quot;	&amp; Quot; un-authorized &amp; quot;
makr	hile
tushunchasi	The concept
ota-ichiga	parents
tekshirildi.	examined.
fan	science
narsa»	»
chiqishi	output
974	974
karta.	card.
tamoyillariga	the principles of
Kulgili	Ridiculous
katalogini	catalog
(872	(872
algoritmlarni	algorithms
Yaqinda	Recently
borar	on arrival
izlayotgan&gt;	Search &amp; gt;
Hays	Gays
ishlaydi-da,	at work,
&quot;biz	&amp; Quot;
Store	Store
foydalangan,	using
atmosferasida,	atmosphere,
banschbach	banschbach
Amerika	America
ko&#39;rindi,	appeared,
Suv	Water
ko&#39;rindi.	appeared.
tizimlar	systems
taqsimlash	distribution
gelişigüzel	indiscriminately
Sun	Sun
ko&#39;rgan	seen
(842	(842
ko&#39;rindi;	appeared;
tizimida,	the system
millionli	million
&quot;....	&amp; Quot; ...
munosabatda&gt;	Relations &amp; gt;
xil	the same
mail	mail
gijgijlash	driven
tushuntirishga	explain
qulfi&quot;.	Lock &amp; quot ;.
natijalari,	The results,
Herschel	Herschel
aytadi.	said.
Toronto,	Toronto,
Nissan	Nissan
Europa	Europa
billq@ms.uky.edu	html>
jumladan,)	including)
uzatiladi.	transmitted.
aylantirish	Translator
degani	mean
soqchi	guard
tomonidan	by
&quot;bir	&amp; Quot;
yahudiylarning	Jews,
ikki,	two,
aylanishi,	dizziness,
mashinalari	Machinery
Bu&gt;	&amp; Gt;
buyurdi.	ordered.
Shadow	Shadow
ma&#39;lumotlar	information
aytib	told
zabt	Climbing
Kifa	Cephas
ikki?	two?
ikkala	both
664-6354	664-6354
[nasroniylar]	[Christians]
tamoyillariga,	principles
shtatining	the state of
Bolalar	Children
Qanchadan-qancha	How many
&lt;wnk.734824081@aquifer.geology.uiuc.edu&gt;	&amp; Lt; wnk.734824081@aquifer.geology.uiuc.edu&amp;gt;
oqlash	justification
bo&#39;ladi.	.
mintaqadagi	region
&quot;bajarish&quot;	&amp; Quot; &amp; quot;
o&#39;zaro	mutual
ishonsangiz	If you believe
namelplate&gt;	namelplate &amp; gt;
yordamida	using
yonga&gt;	chip &amp; gt;
nomini	the name
bo&#39;ladi,	will
bo&#39;ladi?	?
Fiction	Fiction
&quot;orqa	&amp; Quot; back
jamiyatning	society
of&gt;	&amp; gt;
Tezroq	Faster
hujayralari	cells
bo&#39;lardi.	it would be.
So&#39;ngra	Then
bajardi	fulfilled
bo&#39;lardi,	it would be,
bo&#39;ladi;	;
vasiyat&quot;	testamentary &amp; quot;
balandlikdagi	at an altitude of
yetti	seven
atashimiz	call
kasalxonada	the hospital
Banklar	Banks
bo&#39;lmagan	do not
tasavvur,	Imagine,
xaloskor	life guard
marotaba	time
ushlab	hold
#From	#From
aql-idrok	intellect
xavfi	the risk
qilinmoqda,	It is,
========	========
qilinmoqda.	It is.
jo&#39;natib,	sending
Guns,	Guns,
&quot;Pushti	&amp; Quot; Pink
Statistika	Statistics
balandlik,	height
borligi	The presence
meteorit	meteorite
qismlarga	parts
qo&#39;pol	rough
Tan	Tan
Brothers	Brothers
frank@D012S658.uucp	frank@D012S658.uucp
vatin	batting
joyda	everywhere
Krsek)	Krsek)
turibmiz)	see)
INTERNET:	INTERNET:
Hutchison	Hutchison
kamaytirish	reduce
sohalarida	in the fields of
Hali	Yet
tushadi	will
Djakarta	Djakarta
grafik	graph
kiygan	wearing
tushkunlik	depression
olaman&gt;	I &amp; gt;
9:31	9:31
Noring	Norio
loyihasini	the project
&lt;19613@pitt.UUCP&gt;	&amp; Lt; 19613@pitt.UUCP&amp;gt;
Trondxeym	Trondheim
Mustaqillik	Independence
Galiley	Galileo
yarim)	half)
joyga	place
Merkuriy	Mercury
boshqalarning	others
O&#39;Dwyer)	O&#39;Dwyer)
&lt;e&#39;tiqod	&amp; Lt; faith
=========================	=========================
(tosh),	(Rock)
tepalari	dunes
formatlar	formats
eslash	to remember
begona	outsider
Hans	Hans
ning)	)
uu.net	html>
badiiy	artistic
sarflaydi.	spend.
go&#39;zal	beautiful
Sci.med,	Sci.med
Malumot	Reload this Page
&quot;Terminator&quot;,	&amp; Quot; Terminator &amp; quot ;,
imkoniyatlarni	opportunities
&quot;QUACK&quot;	&amp; Quot; QUACK &amp; quot;
94550	94550
ustidan	on
aralashma	mixture
egri	the curve
Frmwrks	Frmwrks
ko&#39;rganmisiz?	Have you?
Inning	Inning
(Rimliklarga	(Romans
tashqi	external
xalqlarga	nations,
oltingugurt-boy	sulfur-rich
(317)	(317)
Galileo	Galileo
kalit	key
Knowles&quot;	Knowles &amp; quot;
borib	Go to
mashinadan	the machine
aniqlandi.	identified.
qoniqarli	satisfactory
WAGNER,	WAGNER
plastinka	plate
nasroniylar	Christians
atmosferaga	the atmosphere
tutun	smoke
zaif	vulnerable
punjabi@leland.Stanford.EDU	html>
sayyoralar,	planets,
farq,	The difference,
xulosasi	conclusion
&quot;shifokorlarining&quot;	&amp; Quot; &amp; quot practice;
etan-metan	ethane-methane
Bicentennial	Bicentennial
boshlab	from
Siz	You
09:02:48	09:02:48
Yamakawa,	Yamakawa
may,	May
but-pastga	but down
o&#39;tadi	will
jalb	attracting
to&#39;plamini	a collection
ketdi;	;
Yorqin	Bright
qo&#39;llab-quvvatlaydi,	supports
jahannam	Hell
Qiyin	Hard
Clayton	Clayton
Yevropaliklar:	Europeans:
Sichqonchasi	MOUSE
saqlab.	maintain.
SuperVGA	Superve
ketdi.	.
saqlab,	save
oladi	includes
qilgan	who
ikki-astronavt	two-astronaut
qutilish	salvation
ozchilik	minority
Aslida	Actually
xabarlar	messages
Malaspina	Malaspina
(menimcha)	(I think)
84-yil	84 years
V-Mail:	V-Mail:
yurish	walk
bo&#39;lishiga	to be
Yoqub	Jacob
o&#39;ylagani	thought
ShU	DE
kodi	code
qanotlari	wings
toplar	tops
o&#39;sha	that
ketdi?	?
From	From
e_mail:	e_mali:
farqi	the difference
rioya	compliance with
plitalari.&quot;	plates. &amp; quot;
chips	chips
turmaydi,	monopoly,
gigantlar	giants
sakkiz	eight
Sir	Mystery
(xokkey	(Hockey
Kolorado,	Colorado
olmayman.	I can not.
haqiqatni	the truth
--------------------	--------------------
olmayman,	I can not,
Injilni	The Gospel
matn	text
Shu	This
Yo&#39;lovchilarning	Passengers
BIOS	BIOS
bormi	Is
kashfiyot	discovery
Demak,	Therefore,
er,	,
olmoq:	feeds:
gaplashayotgan	talking
anketalar	polls
(tvtwm)	(Tvtwm)
Ibrohimning	Abraham,
aytgan	said
shakllanishi	formation
(Chris	(Chris
fuqarolarini	the citizens
qonun&gt;	Law &amp; gt;
Masihning	Christ
keltirildi.	brought.
haqiqatga	reality
mulkiy	property
Narxlari	Prices
mahalliy	local
muzokaralar	talks
og&#39;diruvchi	Freezer
bosqichi	phase
bo&#39;lmasligi	not
ko&#39;rsatish	Show
etish	to
drayveri	driver
sci.med	sci.med
tayansak,	we rely on,
sistemleştirmek	systematize
(Darryl	(Darryl
Umuman	General
vfintd.386	vfintd.386
Anything	Anything
Dori	Dori
Zaif	Vulnerable
takliflarni	proposals
aniqlash	determination
metall,	Metal,
Macworld	Macworld
Bitnet	Bitnet
Denning	Denning
Vashington	Washington
somwhere	somwhere
eítiyotsizlik	reckless
vaqtida	timely
janubiy	southern
devide	David
Matto	Matthew
iste&#39;dod	talent
onboard	onboard
Sen	You
Ahd	Covenant
ezilgan	crushed
atmosferasining	atmosphere
ular	they
bobda	Chapter
Rabbimiz	Lord
uchun).	).
Emas	It&#39;s not
ishlari	works
chill	chill
keng,	wide,
esa	and
yopishgan	adhering to the
----------------------------------------------	----------------------------------------------
harakat,	action
mumkinmi?	Is it possible?
kolleji,	College,
Sotish	Sale
sys.ini	sys.ini
(Ey)	(O)
nasroniylik	Christianity
savolga	question
stansiyalari	stations
milliard	billion
do&#39;stim	my friend
Richard	Richard
TTL	TTL
futbolchilar	Players
:-)	:-)
Muhitini	Environment
odamsiz	you&#39;re
Chiroqqa,	Lamp,
evropaliklar,	Europeans,
tizimlari	Systems
Karlton	Carlton
harakat:	Action:
yoqimsiz	unpleasant
boshingni	head
soliq	tax
urushi	War
bo&#39;lishini	to be
Birinchi	First
noo&#39;rin	inappropriate
mana	here
again	Prompt
oak.oakland.edu:pub/msdos/windows3/winjp210.zip	html>
Air	Air
bormoqda,	is
tanasi	the body
dastur&gt;	&amp; gt;
navbatida,	In turn,
bormoqda.	is.
bormoqda?	is it?
Cuesta	Cuesta
seysmik	seismic
imkoniyati	the possibility of
ishonch	confidence
Kommutatsiya	Switching
namoyondalarining	practiced
C.)	C.)
kunda	today
Dodson)	Dodson)
&quot;gnostein?	&amp; Quot; gnostein?
mintaqada	region
ko&#39;rishingiz	see
Barqaror	Stable
ariza	application
kishi	People
tizimlar,	Systems,
topilgan.	found.
son-sanoqsiz	innumerable
koma	coma
xonadoshim	roommate
topilgan,	found,
tirilish	the resurrection
&quot;yaxshi&quot;	&amp; Quot; good &amp; quot;
eng	most
Ular	They
nuqta&gt;	Point &amp; gt;
&lt;188@ky3b.UUCP&gt;	&amp; Lt; 188@ky3b.UUCP&amp;gt;
BMP	BMP
TSC	TSC
tutadi.	Amount.
BMW	BMW
hissini	the sense of
ingl	visual
do&#39;st	friends
krater	crater
imkoniyat,	opportunity,
Giotto	Giotto
sinishi	fracture
strong&gt;	strong &amp; gt;
Shubhali	Doubtful
kon!	Mining!
Otasi	His father
jamiyat&quot;	community &amp; quot;
Barton)	Barton)
fikrlarini	the thoughts
daraja	level
orqasida	behind
qism	part
konini	mine
&#39;joylashgan.	&#39;.
&quot;orqaga	&amp; Quot; back
sening	your
ikkinchi)	second)
kommutatsiya	Switching
loyihalarni	projects
nasling	seed
mollarni	goods
qobiliyatini&gt;	the ability of &amp; gt;
parchalanish	DECAY
atmosferasi	atmosphere
ega.	.
&#39;93)	&#39;93)
manzara	scenery
ega,	,
tingladi.	clip.
Davis)	Davis)
Crash	Crash
vazifalarni	tasks
suyuq	liquid
Amr	Amr
mart	March
tavsifi	a description of
vaziyatni	situation
ega;	;
mikrometeoritleri	micrometeorites
C2.	C2.
go&#39;yo.	Goya.
(ayniqsa	(Especially
aylanayotgan	circulates
empedans	Impedance
Ana	Ana
texnologiyalari	Technologies
(),	()
1-301-340-4543	1-301-340-4543
().	().
degan	that
miyop,	miyop
munosabat-nazorat	attitude-control
investitsiyalash	investment
(10-105	(10-105
kimyosi	of Chemistry
candida	candida
&gt;&gt;.	&amp; Gt; &amp; gt ;.
Sayyoralar,	Planets
bloklari	blocks
&gt;&gt;,	&amp; Gt; &amp; gt ;,
vositalar	devices
ko&#39;zlarimga	eyes
jang	fight
Delaware	Delaware
email:	email:
755-8742	755-8742
qutqarishga	rescue
qayg&#39;u	sadness
sayyoralarda	planets
behisob	untold
Galant,	Galant,
sifatida,	as
jismoniy,	physical,
sifatida.	.
qasddan	intentionally
sifatida:	as:
Falastinga	Palestine
tez-tez	frequently
fundamental	fundamental
jmilhoan@magnus.acs.ohio-state.edu	html>
So.	H
jami	total
agar)	a)
agar,	if,
Namoz	Prayer
Markaz	Center
gt7469a@prism.gatech.edu	html>
guvoh	witness
1312	1312
Alt.psychology.personality	Alt.psychology.personality
rost,	True,
Nima	What
saqlash	conservation
ettirmaydi.	does.
atmosfera	atmosphere
Buy	Beacon
yurishlari	walks
borligini	the existence of
(6)	(6)
&lt;No.	&amp; Lt; No.
yangilangan	updated
tegishli	appropriate
miltiq&gt;	Rifle &amp; gt;
qilinadi&gt;	&amp; gt;
(59	(59
Adaptec	Adaptec
evro	Euro
qildi	found
uyasi	slot
salmon	salmon
Doimiy	Permanent
gif	gif
nega	Why
arab	Arab
mo&#39;ljallangan,	designed
buyurgan.	ordered.
sababli	Therefore,
(5)	(5)
huquqlar	Rights
Qonun	Law
Umbriel,	Umbria
ganimedes	ganimedes
qo&#39;llab-quvvatlash,	support,
oylar	months
Asteroids	Asteroids
Page)	Page)
neft	oil
qo&#39;riqlab	guarding
Barton	Barton
yadrosidagi	the core
qilsinlar.	let.
(4)	(4)
Bu,	This is
&quot;orbitasida	&amp; Quot; orbit
Landmann&gt;	Landmann &amp; gt;
ulagichlar	connectors
tizimlari,	Systems,
irodasi,	prompt,
Ning	S
kometalar	comets
vahima	panic
&quot;Evropa	&amp; Quot;
yadro	nuclear
normal,	normal
sindromi)&gt;	Syndrome) &amp; gt;
Mening	My
Agar	If
barcha?	all?
dogma	dogma
SUV	SUV
ko&#39;rinadi?	it seems?
Jismoniy	Physical
(3)	(3)
Obligatsiyalar	Bonds
etilgan	Fixed
ko&#39;rinadi.	will be shown.
qo&#39;llab-quvvatlashi	support
variaty	variaty
barcha)	All)
Capture	Capture
[26]	[26]
Aytib	Told
barcha.	all.
masalan,	For example,
(27	(27
dushmanlarini	enemies
zambil	Silt
ko&#39;rinadi)	it seems)
(24	(24
qutisi	Inbox
faqat	only
aylanayotib,	moves
aylanayotib.	orbits.
kodlangan	encoded
Uchun	For
kungi	daily
sindirish	break
kuni,	Day,
ongida	in the minds of
(2)	(2)
kelmading,	does not
Miranda,	Miranda,
======================	======================
tomondan,	On the other hand,
82:	82:
(1)	(1)
ko&#39;zga	eye
qoldirib,	leaving
ulangan	connected to
saqlanib	Preserved
============================================	============================================
(745	(745
yangilash	renewal
Bibliya&gt;	Bible &amp; gt;
[23]	[23]
LaStrange)	LaStrange)
Ruh	Spirit
kun-klub	-day club
ishlatish,	the use of
avtomobillari	cars
yuramanmi	harbor
qiyosiy	Comparative
aralashtirmang.	Do not mix.
jasorat	bravery
moddalar	substances
goaltender	goaltender
ekspluatatsiya	exploitation
ularning	their
optik	optical
tarixchilar,	historians,
[24]	[24]
nodir	unique
[25]	[25]
oldida,	in front of
Halqalarni	Rings
Avtomatlashtirilgan	Automated
yopiladi.	closed.
&quot;Pavel	&amp; Quot; Pavel
Diffie-Xellman	Diffie-Hellman
(Yuk	(Yuk
I3150101@dbstu1.rz.tu-bs.de	html>
7-sirt	7 surface
jh6r@andrew.cmu.edu	html>
(Bake	(Bake
shakllantirildi	formed
manevra	maneuverability
gaz	gas
iltimos	please
MUMKIN	MAY
so&#39;rab,	ask
qiling.	.
Sam	Sam
foydalanishingiz	use
import	import
eslayman,	I remember,
Cramer,	Cramer
elliptik	elliptic
Franjione)	Franjione)
Cramer)	Cramer)
Triantafyllopoulos	Triantafyllopoulos
quyilib	the concentration of
(?)	(?)
«ob&#39;ektiv	&#39;Objective
ring	ring
qiling!	please!
prognozi	the forecast
plutoneon,	plutoneon
boshladi&gt;	&amp; gt;
so&#39;yilgan	slaughtered
to&#39;laydi	to pay
buzilgan	corrupt
qanchalik	How
UUCP:!	None UUCP
raqamlari	numbers
&quot;ob&#39;ektiv	&amp; Quot; objective
Iste&#39;mol	Consumption
gay	GAY
Umumiy	General
poster	poster
salafiy	the predecessor
&lt;id.XNFZ.VJ8@nmti.com&gt;	&amp; Lt; id.XNFZ.VJ8@nmti.com&amp;gt;
&quot;q&quot;	&amp; Quot; q &amp; quot;
gap	sentence
mahalla	the neighborhood
ko&#39;zni	eye
=====================================	=====================================
9,846	9,846
posted	posted
variant	option
qilindi	were
edim!	I did!
aniqlash,	identify,
hobbiest	hobbiest
o&#39;zining	his
Depozit	Deposit
neon	neon
bermoq	grant
kelin-of-ko&#39;rinishida	point-of-view
sharaf	honor
&quot;atmosfera	&amp; Quot; the atmosphere
xira	pale
(Richard	(Richard
kislorod	oxygen
c23st@kocrsv01.delcoelect.com	html>
doimiy	permanent
6x9	6X9
Sifatida	As
&quot;Inson	&amp; Quot; Human
San	San
«Kim	&#39;Kim
nima.	what.
(Scott	(Scott
nima,	what,
kerakli	you want
ishlash	performance
boshlang&#39;ich	primary
Canadiens	Canadiens
unutdingizmi?)	Forgot your password?)
paytida,	During the
edik.	We were.
tushdi	toast
o&#39;rab	surrounded
Juda	Very
shuningdek&gt;	&amp; gt;
Kinsey	Kinsey
chiplari	chips
xterm	xterm
nima?	what?
uzatish	transmission
DES	DES
Finlyandiya,	Finland
standart	Standard
753-3245,	753-3245,
bo&#39;lishimiz	to be
2400	2400
qo&#39;llab-quvvatlasa,	supports
Rosa	Rosa
Rockville,	Rockville,
O&#39;qisak,	As far as
urdi)	hit)
ligasida	League
eshitilgan?	heard?
qilib	as
qoida	rule
(93	(93
o&#39;xshash,	like,
tuzatishlar	corrections
o&#39;rinda	place
edim.	I did.
cj195@cleveland.Freenet.Edu	html>
kuyrukluyıldızların	comets
stylizied	stylizied
qaraganda,	According to
eslatib	remind
politsiya	police
imon	faith
ayrilish	separation
uunet.	uunet.
joylashtirilgan	placed
(88	(88
oynasida	window
yodda	Remember
ESPN	ESPN
atmosferada	the atmosphere
harorati,	temperature,
betob	Check in
hamkorlikda	cooperation
​​201	201
(128.149.6.2)	(128.149.6.2)
masalaga	issue
Rowland,	Rowland
Kichik	Small
Vayss	WEISS
Shimoliy	Northern
&lt;1r1i7mINN4n4@cronkite.cisco.com&gt;	&amp; Lt; 1r1i7mINN4n4@cronkite.cisco.com&amp;gt;
olmang.	Do not.
eksklyuziv	exclusive
korenek@nmti.com	html>
o&#39;ylardim.	I thought.
amaldagi&quot;.	current &amp; quot ;.
sharoitlar	conditions
o&#39;rnatish	installation
arablaridan	Arabs
Hadi	Hadi
yahudiylarga	Jews,
jigarrang	brown
Gyuygens	Huygens
24:46	24:46
ba&#39;zan	sometimes
xaritalash	Mapping
umid	hope
achitqilari	Yeasts
uchdan	-thirds
Harumph.	Harumph.
barqaror	stable
hikoya	story
faoliyati	activities
Spin	Spin
xulq&quot;	behavior &amp; quot;
vacsc0qe@VAX.CSUN.EDU:	html>
Nelson)	Nelson)
davlatlar	countries
Astronomlar	Astronomers
kelgan&gt;	&amp; gt;
A&gt;	A &amp; gt;
Zbib	Zbib
yashaydi	lives
ro&#39;parasiga	exactness
paydo,	,
qilardi	Value
etilmoqda	are
(Bu	(This
VanHeyningen	VanHeyningen
Balki	Maybe
yodgorlik	memorial
yupqa	Thin
ammiak	ammonia
nozil.	revealed.
qulflangan	locked
kameralar	cameras
o&#39;ylab	Think
SKS	SKS
anglatadi	means
amaliyot	practice
hammasini	all
qilsa	If the
leonard@aix3090b.uky.edu	html>
2300	2300
Madaniyat	Culture
sizlardan	of you
rahbarlar	leaders
qaytgan	returned
&quot;qurol	&amp; Quot; arms
nozik,	fine,
Ammiak	Ammonia
haydovchi	driver
displeyda	the display
00ecgillespi@leo.bsuvc.bsu.edu&gt;	00ecgillespi@leo.bsuvc.bsu.edu&amp;gt;
ulardan	them
birdan	suddenly
End,	End
qilaman,	I
ketkazdi.	beguiled.
parchalanishi	decay
potentsial	potential
Qonunchilikni	The legislation
ikkinchi	second
Citizen	Citizen
o&#39;qotar	Rifles
415-	415-
olgan,	,
parented	parented
«SRESURRECTION:::	SRESURRECTION :::
anakartı	motherboard
ro&#39;yxatiga	the list
Afrika	Africa
asosiy	main
olib&quot;	&amp; quot;
to&#39;p	cannon
Biz	We are
to&#39;q	orange
G&#39;arbga	Westwards
his-tuyg&#39;ularini	feelings
yashagan	lived
Kirk.	Kirk.
&lt;jh6r+@andrew.cmu.edu&gt;	&amp; Lt; jh6r+@andrew.cmu.edu&amp;gt;
AQSh	United States
qurol:	Weapons:
infüzyonları	infusions
mening&gt;	I &amp; gt;
erkaklar	Men
do&#39;konlari	shops
xodimlari	staff
qilaman.	I am.
qurol,	weapons
Bir	One
United	United
beradi!	!
Robert	Robert
kilometr	kilometer
Lekin	But
hitter)	hitter)
Iordaniya	Jordan
do&#39;stlarim	friends
izlab	searching
SER	SER
SET	SET
moddiy	material
Re:	Re:
20-asrning	20th century
chetlashish	perturbations
beradi,	,
araştırdıktan	searching
Re?	Re?
beradi.	.
Public	Public
Red	Red
qilmoqda	Wants
Sizning	Your
beradi:	provides:
yoki	or
holatlar	Circumstances
dengizchilar	sailors
faoliyat,	activity
qilsa,	If the
plakatlar	posters
o&#39;zgargan,	changed
odamlarning	people
&quot;Jonathan	&amp; Quot; Jonathan
html>	html&gt;
flash	Flash
fikr	thought
SPL	SPL
o&#39;rni	The role of
moliyalashtirilgan	funded
ingichka	thin
foo	foo
bo&#39;ladigan	will
sinflari	classes
natijasidir.	as a result.
COD	COD
---------------------	---------------------
girdap	swirl
yondashuv.	approach.
stoli,	On the desktop,
yondashuv,	approach
fikr?	thoughts?
POBox	POBox
kiritdi	won
Ishga	Launched
Illustrated	Illustrated
o&#39;g&#39;li	his son,
shaxslar	persons
Kamida	At least
masalaning	issue
mohiyati	The essence
beysbol	baseball
meni,	me
yahudiylarni	Jews
Ron	Ron
mezonlari.	criteria.
menga	me
manfaatdormiz.	We are interested in.
O&#39;pka)	Lung)
bugun	today
Endi	Now
yulduzli	stars
buyumlar	items
Crawford	Crawford
qo&#39;lini	hand
narxda,	Prices
belgilab	defined
doirasida	within the framework of
munozara,	Talk,
yaxshiroq)	better)
murakkab.	complex.
ro&#39;yxatida	the list
Lebannon	Lebannon
quvonch	joy
PowerBook	PowerBook
IMHO,	IMHO
OLIY	HIGHER
Yuhanno,	John,
Milodiy	CE,
baland	high
Tarixan,	Historically,
(qayta:	(Re:
yilning	year
bo&#39;lmasa&gt;&gt;,	or &amp; gt; &amp; gt ;,
uzatish,	transmission
eksport	export
Nyu-Yorker,	New York,
Isoning	Jesus&#39;
boruvchi,	outgoing,
kurash	struggle
Spot	Spot
ko&#39;rsatilgan	are shown
o&#39;zgardi	changed
Yahudiy	Jew
uzuk,	rings,
noqulayliklarni	discomfort
(5,25	(5.25
asar	trace
qishda	in winter
(J.	(J.
eksantrikliği	eccentricity
»,	&#39;
274-5357	274-5357
».	.
&lt;1993Apr21.234159.1206@ualr.edu&gt;	&amp; Lt; 1993Apr21.234159.1206@ualr.edu&amp;gt;
duch	face
yagona	only
ko&#39;rmagan	seen
&quot;Drakula&quot;	&amp; Quot; Dracula &amp; quot;
[standart	[Standard
maydon	area
yog&#39;och	wood
...]]	...]
Ommaviy	Mass
nuqtasi,	point,
ibodat&gt;	prayer &amp; gt;
(Edward	(Edward
hafta	week
asosan	basically
Regards,	Regards,
qalin	thick
Kitobda,	Book
muhokama	discussion
taxminan	approximately
skaner.	scanner.
geyzer	geyser
qo&#39;llaniladi)	apply)
keltirib	Bring
(kim	(Who
Matsuo,	Matsui
so&#39;rash	ask
Xokkey	Hockey
farqlar	differences
oshiriladi?&quot;	? &amp; quot;
yaqin-up	close-up
fuqarolik	citizenship
15-ilon	15-snake
Indoneziya	Indonesia
departamentining	Department
kimdir&gt;	someone &amp; gt;
Barcha	All
Columbia&gt;	Columbia &amp; gt;
Xodimlar	Personnel
o&#39;roq	sickle
parolini	decrypt
Bos	Bos
90%	90%
So&#39;rov	Request
video,	video
keyin,	then,
Monreal,	Montreal,
Yoki	Or
qilayotgan	you do
galma	alternately
mehmondo&#39;stlik	hospitality
qaragan	facing
fayllari	files
Odamlar	People
missiya	mission
yosh	young
omadsiz	unlucky
OpenLook	OpenLook
Bunday	Such
aytiladi.	said.
Vehical	Vehical
ta&#39;siri:	the effect of:
sharma@tiger.vill.edu	html>
ziyolilar	intellectuals
asrlar,	centuries,
faoliyatida	the activities of
ta&#39;sir&gt;	&amp; gt;
trayektoriya	SPIE
tortish	gravity
hayvonlar	animals
&lt;C5w5CB.Ct4@rahul.net&gt;	&amp; Lt; C5w5CB.Ct4@rahul.net&amp;gt;
video	video
(&lt;o&gt;	(&amp; Lt; o &amp; gt;
sayyohni	tourists
quyruq	tail
^^^^^^^^^^^^^^^^^^^^^^^^^^	^^^^^^^^^^^^^^^^^^^^^^^^^^
topmadik.	Can not find it.
(John	(John
ko&#39;rsatgan.	.
jinoyatchilar	criminals
qondiradi.	sufficient.
Bundan	In addition,
73,	73
He&gt;	He &amp; gt;
Friedman	Friedman
kaliti,	the key
hukmronligi	the rule
yuboriladi	sent to
bir:	a:
kichikroq,	smaller,
kengash	council
bir,	a
nomidagi	named
Station	Station
27.6	27.6
Thanx	Thanx
axloqini	morals
Najotga	Salvation
voqea	event
qobig&#39;ining	the crust
jurnallar	Log in
(lekin	(But
hukumatining	the Government of
rejalari	Plans
emasman&quot;	I am not &amp; quot;
hunar	profession
Lampoon_	Lampoon_
Asteroid	Asteroid
Selannes	Selannes
taqdim),	)
izlayapman.	I&#39;d like.
ukasi	his brother,
OLIVEIRA	OLIVEIRA
foydalanishni	the use of
biri	One of the
suv-muz	water and ice
sho&#39;ng&#39;idi	and dived
410-34-1	410-34-1
Software	Software
yogurt	yogurt
dinamik	dynamic
to&#39;lash	to pay
Hitter	Hitter
ko&#39;tardi	raised
kata	on the floor
qutb	pole
Tezligi	Speed
[Bo&#39;ldi	[It has been
kengashi	The Board of
Buyurtma	Order
&quot;Uran	&amp; Quot; Uran
700	700
703	703
kuchga	force
tayanib	Relying on
Va,	And
serverda	the server
Microsoft	Microsoft
Maplewood	Maplewood
yaratilgan.	created.
elementlarning	the elements
Kennedi	Kennedy
voqea,	event
DX)	DX)
tashrif	visit
dan	from
dam	rest
tasvirni	image
gazni	gas
&quot;optik	&amp; Quot; optical
o&#39;ylayman),	I think)
Cup	Cup
dumaloq	round
I&gt;	I &amp; gt;
Lee)	Lee)
besoqolbozlik	Homosexuality
ABI,	ABI
tarkibiga	part of
Nanaimo	Nanaimo
soni.	.
&lt;o&gt;)	&amp; Lt; o &amp; gt;)
&quot;imkonini	&amp; Quot;
maydoni,	area
Kennedy	Kennedy
vaqtinchalik	temporary
cl056@cleveland.Freenet.Edu	html>
(Spiros	(Spiros
o&#39;rinli,	seats
kallapo&#39;sh	kulupush
7,5	7.5
ishongan	who believes
ko&#39;rgan.	.
maydonga	pitch
kasb	profession
Moroccans	Moroccans
uyimni	house
ko&#39;rib,	,
emasmanmi?	Am I?
&lt;1APR199313404295@skyblu.ccit.arizona.edu	html>
1200	1200
200uf	200uf
devi&quot;	Giant &amp; quot;
vitamin	vitamin
haydovchilar	drivers
redraws	redraws
gapira	to speak
(61302	(61302
Ave.	Ave
Psevdo-tibbiy	Pseudo-medical
samolyot	aircraft
ravishda,	Accordingly,
g&#39;azabini	the anger
Henry	Henry
atalmish	called
ibodat.	prayer.
Whitten	Whitten
Tushuntirib	Explain
ibodat,	worship
ming&#39;irlaydi	mutters
zbib@bnr.ca	html>
betel@camelot.bradley.edu	html>
muolajalar	treatments
kengaymoqda	expanding
ayrim	separate
va.	and.
&lt;,	&amp; Lt ;,
hajmi	The volume
va,	and,
(IMHO)	(IMHO)
o&#39;tmishda,	in the past,
so&#39;zlar	the words
oshirildi.	increased.
McCord,	McCord
va!	and!
ularga	them
DOSKEY	DOSKEY
(mening	(My
qatlam	layer
home	home
MS-Windows	MS-Windows
raketa&quot;	Rocket &amp; quot;
Pentium	Pentium
foydalanilgan	was used
_outside_	_outside_
(Medicare	(Medicare
(Milliy)	(National)
dahshat&gt;	Terror &amp; gt;
rauser@fraser.sfu.ca	html>
jarayonlarini	the processes
istaydi,	wants
empirik	The experimental
HMMMMMMMMMMMMMMMMMMMMMMMMMMMMMMMMMMMMMMMMMMMMMMMMMMMMMMMMMMM	HMMMMMMMMMMMMMMMMMMMMMMMMMMMMMMMMMMMMMMMMMMMMMMMMMMMMMMMMMMM
Fayl	File
o&#39;zida,	at
Tuzatish:	Correction:
ularda	they
Deb	That
oshirildi?	increased?
qonunlari	laws
badjahl	angry
(severy)	(Several)
bor).	).
o&#39;ylayman.	I think.
o&#39;ylayman)	I think)
​​_him_	_him_
axloqiy,	Ethics,
keyingi?	next?
o&#39;ylayman,	I think,
Xiram	Hiram
Oberon	Oberon
homo	homo
.....	.....
Van	Van
alanga	flame
&lt;2958804@QUCDN.QueensU.CA&gt;	&amp; Lt; 2958804@QUCDN.QueensU.CA&amp;gt;
ishqalanish	friction
Office:	Office:
yig&#39;ilib	Rollaway
viloyat,	regional,
Wai-Ming	Wai-Ming
dunyoda	the world
buzmasdan	without breaking
ifodalaydi.	icons.
olqishlaymiz.	welcome.
litsenziyaga	licensed
tashlashdi	cast
tutyapman.	I mean.
qulf	lock
xususiyati	feature
esgan	esen
&quot;Lekin,	&amp; Quot; However,
sinüzit	sinusitis
qo&#39;shnisidan	neighbor
uzr	apology
Mags&gt;	Mags &amp; gt;
Terrorizmga)	Terrorism)
gt7469a@prism.gatech.EDU	html>
Frank	Frank
taxmin?	guess?
taqiqlash,	Prohibition
622121	622121
energiya	energy
narxlari	Prices
&lt;Men	&amp; Lt; I
joylardan	places
Dastur	Program
biz,	We,
yanvar,	In January,
fanining	science
hazir	beware
1978,	1978
farqlarni	differences
muxlislari	fans
manzarani	picture
taxmin,	estimated
samarali	effective
Ya&#39;ni,	That is,
hazil	fun
Kreiling)	Kreiller)
yuborilishi	sent
Dan	From
sxema	chart
chetda	aside from
Regio	Regio
&quot;arab?&quot;	&amp; Quot; Arab? &amp; Quot;
uya	Automation,
kuchli	strong
o&#39;rgatish.	teaching.
cratered.	cratered.
orbiters	orbiters
hisoblayman	I think
muxlislar	fans
goolsbey@cs.utexas.edu	html>
tortiladi	subject to
ma&#39;lumotni	information
750	750
Ford	Ford
tashqari	except
avtomobil	car
tipi	Aerospace
Faehl	Faehl
oladi)	)
oladi,	,
oladi.	.
tayanch	base
nishonlash	celebration
organlarning	bodies
VLB	VLB
32-bit	32-bit
Earth-o&#39;lchamli	Earth-sized
Avgust	August
bo&#39;lyapti	iterated
king@reasoning.com	html>
emasligini.	not.
yo&#39;l	road
dunyoni	world
486DX-33	486DX-33
yo&#39;q	no
4.0-4.3	4.0-4.3
tizimli	systemic
parametrlarni.	parameters.
oqimi,	flow
shovqin	noise
uzoqlasha	to drift
Cleopatra	Cleopatra
beriladigan	issued
ketadi.	Expenses.
Ular&gt;	They &amp; gt;
ketadi,	going
o&#39;tish&gt;	&amp; gt;
buyurtma	order
yashil	green
Mars,	Mars
Steve	Steve
VLX	VLX
tanaffus	break
R&gt;	R &amp; gt;
DLC	DLC
ko&#39;rish	View
jarayonlarni	processes
blaisec@sr.hp.com	html>
diagramma	the schema
VMS	VMS
Duglas	Douglas
ayblashadi.	accused of.
Etarli	Sufficient
Um,	Um,
Farangeyt)	Fahrenheit)
Plutondan	Pluto
darcha	window
ekan&gt;&gt;	&amp; gt; &amp; gt;
unga	her
Mocker)	Mock)
DMA	DMA
tanqid	criticism
o`chirilishi	MUTE
zaryad	charge
nuqtada,	At that point,
va&#39;z	sermon
Algoritm	Algorithm
uzr,	Sorry,
manzarasi	Landscape
(Hal	(Hal
Mitsubushi	Mitsubishi
gapirib,	speaking,
(Ham	(Well
----	----
yonga,	chip,
tirilgan	resurrected
yozish,	write
to&#39;liq&gt;	&amp; gt;
uzoq	far
(bo&#39;lishi	(To be
Iso&gt;	Jesus &amp; gt;
______________________________________________	______________________________________________
hayot	life
bor.)	there.)
yaxshilaydi.	improves.
Tashqari,	In addition,
&lt;May.12.04.27.47.1993.9935@athos.rutgers.edu&gt;	&amp; Lt; May.12.04.27.47.1993.9935@athos.rutgers.edu&amp;gt;
Uni	Her
berganda	When
imkoniyat	opportunity
ko&#39;ryapsizmi?	Do you see?
ron.roth@rose.com	html>
atrof-muhit	the environment
shakllantiradi,	form
ko&#39;ring	Try
to&#39;g&#39;riligi	the accuracy of
Teodor	Teodor
ikkinchi-tartibi	The second-order
ishlatiladi	is used
bajarilgan	performed
qo&#39;ndi	landed
orbitasi:	orbit:
&quot;Stiven	&amp; Quot; Stephen
og&#39;riq	pain
nazar	look
&quot;Borland	&amp; Quot; Borland
5500	5500
tarkibi	composition
Elektr	Electric
o&#39;yladim	I thought
xo&#39;jaligi	Agriculture
7.00	7.00
atrof-muhit,	environment,
(317)743-1394	(317)743-1394
beshinchi	fifth
uzuk	ring
Kasal-tabib	The patient-physician
xelion	Xelil
juliet	juliet
yashashni	to live
g&#39;oyaviy	ideological
140-165	140-165
bilimdon	knowledgeable
Kishi	People
qog&#39;ozga	the paper
davlatni	state
kavlash	entrenching
bo&#39;lishini,	,
(qayta	(
derazadan	the window
ijtimoiy-kalit	public-key
batman@cisco.com	html>
tuzatish,	correction,
(-290	(-290
kabi	such as
tizimi,	System
(Aaron	(Aaron
bor-ku.	is there.
oson	easy
(-298	(-298
tizimga	log in
(masalan,	(For example,
umr	life
Deportes	Deportes
tizimda	system
shakllari	forms
(masalan)	(Example)
yurgan	walking
mutaxassis.	staff.
zohiriy	The apparent
Diffie-Hellman	Diffie-Hellman
dunyolar,	worlds
Falastinliklar,	Palestinians
8,6	8.6
sahrolarda,	deserts,
lavozimidan	the position of
million	million
kashf,	discover,
ekstrapolyatsiya	extrapolation
hayotdirman	life
8.1	8.1
uni	her
munozara	dispute
rahbarlari	Heads of
ixtirochi	The inventor
Rosenau)	Rosenau)
Ya&#39;ni	That is,
Prezident	President
misoldir.	example.
harakatlar	actions
modellashtirish	Modeling
tanlang.	Select.
atrofida	around
kuzatish	observation
sababi	The reason
xavfsizlik	security
jamoalarini	teams
_____________	_____________
daryolar	rivers
ishonamiz.	We believe that.
Apollon	Apollo
shaklidagi	in the form of
(Bibliya	(The Bible
qolgan.	.
(NRSV)	(NRSV)
butaning	bush
janob,	Mr.
ulangan?	connected?
(Ishoq	(Isaac
Mouting	Mouth
8,1	8.1
ORIGINAL	ORIGINAL
QANDAY	HOW
Otaning	The father
ulangan)	connected)
alane@microsoft.com	html>
gomoseksualizm	homosexuality
hit&gt;	hit &amp; gt;
afronted	afronted
radio	radio
avgust,	August
hujumga	attack
yopildi	closed
asteroids	Asteroids
keskin&gt;	Critical &amp; gt;
orbitalari	orbits
radar	radar
DEVICEHIGH	Subsitute
chora	measures
Springs,	Springs
evropalik	European
olimlar	scientists
UUNET:!	None UUNET
&quot;Yahudiy	&amp; Quot; Jews
shartlar	conditions
miqdori	The amount of
JPB-sertifikatlangan	NRA-certified
oxiri	the end
Clr	Clr
issiqlik	heat
Yernikiga	Earth
reyslar	flights
ayblashga	blame
masalalar	issues
Stein	Stein
Howdy!	Howdy!
9.128:	9.12:
sintezlashga	fusing
Gretzky	Gretzky
to&#39;pponcha	pistol
pastlab.	slowdown.
unda	then
deydi	says
Unga	Her
DOS	DOS
deraza	window
orollar	islands
(Leonard	(Leonard
ayblovlarni	accusations
tajriba	experience
zulm	wronged
&lt;1qvb5aINNmoi@darkstar.UCSC.EDU&gt;,	&amp; Lt; 1qvb5aINNmoi@darkstar.UCSC.EDU&amp;gt ;,
tadbir	event
dastur	program
thanks,	thanks
(har	(
mavjudotlar	assets,
seriya	serial
vaqti	time
«vaqtinchalik	&#39;Temporary
tashviqot	propaganda
microsoft	Microsoft
Jo&#39;natuvchiga)	The sender)
belgilangan.	established.
ketyapsan?	are you going?
Misr	Egypt
Deptt.	Dept.
Siz&gt;	You &amp; gt;
tarkibini	the contents of the
Dovudni	David
azob-uqubatlarga	Suffering
chekishi	to suffer
belgilangan,	,
nuqta	point
bo&#39;yicha	on
tadqiqot&quot;	Research &amp; quot;
Masih&gt;	Christ &amp; gt;
(Michael	(Michael
eshitildi.	heard.
cheklangan	limited
mamlakatlarda	countries
boradi	will
g&#39;amxo&#39;rlik	care
hududlar	territories
utzoo!	utzoo!
qoladi.	remains.
qoladi,	remains,
uchirish	Throwing
taxmin)?	guess)?
kutilmoqda,	expected
Germaniya	Germany
ko&#39;rsatib,	,
mukammal	perfect
illyuziya	Illusions
qilamanki,	I
FAQ	FAQ
klinik	clinical
deb&gt;	&amp; gt;
turadi.	.
sguerke@brahms.udel.edu	html>
patlarni	feathers
koutd@hiramb.hiram.edu	html>
kulba	hut
lift-off	lift-off
CLEAR	CLEAR
yangi.	new.
yangi,	new,
imoni	faith
shakllantirdi.	formed.
V9R	V9R
inkor	denied
o&#39;liklar	dead
manfaati	the benefit
tuzoqqa	Saran
kelsak.	As.
aloqalar	Relations
markaziga	center
Shtatlarida	States
yo&#39;lovchilarning	passengers
uch	three
Stalin	Stalin
aqlli	smart
dengizda	the sea
qanday.&quot;.	. &amp; quot ;.
hayvon	animal
tartib	order
oqimlarni	streams
ekspeditsiya,	expedition
hodisa	event
AAS-92-186,	AAS-92-186,
ikkovlari	both of
vaqt.	time.
tog&#39;li	mountainous
bo&#39;lmadi,	not
berdimi	Was
tasvirlari	The images
Kuchliroq,	Stronger,
(aniq)	(Clear)
23-25).	23-25).
tadqiqot	research
tovushlar	sounds
degani?	mean?
sifatli	quality
korenek)	korenek)
committ	committ
tovushlar.	sounds.
to&#39;sqinlik,	prevent,
1/1000,	1/1000
tug&#39;ilgan,	birthday,
odamlar,	people
sentyabr	September
tug&#39;ilgan.	was born.
mintaqani	region
bayonot	statement
&lt;Rauser.734062608@sfu.ca&gt;	&amp; Lt; Rauser.734062608@sfu.ca&amp;gt;
deydi,	he said,
tartibi,	Order,
qaytish	Back to
Ishoqning	Isaac
markazida	in the center
degani,	means
yo&#39;lda	on the road
qirqish	cutting
ailin):	Aili):
deydi.	he said.
qoidalarini	the rules
lmouse	lmouse
dalil-belgilar	evidence of character
deydi:	He says:
vaqt,	time
degani.	mean.
vaqt)	time)
Olti	Six
(2.147	(2,147
(Mustaqil	(Independent
tirik	live
sabab,	,
issiq	hot
uyat	shame
kamari	Belin
paketini	package
komissiyasining	Commission
6,4	6.4
foydalanib	Using
ega	have
marsliklarni	Martians
qoidalariga	the provisions of
cherkov	church
yo&#39;lga	Path
99.9	99.9
(29.95)	(29.95)
kelinmoqda.	being.
pastlab	The slowdown in
tuyuladi,	It seems,
aqlga	mind
engashib	He stooped down
tuyuladi.	it seems.
so&#39;zlarning	the words
kostyum	suit
1972-yilda,	In 1972, the
eslab,	Remember,
qaramay,	However,
Banklar)	Banks)
Parallel	Parallel
bo&#39;lsangiz	If
nelson_p@apollo.hp.com	html>
ko&#39;rishni	see
odamlar&gt;	People &amp; gt;
(932	(932
Dorothy	Dorothy
.indiana.edu	.indiana.edu
nomzod	candidate
Qonuniga	The law of
so&#39;ng	after
foydalana	use
gapirish	talk
ota-	of yore
edi	was
o&#39;yin,	game
zumga	tremulous
qutblari	ends
doim&gt;	always &amp; gt;
6-7	6-7
mablag&#39;lar	funds
&quot;Konstantinov&quot;	&amp; Quot; Konstantinov &amp; quot;
saqlanadi.	saved.
&quot;ko&#39;k	&amp; Quot; blue
degandi	Pinturicchio
oralig&#39;ida	the range
haqiqat	truth
Radio	Radio
topganingizni	you&#39;ve
komplekson	complexion
omili	factor
izlari	Traces of
keskin	abrupt
tug&#39;ilganidan	the birth
saralash	qualifying
Qonunning	The law
aytaman.&quot;	I say. &amp; quot;
muvofiq	according to
dushman	enemy
THEWITNESS	THEWITNESS
Quorum	Quorum
xushxabarni	the good news
missiyalar	missions
POSTITION	POSTITION
chaqiradi	calls
&lt;_Atheism	&amp; Lt; _Atheism
yolg&#39;on.	false.
oyna)	window)
albatta&gt;	&amp; gt;
oqimlari,	currents,
waiiiiiit,	waiiiiiit
birodarlarga	brothers
Biroq,	However,
bag&#39;ishlangan&gt;&gt;	dedicated &amp; gt; &amp; gt;
Empedans	Impedance
mumkin!	You can!
atmosferasi,	atmosphere,
ob&#39;ektlar	objects
bo&#39;lgani,	,
mumkin)	)
ayniqsa	especially
Shostack	Shostack
oqlashga	to justify
&lt;...	&amp; Lt; ...
mumkin.	.
mumkin,	You can
natijalari	The results of the
mumkin:	You can:
orientatsiya	Orientation
Hughes	Hughes
Baqoevning	Bakaev
kosmik	space
(g&#39;arbdan	(West
mumkin?	You can?
qo&#39;llaniladi)&gt;	used) &amp; gt;
294-8153	294-8153
Jonson	Johnson
muloqot	dialogue
mumkin;	You can;
so&#39;ra	Ask
Montes,	Montes
ma&#39;lumotlarni	information
(900	(900
o&#39;lchash	measurement
ravishda	In
insonning	man
Uch	Three
kamar,	belt,
erkaklarga	men,
1200-1500	1200-1500
Ilohiy	Holy
geb@cadre.dsl.pitt.edu&gt;	geb@cadre.dsl.pitt.edu&amp;gt;
Gomoseksualizm	Homosexuality
ko&#39;rmadim	I did not see
6:.	6 :.
&quot;qattiq	&amp; Quot;
tavba&gt;	Stuffed &amp; gt;
Dodson	Dodson
barpo.	building.
VDC	VDC
McDONNELL	McDONNELL
evropaliklarga	Europeans
5X9	5X9
Windows,	Windows,
istisnolar	The exemption
o&#39;tdi	held
bo&#39;ronlari	storms
(orqaga)	(Back)
Landers	Landers
niqoblangan,	Mask,
shag&#39;al-o&#39;lchamli	gravel-sized
kislota	acid
Gary	Gary
tog&#39;orani	basins
bolalar	children
&quot;Foydalanuvchi&quot;	&amp; Quot; &amp; quot;
vax839@tid.es	html>
(Sanjeev	(Sanjeev
radar-xaritalash	radar-mapping
atom	atom
Bonds	Bonds
qabul,	,
MLINDROOS@FINABO.ABO.FI	html>
qabul)	)
quruqliklar	land
VGA	VGA
&quot;Bizning	&amp; Quot; Our
640	640
maxsus	special
aniqlanadi	determined
oylar,	months
bo&#39;lishi)	)
sirlaridan,	points,
armada	armada
Graphics	Graphics
hujjatlarni	documents
inqilob	revolution
eshak	donkey
Baptist	Baptist
Ichki	Internal
yoritib.	illuminate.
(JT)	(JT)
siz&gt;	&amp; gt;
mukofot	award
San-Xose,	San Jose,
uçurumlar	Cliffs
otash.	flame.
ko&#39;rinadi	it seems
adolat	justice
doiralar	circles
tun	night
Mercury,	Mercury,
shifrlash	encryption
yaxshi	good
tovushlar,	sounds,
to&#39;la.	full.
eshitsa.	hears.
gravity	gravity
olindi	Retrieved
bo&#39;lmaydi.	is not.
Marty	Marty
makon	space
bo&#39;lmaydi,	not
Atkinson	Atkinson
Voice:	Voice:
(JPL	(JPL
chizish&quot;	Drawing &amp; quot;
soğutulur	cooled,
muddatli	-term
486DLC-33	486DLC 33
bo&#39;lmaydi:	not:
sonlar	numbers
kemalar	ships
Brian,	Brian,
darajasida	level
tuzatish	correction
oylari	months
chiroqlari	lights
VHS	VHS
mustasno),	except)
peer	peer
bo&#39;lishi;	to be;
oling,	Learn
Houston	Houston
Round	Round
noma&#39;lum	unknown
Apelsin	Orange
650	650
oling.	.
bo&#39;lishi.	.
jihozlangan	equipped
missiyasining	the mission of
bo&#39;lishi,	,
FBI	FBI
o&#39;tishingiz	record
umidsizlik	disappointment
Zoologiya	Zoology
lava	lava
iyunda	June
quibble-	quibble-
ko&#39;proq?	more?
otib	shot
urf-odatlari	traditions
asosiy-haroratga	The main temperature
bilamiz.	We know that.
bombardimon	bombing
boshidan	the beginning
don	grain
serverlardan	servers
bo&#39;ladi	will
km@ky3b.pgh.pa.us	html>
oldi.	.
Axborot	Information
tegdi,	touched,
Sanjeev	Sanjeev
mamlakatlaridan	countries
dos	dos
bilamiz?	we know?
tojni	crown
dünyadışı	extraterrestrial
qaytib,	back,
yuqumli	infectious
nikel	nickel
tashlaydi	throw
pelting	Pelton
hodisalarni	events
&quot;ob&#39;ektiv&quot;	&amp; Quot; objective &amp; quot;
mavjud»	there is&quot;
rock,	rock,
(-366	(-366
dpi	dpi
Nunnally@acs.Harding.edu	html>
shogirdlari)	Students)
silkitib	waving
davr	period
kilogramm	kilo
uchinchi	third
American	American
ekranda	screen
windows	windows
Ehtimol	Probably
statistik	statistical
Bading)	Art)
bolalar&gt;	Kids &amp; gt;
ehtimol	probably
Siemon)	Siemon)
bashoratlar	prophecies
DoD	DoD
so&#39;raymiz	ask
unalterably	unalterably
temir	iron
siyoh	ink
kasallik,	disease
tomonidan.	by.
400dpi)	400dpi)
tomonidan,	by
Aksiga	Mishap
to&#39;qqizinchi	ninth
ingichka,	fine,
Logitech	Logitech
topish,	find
northeners	northeners
topish.	find.
shartnoma	contract
stantsiyalari	stations
fazoda,	space
FAX;	FAX;
Luqo	Luke
hokimiyatga	authority
maqsadida,	In order to
LEKIN,	BUT,
bilish	to know
somon	straw
kalitlari.	keys.
kanallar	channels
(Edmonton,	(Edmonton,
ularni	them
spiral	spiral
blokirovku	crash
o&#39;tdi.	.
Bo&#39;yicha	On
xususiyatiga	Specification
(Dave	(Dave
yo&#39;qolgan	lost
Information	Information
yozuvlarni	records
tanitadi,	Contracts,
yamaha	yamaha
auroras	auroras
istamayman!	I do not want!
hisoblanadi&gt;&gt;	&amp; gt; &amp; gt;
Brenn)	Brand)
geliy	helium
Tim	Tim
efirga	broadcast
Brenn,	Brenn
tayyorgarlik,	preparations,
ishlatiladigan	used
Anonim	Anonymous
ma&#39;lumotga	information
256k	256k
shohiddir	Witness over
avvalgilaridan	previous
qimirlagan	loose
signallarining	signals
berib	giving
bo&#39;lishni	to be
optilink	optilink
ketsa,	If the
newsdesk@jplpost.jpl.nasa.gov	html>
bulutlarni	the clouds
taymerni	timer
qiziy	glow
yondashuv	approach
&quot;ma&#39;lumotlar	&amp; Quot;
&lt;1993Apr7.221357.12533@lamont.ldgo.columbia.edu&gt;	&amp; Lt; 1993Apr7.221357.12533@lamont.ldgo.columbia.edu&amp;gt;
yozuvchilar	writers
mavjud;	there is;
So&#39;z	Word
qiziq	funny
&quot;foydalanuvchi&quot;	&amp; Quot; &amp; quot;
o&#39;tdi;	held;
qizil	red
sichqon	mouse
asta-sekin	Step by step
&quot;real&quot;	&amp; Quot; real &amp; quot;
daralarda,	gorges,
stephen@orchid.UCSC.EDU	html>
samimiy,	warm,
o&#39;tib	later
(Dostoevskiy)	(Dostoevsky)
cheklangan,	limited
ochiq	open
yumshoq	soft
uyqu	sleep
xabardorligini	awareness
Yordamingiz	Help
(ya&#39;ni	(Ie
1.00)	1.00)
kaykay	skateboarding
mitti;	Dwarf;
Bono,	Bono,
sohasida,	in the field,
faol,	active
Wanderers	Wanderers
(salbiy	(Negative
oldim	I got
oldik	We received
&gt;&gt;&gt;	&amp; Gt; &amp; gt; &amp; gt;
to&#39;liq	full
salbiy!	negative!
bayonotida	a statement
oldin	before
«Men	&#39;I
isbot	proof
tug&#39;diradi.	poses.
tog	mountain
qanoti	wing
dastlab	originally
-----------------	-----------------
psevdo-ta&#39;limotning	pseudo-doctrine
10:34	10:34
aylanadi	converted to
hisobotlarni	reports
tugatish	completion
qilyapsiz,	doing
turtki	impulse
Cassini	Cassini
charog&#39;on	lit
bag&#39;ishlanib	dedicated to
Biz,	We,
tom	roof
kishisiga	to whom
beri,	Since then,
maxfiylik&quot;,	Privacy &amp; quot ;,
nuri	Nuri
tor	narrow
nereid	Nereid
Erkak	Male
fuqaroligini	citizenship,
mavjud.	there is.
ochko	point
(Version	(Version
&gt;	&amp; Gt;
aloqasi	connection
e&#39;tiborli	reputable
Savollar:	Questions:
kimgadir	someone
(Genri	(Henry
10&quot;	10 &amp; quot;
Yuzasining	Superficial
eslang	remember
schauf@iastate.edu	html>
anti-ishonch	anti-trust
oylarda	months
va&#39;dalar	promises
Dunyo	World
bo&#39;luvchi	Dividers
Shunga	Nevertheless,
bo&#39;lgani	is
4/26/93	4/26/93
100K	100K
o&#39;ylayman	I think
Explorer&gt;	Explorer &amp; gt;
&gt;&gt;&gt;&gt;	&amp; Gt; &amp; gt; &amp; gt; &amp; gt;
Campus)	Campus)
Venusian	Venusian
Tom	Roof
etilmoqda.	being.
Omad	Luck
mavjudligini	the existence of
Lei)	Lei)
Masih	Christ
yolg&#39;on	lie
xavfli	dangerous
taqqoslashlar?	Comparisons?
2-ning	2
shaklda	form
100,	100
yashaydi,	housing,
Oxirgi	Last
tushirildi.	put.
1000	1000
Saqlash	Conservation
bahslasha	to plead
kitob,	book,
qavmiga	people
vositasi	tool
der	der
Alpha	Alpha
yoqtirmayman.	I do not like.
kolba	tube
uyda	home
Menimcha,	In my opinion,
dale	dale
dan)	)
dan,	from
funksiyalarini	functionality
Maslahat	Advice
bila	Stolen
&lt;31MAR199321091163@juliet.caltech.edu	html>
deb	that
bo&#39;lgan)	)
kirdi	entered
»klubi	&#39;Club
bo&#39;lgan.	.
nikoh	marriage
&lt;p00261@psilink.com&gt;	&amp; Lt; p00261@psilink.com&amp;gt;
bo&#39;lgan,	that is,
Luis	Luis
bo&#39;lmaydi»,	not &#39;
quyi	lower
huquqini	right
çökerttiğini	Smashed
Deviants	Deviants
shaxsiy	personal
XRaiseWindow	XRaiseWindow
7,3	7.3
tuyulardi.	it seemed.
orbitalarida	orbits
bo&#39;lgan?	?
e&#39;lonlar	Statistics
afzal.	Preferences.
yorliq	shortcuts
ushbu	this
gomoseksual	homosexual
USA	USA
vakili.	representative.
Umid	Hope
vakili,	Representative,
bermadi	I did not
11-15	11-15
ortda	behind
Yamanda	Yemen
Biri	One of the
ortiq	excess
uxlab	sleeping
isrof	wasteful
to&#39;lov	payment
ziddiyatli	contradictory
qishloq	village
esnetmeyi	stretch
yulduzlar	stars
yaqinlashib,	approaching
meteoritlar	meteors
gilkey,	Gilkes,
Kometalar	Comets
Dr.	Dr.
nikel-temir	nickel-iron
protey	Proteus
arzon	cheap
bo&#39;lsa,	If
&quot;dual	&amp; Quot; dual
&lt;belgilab	&amp; Lt; defined
xohishi	Prompt
LaStrange	LaStrange
bo&#39;lsa)	If)
yigit	young
////	////
default	default
tez	fast
sanab	and derivatives
henry@zoo.toronto.edu	html>
g&#39;azablangan	angry
turdi.	stood.
Lindroos	Lindroos
5-daqiqa	5 minutes
jinoyatchi	criminal
bo&#39;lsa?	If?
joule	joule
molekulalar	molecules
barcha&gt;	&amp; gt;
3511,	3511
sochli&quot;	Hair &amp; quot;
DOS;	DOS;
Fang	Fang
1024	1024
DOS6	DOS6
din	religion
WINDOWS;	WINDOWS;
an&#39;anaviy	traditional
qoladi	remains
dir	dir
Support	Support
Huh?	Huh?
Finney	Finney
bo&#39;lsa:	if:
withs	Read
nazariyotchi	theoretician
shaxsni	a person
shaklga	shape
asboblar	devices
qiluvchi&quot;	&amp; quot;
(yuqori	(High
Meteoritlarning	Meteorites
batareya	battery
Hui)	Hui)
mazmunli	significant
domen:	domain:
Lucifer,	Focus
masxara	ridicule
Keng	Wide
olmaydi	does not
kirib	entered
mulozimlari	officials
natijasi	The results of
biladi?	who knows?
haqiqiy	real
Dos	Dos
shug&#39;ullangan	engaged
tayyor	ready
massasi	mass
biladi,	Who knows,
Kitob	Book
chandiq	scar
dafn	buried
ekansiz?	If you?
yillar,	years
chiqamiz.	We will.
olmaydi&gt;	not &amp; gt;
terisini	the skin
to&#39;xtatish&gt;	Stop &amp; gt;
qidiraman.	looking.
plastik	plastic
Jon.	John.
O&#39;shandan	Then,
xabarlarni	messages
yillik	annual
muammoni	the problem
anglashuv	Understanding
narsaga	what
Iqtisodiy	Economic
neccities	neccities
Meteoroid	Meteoroid
altimeter	altimeter
topgan;	component;
o&#39;zimni	myself
OFF	OFF
&quot;Qayta-bildirdi?&quot;	&amp; Quot; Refresh? &amp; Quot;
Utility	Utility
Uchinchi	Third
qurilish	construction
qog&#39;oz	paper
qo&#39;yishdi	put
topgan,	,
göktaşları	meteors
Uch-Way	Three-Way
topgan.	.
kotirovka	traded
kishilar,	people
(ba&#39;zi	(Some
Buffalo	Buffalo
tadqiq	investigation
chog&#39;ida	During the
trillion	trillion
*************************	*************************
doirasida,	,
(Ron	(Ron
Magazine	Magazine
[PED]	[PED]
biri,&gt;	&amp; gt;
ta&#39;qib	persecution
(Steve	(Steve
Bloom,	Bloom,
Psevdo-o&#39;qituvchi	Pseudo-teachers
chiqilgan	developed
tong	dawn
hech	no
shovqin.	noise.
(Tobias	(Tobias
bemorlar	patients
qaradim.	I looked.
(Kirk	(Kirk
Yangi	New
aniq,	clear
shuning	therefore,
ajratilgan,	allocated
butun,	in all,
GOURMET	GOURMET
Yo&#39;q	No
​​Lee	Lee
rem	rem
qarshi	against
TIFF,	TIFF
yozadi:&gt;	writes: &amp; gt;
o&#39;ndan	a dozen
-428-0800	-428-0800
KATALOG	Catalog
uzata.	simultaneously.
maqsadlarini	the objectives of
(O&#39;ZMK)	(KJV)
John	John
Spencer)	Spencer)
kosmonavtlar	astronauts
dizayn]	Design]
e&#39;tiqod,	Religion,
Dave	Dave
o&#39;limdan	the dead
sizga	you
yevropaliklardan	Europeans
topa	to find
janubida	south
tirilmaydi,	alive,
xristianlar	Christians
zilzila	earthquake
-486-9975	-486-9975
so&#39;rang.	ask.
takliflar	Offers
Ikkinchidan,	Secondly,
e&#39;tiqod.	belief.
OK,	OK
demadi?	He did not say?
arablarni	Arabs
boshqarmasi	Department
cheklashlar	Limitations
OK.	OK.
omili,	factor
AMPS	AMPS
(Erkin	(Erkin
jon,	soul,
&quot;qiyin&quot;	&amp; Quot; difficult &amp; quot;
tizimining	system
kabi-*	such as-*
texnikasi	equipment
harorat	temperature
bo&#39;lib	as
(Bro	(Bro
atrofidagi	around
rind@enterprise.bih.harvard.edu	html>
Bure,&gt;	Bure &amp; gt;
...&gt;&gt;&gt;	&amp; Gt; &amp; gt; &amp; gt;
muhit	medium
qatlamlari	layers
Alan	Alan
foydalanish»,	&#39;
deyiladi.	called.
muhim	important
aksincha,	On the contrary,
o&#39;laroq&gt;	Unlike &amp; gt;
o&#39;lchanadi.	measured.
5X9&gt;&gt;	5X9 &amp; gt; &amp; gt;
axir	because
ergashdilar	followed
Hech	No
as-issiq	as-hot
Systems&gt;	Systems &amp; gt;
New	New
&quot;^^^^^^»	&amp; Quot; ^^^^^^
oqilona	reasonable
karta,&gt;	Cards &amp; gt;
tugaydi	ends
olmoq	take
&quot;gomoseksual	&amp; Quot; homosexuals
keltirdik	brought
rad	rejected
manba	source
&quot;aylanish	&amp; Quot; cycle
Switch	Switch
^^^^^^^^^^^^^^^^^^^^^^^^^^^	^^^^^^^^^^^^^^^^^^^^^^^^^^^
qanday	how
bo&#39;ldi:	it has been:
qisman	partial
bo&#39;ldi;	it has been;
Leifson)	Leifson)
kelajakda	future
butunlay	entirely
Inson-Mürettebatlı	Human-Crewed
bo&#39;ldi.	it has been.
yahudiy&gt;	Jewish &amp; gt;
tasdiqlangan	approved
bo&#39;ldi,	it has been,
Yo&#39;ldoshlar	Fellow
xususiyatlarini	the characteristics of
iloji	possible
Kitobni	The book
fakulteti	Faculty of
Odatda,	Typically,
keyingi	next
rom	rom
yulduzlardan	stars
berib,	giving
eshik	door
dominant	dominant
Dastgoh	Workshop
Quyosh	Sun
yuzasida	on the surface
ifoda	expression
Will	Will
raqamlari&gt;	Numbers &amp; gt;
rol	role
qoplangan&quot;	coated &amp; quot;
huzurida	the presence of
WNCI	WNCI
qattiqqo&#39;l	harsh
tanga	coin
​​quyosh	sun
partiyalar	parties
aralashtirmang	Do not confuse
(22,238	(22,23
yuzasiga	the surface
asarlar	The works
dir.	dir.
demoqchimisiz?	You think?
jarayonlar	processes
Yana	Again
Ovropada	Europeans
SKIING	SKIING
shaxs	person
taqdim.	.
&lt;mvanheyn@cs.indiana.edu&gt;	&amp; Lt; mvanheyn@cs.indiana.edu&amp;gt;
Whethe	Whether
Wizzard)	Wizzard)
sizlarning	you
muvozanatga	balance
o&#39;rgatadi,	teaches,
Qaysi	Which
UNIX	UNIX
Joel	Joel
yillar	years
&quot;sirlarini&quot;	&amp; Quot; secret &amp; quot;
nagle@netcom.com	html>
Ground	Ground
disk	disk
boshlanish	start
Explorer	Explorer
spirochetal	spirochetal
qurishga?&quot;	to build? &amp; quot;
NiCad	NiCad
bo&#39;lsa	If
Ottava,	Ottawa,
namoyon	show
paketlar	packages
Utopia	Utopia
quyida	below
munosabati	the occasion
sizni	you
palastenians	palastenians
Venera	Venus
ulysses.att..com	ulysses.att..com
Europa,	Europa
algoritm	algorithm
(Noqonuniy	(Illegal
&quot;SO&quot;	&amp; Quot; SO &amp; quot;
Frantsiya	France
qoplangan	covered
bolgan	fields
90%&quot;	90% &amp; quot;
&lt;1qkoel$5fr@horus.ap.mchp.sni.de&gt;	&amp; Lt; 1qkoel$5fr@horus.ap.mchp.sni.de&amp;gt;
isbotidir?	is the proof?
Columbia,	Columbia,
***************	***************
nazorat	check
kirib,	entered
qismi)	part)
avvalgi	previous
yozadi&gt;:	writes &amp; gt ;:
yoqilganda	switched on
savolim:	Questions:
qismi,	part
&quot;Yer-Moon	&amp; Quot; the Earth-Moon
ezib	crush
ekran	screen
ko&#39;rinadigan	visible
qozonmoqda.	gaining.
&quot;Yangi	&amp; Quot;
&quot;oldin&gt;	&amp; Quot; &amp; gt;
hamkasblari	colleagues
o&#39;tish,	,
o&#39;rnatilgan	installed
qondiradi	satisfies
adapter	adapter
omon.	survival.
fanlari	Sciences
1980,	1980
-rigth	-rigth
mashhur	famous
Bzzt!	Bzzt!
huquqi	right
taqdir!	destiny!
Timmons)	Timmons)
Timmons,	Timmons
Visual	Visual
derlar;	they say;
istamayman.	I do not want.
5-11,	5-11,
istamayman,	I do not want
quyidagi	following
Stiven	Stephen
dumlari	tails
hrubin@pop.stat.purdue.edu	html>
etarli	sufficient
Ko&#39;p	Many
hislar	the senses
Salah)	Salah)
tamoyillari	principles
arenasi	arena
Yaponiya	Japan
suratga.	the camera.
(Leong	(Leong
martyj@mrcnext.cso.uiuc.edu	html>
sistemasidagi	system
chiqilgan.	.
jamoatini	the church
konusning.	cones.
o&#39;tishi	to go
o&#39;g&#39;illari	sons
&lt;1qnb9tINN7ff@rave.larc.nasa.gov&gt;	&amp; Lt; 1qnb9tINN7ff@rave.larc.nasa.gov&amp;gt;
masalalari	issues
accuire	accuire
ergonomik	ergonomic
Yanvar	January
97,9	97.9
GSX-145	GSX-145
ozor	hurt
minglab	thousands
Kuzatuvlar	The observations
qonuniy	legal
okeanlar,	oceans,
COM1	COM1
Otamning	My father
policha	Police
vulkanlar	Volcanic
bayonotlar	statements
sentyabr,	September
markazi,	Center
Bugungi	Today
maqsadida&gt;	&amp; gt;
ozod	free
yordam?&quot;	? &amp; quot;
&quot;|	&amp; Quot; |
portlashlari	explosions
RESP.	RESP.
Mives	Mives
Control	Control
erlar	Husbands
savdo	trade
cfaehl@vesta.unm.edu	html>
ishora	hint
AQSh&quot;	US &amp; quot;
holatda	case
shohi;	King;
g&#39;oyalar	ideas
Enteritis	Enteritis
markaziy	central
brian@gab.unt.edu	html>
sotuvga	for sale
joyi	Place
vodiylari	valleys
gullab-yashnagan.	prosperity.
Canucks	Canucks
(Sam	(Sam
hujjatlarida	documents
birikish	combination
Anakart	The motherboard
yashayotgan	living
xalqaro	international
ajrata	to distinguish
sevib	loved
Livermore,	Livermore,
&lt;ateizm	&amp; Lt; atheism
Redelfs)	Redelfs)
nstassen@magnus.acs.ohio-state.edu	html>
vitr	to showcase the
eshitishni	to hear
yugurib	ran
xudosi.	god.
barkamol	harmoniously
buyurish	enjoining
ergashdilar.	followed.
xudosi;	god;
&quot;	&amp; Quot;
irodasini	the will of the
uchastkalar	lots
undan	him
funktsiya	The function
sun4nl	sun4nl
qurilgan.	built.
okeanlarning	the oceans
qurilgan,	built,
qadriyatlar	values
yashirin	secretly
oqsoqollar,	elders,
umumiy&gt;	General &amp; gt;
imputs	impute
TARIX:	HISTORY:
tasdiq	approval
sevgi	love
Electronics	Electronics
yondirib	burned
etaklaydigan	Shipment
fikrini	the idea
ko&#39;rmayapman,	see
ko&#39;rmayapman.	I can not see.
o&#39;ldirilishi,	murder,
Ushbu&gt;	This &amp; gt;
Powered	Powered
bo&#39;yalgan	painted
faolligini	activity
Kitobda	The Bible
mamlakatni	the country
(yoki	(Or
ta&#39;minlash&gt;	&amp; gt;
Astronomiya	Astronomy
sotuvda	For Sale
chip	chip
gunohlari	sins,
qaynaydi,	boil
kraterlardan	krater
tez-harakat	fast-action
keltirganlar,	Those who
ilon,	snake,
==========	==========
(Carl	(Carl
(DES	(DES
&quot;edi	&amp; Quot;
qonuni,	Law,
fotoelektr	photoelectric
OLDIN	BEFORE
Wagner,	Wagner,
o&#39;rgatgan	taught
Plains&quot;)	Plains &amp; quot;)
Coons)	Coon)
befarq	indifferent
maqolada	article
17-asrda,	In the 17th century,
ekan	that
-Karl&gt;	Kars &amp; gt;
zanjirlar,	chains,
sizning	your
qa&#39;riga	the depths
(ncsc8!	(Ncsc8!
Optik	Optical
ob&#39;ekt,	object,
fang@en.ecn.purdue.edu	html>
bokiralik,	virginity,
&quot;bizning	&amp; Quot; our
Sharma	Sharma
(Yaponiya	(Japan
tiriladi.	rise.
yutib	won
kutadi	Waits
mavjudmi?	Are there any?
paydo	appears
arziydi	worth
bezatish	Decoration
doira.	apartment.
foydalanuvchi	user
qo&#39;shnilar	neighbors
ish-of--tegirmon&gt;	the work of the mill &amp; gt;
&quot;Klaviatura	&amp; Quot; Key
fitna]	conspiracy]
hujjatlar	documents
tadqiqotlar	Research
pallasida	circuit,
tosh	stone
izohlash.	explain.
Xudosi	The god
spec&#39;d	spec&#39;d
pimi	pin
kutib&gt;	meet &amp; gt;
narsani	everything
yashashi	live
yoyib	spread out
kamera	camera
biseksual	bisexual
comp.sys.ibm.pc.hardware:	comp.sys.ibm.pc.hardware:
line	line
o&#39;yin,&gt;&gt;	&amp; gt; &amp; gt;
istaganini	wants
ijodimiz,	creative,
turgan	standing
aloqada	contact
Bizning	Our
najot	saved
yil,	year
negadir&gt;	reason &amp; gt;
pro-kun	pro-gun
(Bryan	(Bryan
HAWK	HAWK
tibbiyot	medicine
(Kevin	(Kevin
ota-deb	parents
minnatdorchilik	thanks
SCSI	SCSI
talabalar,	students,
bo&#39;ldi	it has been
dizayni	design
xohlaysizmi?	Do you want to?
Xaloskorimiz	Redeemer
Darryl	Darryl
oshkor	disclosure
nomidan&gt;	On behalf of &amp; gt;
shifokorlarga	doctors
tirildi	rose from the
qobig&#39;i	shell
qurilmaning	the device
Karlos	Carlos
shifokorlari,	doctors
viloyatlariga	regions
yili	year
siyanür	cyanide,
o&#39;rgatadi.&quot;	teaches. &amp; quot;
biroz	a little
&lt;&lt;	&amp; Lt; &amp; lt;
===	===
to&#39;qnashuvning	Collisions
birov	someone
Thomas	Thomas
lyme	Lyme
parvo&quot;	&amp; quot mind;
etnik	ethnic
qaytdi.	returned.
biror	a
RS-6903	RS-6903
Cheers	Cheers
GENIE:	GENIE:
yo&#39;llar	roads
tarjima	translation
joy,	place
82%,	82%
Potvin,	Potvin
Gosh..I	Gosh..I
J.David.W.Reeves@dartmouth.edu	html>
teleskop	telescope
buzuq	corrupt
Pioneer	Pioneer
aep@world.std.com	html>
HAVO	AIR
buyuriladi.	prescribed.
o&#39;rganib	studied
(1430	(1430
Ranger,	Ranger
hodisadan	incident
zaxiradan	bench
Kanadaliklar	Canada
&quot;eng	&amp; Quot;
agnostik	agnostics
«a»	&#39;A&#39;
Bentz	Bentz
odam	man
tekisliklarni	plains
chop	published
tafsir	tafsir
&lt;	&amp; Lt;
kuzatildi.	observed.
bo&#39;lak	portion
natonal	NATO
toza	clean
Suzuki	Suzuki
qoidani	rule
Spencer	Spencer
bo&#39;lar	would
Takliflar	Offers
keltirur.	bring.
qo&#39;llab-quvvatlanadigan,	supported
Planitia	Planitia
qo&#39;llab-quvvatlanadigan)	supported)
ijro	executive
chegaralarini	the boundaries
yetganida,	When,
!!&quot;	!! &amp; Quot;
Nor	Nor
narsalar	things
oshiradi&quot;&gt;	&amp; quot; &amp; gt;
savol	question
Winslow,	Winslow
qaynatiladi,	boil,
16804	16804
Yaxshi	Good
tanasini	the body
Perfect	Perfect
xilvat	deserted
AMPS,	AMPS
tasvirlangan.	described.
​​Venusian	Venusian
foizini	percent
(JPS)	(JPS)
qanday,	How,
topgan	consisting of
QOYIL!	Wow!
g&#39;oya	conception
sinash	try
monitoring	monitoring
uchastkalar!	lots!
qoplangan.	covered.
jamoatchilik	the public
_in	_in
chiqindilarini	waste
boshqaruvidan:	Management:
qiyinchilik	difficulty
Of,	Of
bo&#39;linish	division
jihatlari	Aspects
siz	you
(______________________________________)	(______________________________________)
Tog&#39;-qizlar	Mining and girls
meros	heritage
yozda,	in the summer,
bo&#39;lganlarga,	who
ayollar	women
PIN	PIN
ustida	over
10/82	10/82
platosining	Plateau
qilish&gt;,	&amp; gt ;,
tuproqdan	dust,
qaradi	He looked at
ajratadigan	distinguishes
Uran,	Uranium,
ko&#39;rsatdi	showed
narsa&gt;	&amp; gt;
Dalillar	Facts
ekdfc@ttacs1.ttu.edu	html>
shu	this
Kitob-sevishganlar	Book-lovers
(10000	(10,000
sir	mystery
havzalari	basins
mamlakatlari	countries
madaniyat	culture
4Runner&gt;	4Runner &amp; gt;
Oh,	Oh,
yechishga	to solve
mashina	machine
kechishlari-uni:	night:
qodir	able
undamayaptimikin&gt;	Does &amp; gt;
chuqur	deep
yo&#39;ldoshlari	moons
Endi,	Now,
yoriqlar	cracks
yo&#39;qotgan.	lost.
Angliya	England
Telefon:	Phone:
Callisto	Callisto
ligada	league
payini	twitched
tutayotgan	referring to
Space	Space
6/91	6/91
guruh	group
Canada,	Canada
Yaman	Yemen
ustiga	upon
(yahudiylar)	(Jews)
nasroniylik,	Christianity,
yer-oy-quyosh	the earth-moon-sun
00ECGILLESPIE	00ECGILLESPIE
aqidaparastlar	fanatics
yaproqlar	leaves
bilurlar.	know.
-14	-14
dunyodagi	the world
keltirgani&quot;.	Straps &amp; quot ;.
diqqat	attention
sinov,	test
Scharfy)	Scharfy)
shamoli	wind
sex	sex
barcha	All
eshitamiz.	hear.
lezbiyen	lesbian
Barcha&gt;	&amp; Gt;
2230	2230
taqlid	imitation
PMS	PMS
ko&#39;rsatildi	shown
qoyalar	rocks
&quot;litsenziyaga	&amp; Quot; licensed
Services	Services
qaynatiladi	boil
ko&#39;rmadim.	I did not see.
(o&#39;ng	(Right
buyon&gt;	&amp; gt;
(Computer	(Computer
kripto	crypto
ko&#39;rmadim,	I did not see,
uzoq-uloqtirdi	and threw it into the long-
Franjione	Franjione
HOMOSEXUAL-	HOMOSEXUAL-
«dalillar»	&#39;Facts&#39;
Kaufman)	Kaufman)
Telecope	Telecope
birga	together
&quot;qabul&quot;	&amp; Quot; &amp; quot;
me&#39;yor	In principle,
necha,	few,
surilsa,	ascription
Edwin	Edwin
nima&gt;	What &amp; gt;
sen	you
sel	flood
butun	whole
rangdagi	colors
chiziq	line
to&#39;qnashib.	collided.
milya),	mph)
ekanligini,	that
bo&#39;lmaganda	at least
agar	if
shaxslarni	persons
shama,	implied,
àmì	AMI
chet	foreign
shishgan,	swollen,
qamoqda	prison
Ludwick&quot;	Ludwick &amp; quot;
ildizi	The roots of
jamoa&gt;	Jewelry &amp; gt;
nimadir	something
qiling&quot;	&amp; quot;
Kentukki	Kentucky
masihiylar	Christians
bilimga	knowledge
(Andrew	(Andrew
shama;	implied;
(3,010	(3,010
Dual	Dual
(-184	(-184
fotosel	photocell
amino	amino
hosil	harvest
qaerda)	Where)
sol	Look
Deb&gt;	&amp; Gt;
dalil,	evidence
joyida	place
to&#39;lanadigan	payable
xronologik	chronological
tekisligiga	plane
litsenziya	license
Klark	Clark
---	---
sof	pure
foydalaning	Use
aytish	say
Ryan	Ryan
kishilar	people
qaerda,	Where
(&quot;Oltin	(&amp; Quot; Gold
Hoffman	Hoffman
themon	Theme
menimcha	I think
sex)	sex)
korean,	korean
qilgan.	.
qilgan,	,
bo&#39;yicha&gt;	&amp; gt;
Ikki	Two
majbur&gt;	Core &amp; gt;
Xarid	Shopping
Selsiy	Celsius
qilgan;	;
Santa	Santa
Hajmi:	Size:
tushunishga	to understand
qo&#39;llanmalar	Manuals
botganidan	sunset
&quot;Lyme	&amp; Quot; Lyme
Stanza	Stanza
jinoiy	criminal
axloq	behavior
êonuniyligi	Legality
tijorat	commercial
o&#39;rganish,	study,
a&gt;	a &amp; gt;
Daraja	Level
ligini.	stained.
bemorlarning	of patients
chiqaradi	produces
mish-mishlarni	rumors
Multiprobe	Multiprobe
--clh]	--clh]
chap	left
&lt;C5r60r	&amp; Lt; C5r60r
MAQOMOTI&gt;	COM &amp; gt;
___	___
mish-mishlarga	rumors
dasturlar	Applications
o&#39;zingizni	yourself
harakatini	movement
qilmaydi.	It does not.
qilmaydi,	It does not,
muqobil,	alternatively,
Xalqaro	International
1993,	1993
qatorda	as well as
floppi	floppy
bevaqt	premature
Ligasi-da,	League,
Stars&quot;	Stars &amp; quot;
Altimas	Altima
hujjatlariga	acts
bering.	Read on.
Candida	Candida
Thanks	Thanks
bering,	Read
Theos	Theos
hammangiz	all
zaryadlash	charging
&quot;Ular&quot;	&amp; Quot; &amp; quot;
cryptoanalysis	cryptoanalysis
&quot;Geiger	&amp; Quot; Geiger
tizimidagi	system
ko&#39;rsatilib	indication
Corp.	Corp.
supurib,	sweep
ligalari	DPJ
bering!	Read on!
adam@das.harvard.edu	html>
radioed	Wendy
William	William
qiziquvchan.	curious.
pishirib	simmer
Motherboard	Motherboard
Yupiterning	Jupiter
muammolar	issues
Lauria)	Lauria)
real	real
bir-biriga	a one-
qotib	stare
dalil:	Justification:
kuzatib	watch
egalik	possession
articals	articals
ayting	website
daviss@sweetpea.jsc.nasa.gov	html>
qilinib,	, and
ko&#39;rsatib	show
foydalanish	The use of
kelgan	from the
nozil	revealed
19947	19947
nozik	sensitive
forsale	forsale
Altima,	Altima
Biroq	Though
cho&#39;mish&gt;	Baptism &amp; gt;
^^^^^	^^^^^
Jorjtaun,	Georgetown,
ko&#39;lamli	-scale
Kontrollerlar	Controllers
paketlar&quot;	Packages &amp; quot;
Gen3:	Gen3:
&#39;s	&#39;S
PCX	PCX
shifokorlar,	doctors
nomlari	names
(havo)	(Air)
jamoalar,	teams
Floppy..BURN	Floppy..BURN
hayron.	surprised.
xotirlash	a requiem
kafolat	warranty
ekvator	equator
xohlagan	wills
isolator&quot;	isolator &amp; quot;
Out	Out
yaxshiroqdir	better
oshiriladi&gt;&gt;	&amp; gt; &amp; gt;
There	There
yakunlandi.	completed.
o&#39;tirib	to sit
strawman	Straw
27611@athos.rutgers.edu,	27611@athos.rutgers.edu
halok	killed
Dunyodagi	The world
96,5	96.5
folta@zen.holonet.net	html>
Kolorado	Colorado
masala»	issue
Skelton	Skelton
oyoq	leg
hamkorlikdagi	the joint
olishingiz	receive
jamoalari	The teams
-oOOO	-oOOO
astein@nysernet.org	html>
shug&#39;ullanish	deal
loyiq,	worthy
etishmasligi	The lack of
KUKUNI	POWDER
qildi,	,
qildi.	.
xudo	God
^^^^^^^^^^^^^^^^^^^^^^^^^^^^^^^^^^^^^^^^^^^^^	^^^^^^^^^^^^^^^^^^^^^^^^^^^^^^^^^^^^^^^^^^^^^
tirilishiga	the resurrection
O&#39;g&#39;li	The son
tomoniga	side
narsalardan	things
sharma@monet.vill.edu	html>
dağınıklığı	clutter
Kolodny	Kolodny
(Dick	(Dick
halqa	ring
jalilalik	Galilean
BMP,	BMP,
sguerke@ravel.udel.edu	html>
ko&#39;rsatuv	default
oyna	mirror
tuzatilgan	corrected
OTOH,	OTOH,
Oliveira	Oliveira
nomidan	On behalf of the
chuqurliklarda	Hollows
aylantirilayotgan	turned
GMT,	GMT
kfrank@magnus.acs.ohio-state.edu	html>
terma	team
ekspeditsiyalar	expeditions
orasida	among
buyon	Since the
9600	9600
hayotda	life
termo	thermo
savol,	question,
avtomatlashtirilgan	automated
tekshirish	inspection
xabarni	message
hisobiga,	expense
hans@xelion.nl	html>
xarakterli	characteristic
qo&#39;llab-quvvatlash	support
boshqa,	other
Fallout	Fallout
Foydalanuvchi	User
hoshiyali	edges
qildim	I have
holatini,	condition,
yotoqxona	bedroom
kimsadan	one who
tarixini	history
SMARTDRV	SMARTDRV
Williams,	Williams,
yumshoq-og&#39;zaki	a soft-spoken
O&#39;g&#39;il	Son
dengiz	sea
tomonida	side
kategoriyalari	Categories
odati	The tradition of
ma&#39;noni	means
soniya	second
masala:	issue:
Jinnimisiz_?	Jinnimisiz_?
&quot;maqsad	&amp; Quot; target
harbiy	military
&quot;dalil-manifatura&quot;	&amp; Quot; proof-texting &amp; quot;
sud	court
ligasi	League
orasiga	between
reja	plan
Frank)	Frank)
Accelerator	Accelerator
suv	water
o&#39;tgan	past
Ishlatilgan	Used
turdagi	kind of
Accord	Accord
dastlabki	the first
kuch	force
mantiqiy	logical
maqsadida	In order to
holsend@mhd.moorhead.msus.edu	html>
belgilang	Define
yasalgan	made
osmon.	the sky.
g&#39;alabaga	victory
cyphers	cyphers
(Robert	(Robert
shahodat&quot;,	&amp; quot ;, witness
dookie	dookie
almashish	Sharing
ketkazguvchi	Deceiver
oshirmoq,	,
kimning	whose
FORSALE	FORSALE
hokazo,	etc,
Callisto,	Callisto
Kaldis,	KALDILDI
ketmaslik	to leave
bo&#39;limida	section
Press-demokrat,	Press-Democrat
Javob	Answer
urdi	hit
hokazo)	etc.)
grafigini	schedule
maqolada,	article
buyuk	great
yo&#39;ldosh,	Satellite,
Slot	Slot
o&#39;zgarishi	change
===========================================	===========================================
WP51	WP51
bordingizlar?	did you?
shamol	wind
fırlatıcısı	netters
tirilishini	the resurrection
oyga	the moon
&lt;1993Apr22.153959.12328@ucsu.Colorado.EDU&gt;	&amp; Lt; 1993Apr22.153959.12328@ucsu.Colorado.EDU&amp;gt;
sendan	thee
10000	10000
topilmadi.	found.
o&#39;zgartirilgan	changed
(125	(125
ma&#39;nosi	The meaning of
bolta	ax
tan	recognized
aytaylik).	for example).
qadar)	)
(JPL)	(JPL)
Darn	Darn
qadar,	so,
Dark	Dark
(1500	(1500
soxta	fictitious
engil	light
tozalash	cleaning
Masalan	For example,
xulq	behavior
yaratgan	created
Avvalgilar	The former
osmonlaru	the heavens
shuningdek	also
Ona	Mother
Lawrence	Lawrence
faqat&gt;	&amp; gt;
One	One
bepul	free
bilmayman,	I do not know,
bilmayman.	I do not know.
uzatdi	handed
oila	family
bilmoqchi	to know
demokratik	democratic
kemaning	deck
megatest.com&gt;	megatest.com &amp; gt;
qarang	See
hujum	attack
sug&#39;urta.	insurance.
o&#39;sayotgan	increasing
&lt;C5DxBs.5ov@panix.com&gt;	&amp; Lt; C5DxBs.5ov@panix.com&amp;gt;
****	****
(12v	(12v
oxir-oqibat	eventually
Kimdir	Somebody
liscenced	liscenced
&lt;1r9j33$4g8@hsdndev.harvard.edu&gt;	&amp; Lt; 1r9j33$4g8@hsdndev.harvard.edu&amp;gt;
PS:	PS:
berish	Rent
amaliyotchilar	practitioners
prob,	The probe
shtati	State
dunyo	world
tranzistor?	the transistor?
olmaydi,	not
qarash	look
to&#39;satdan	suddenly
Psevdo	Pseudo
kriptografiya	Encryption
(175	(175
NUNNALLY@acs.harding.edu	html>
[...	[...
qattiq	solid
foydalanib.	using.
Hozircha,	Meanwhile,
yuritadigan.	angles.
kimdir	somebody
psyrobtw@ubvms.cc.buffalo.edu	html>
foydalanib,	Using
ko&#39;rinishini	appearance
aytib,	said,
(RvKampen)	(RvKampen)
!!!!	!!!!
olmaydi.	not.
eshitmadim	I did not hear
window	window
shtatining,	Dayton,
Phil	Phil
insonlar	people
chaqnash	ignition
natijasida	As a result of
kombinatsiyalangan	combined
maqsadini	the purpose of
....&gt;&gt;&gt;&gt;	... &amp; Gt; &amp; gt; &amp; gt; &amp; gt;
kamdan-kam	rare
diskda	disk
nomlanadi	referred to
U&gt;	U &amp; gt;
Dana	Dana
banschbach@vms.ocom.okstate.edu	html>
Willis)	Willis)
drayverini	driver
kundan	days
Amerikaliklar:	Americans:
oktyabr,	October,
PTO	PTO
sohada,	area,
nomuvofiqlik	The discrepancy
yirik	large
mantiqan	logically
aytilganidek,	As mentioned,
(Tim	(Tim
(Plutondan	(Pluto
markazi	Center
hiylalari	plotting
^^^^^^^^^^^^^^^^^^&gt;	^^^^^^^^^^^^^^^^^^ &amp; Gt;
tarixida	in history
hajmini	the size of the
qiziqish	interest
anhuma	anhumâ
Keling,	Now,
yotipti,	that&#39;s,
serverlarida	servers
masihiylar&gt;	Christian &amp; gt;
azot	nitrogen
fosfor)	phosphorus)
ehtiyotkor	cautious
o&#39;rnatish,	installation,
yotipti!	that&#39;s it!
14-19?	14-19?
radar,	radar
View,	View
ko&#39;rmayapman	I do not see
azob	torment
&quot;yuzasida	&amp; Quot; surface
yotipti)	that&#39;s)
oyat	signs
Point	Point
Mana,	Here,
foiz	interest
gunohlarimiz	sins
toml@boulder.parcplace.com	html>
kenyee	kenyee
sharqqa	eastward
biz	We are
bit	bit
sichqonchani	Mice
20-39	20-39
bir	one
markerni	the pointer
qo&#39;yilmaydigan	investments
(gregh@niagara.dcrt.nih.gov)	(Gregh@niagara.dcrt.nih.gov)
himoya.	protection.
himoya,	protection
9.256	9.25
....	....
ta&#39;riflarni	The definition of
qiladimi?	Does it?
namunalari	samples
qilingan&gt;	&amp; gt;
exeption	exeption
orbitasida	orbit
...:	...:
intervyusida	interview
Munns)	Munnar)
(39.95)	(39.95)
tayyorlaydi.	prepares.
...?	...?
Teleradiokompaniyasi	Television and Radio
uning&gt;	&amp; gt;
qoldi,	,
keyinchalik	later
ostida&gt;	&amp; gt;
qoldi.	.
zarralar	particles
(Tom	(Tom
(Assalamu)	(Oo)
Italiya	Italy
boshqalarga	others
sozlanishi	adjustable
Xavotir	Concern
ketishiga	go
shohiddir:	Witness:
hislarni	perceptions
uslubi	style
Fikr?	Comments?
axloqiy	ethical
yaxshiroq&gt;	better &amp; gt;
Bormon)	Barman)
kurs	exchange rate
urib	Dover
Allen	Allen
Goolsbey)	Goolsbey)
Tampa,	Tampa,
gradus	degree
bob	chapter
Shaxsiy	Personal
(486-33DX	(486-33DX
oqimlari	flows
-Arlo	-Arlo
Florida	Florida
yangilar	Novices
Avtomobil	Car
qiziqtiradigan	Interested in
oqlanadi&gt;	justified &amp; gt;
Ajablanarli	Surprising
(no	(No
rasman	officially
velosiped	bicycle
(1100	(1100
tanilgan.	known.
balki	maybe
sog&#39;lig&#39;ini	health
zarrachalar	particles
klassik	classical
tayyorlangan	prepared
kesh	Cache
QUACK	QUACK
...)	...)
texnik	technical
Jozef	Jozef
orqa-eshik	back door
muhandislik	Engineering
Yerdagi	The earth
izchil	successive
zarar)	damage)
og&#39;ir	heavy
yoqib,	burned
Ikkinchi	Second
Cuesta)	Cuesta)
kimyo	chemistry
(Frank	(Frank
&lt;C4vG3F.Kx3@apollo.hp.com&gt;	&amp; Lt; C4vG3F.Kx3@apollo.hp.com&amp;gt;
narsadir.	thing.
Avvalroq	Earlier,
kuchlanish	voltage
mehribon	loving
Deimos	Deimos
qiladigan	that
qamchilash	scourge
Cypher	Cypher
ta&#39;minoti	supply
&quot;non-turli&quot;	&amp; Quot; non-different &amp; quot;
&lt;93095@hydra.gatech.EDU&gt;	&amp; Lt; 93095@hydra.gatech.EDU&amp;gt;
Xiroki	Hiroki
bo&#39;lsa-da,	Although,
chaqmoq	lightning
bo&#39;lsa-da.	though.
bitimlar	agreements
olaman.	I can.
heteroseksüel,	heterosexual,
Jalb	Attracting
caldwell8102@mtroyal.ab.ca:	html>
bor	There are
whitsebd@nextwork.rose-hulman.edu	html>
HITEN	Hite
boy	rich
Rauser@sfu.ca	html>
talip	talip
murvat	bolt
yoqing	Turn
masofada	the distance
shokolad	chocolate
burchakda	corner
4Runner	4runner
hozirda	now
suratini	pace
chip-majmui	chip-set
ma&#39;noda	sense
transformatorlar	transformers
(bu	(This
bergan	given
keng	wide
Delaver	Delaware
Sayyora	Planet
&lt;1993Apr21.032427.22464@leland.Stanford.EDU&gt;	&amp; Lt; 1993Apr21.032427.22464@leland.Stanford.EDU&amp;gt;
ishg&#39;ol	the occupation
masihiylarni	Christians
yozishni	writing
kechqurun	evening
computergenerated	computergenerated
kun)	day)
Sayyoramiz	The planet
Ijaraga	Rental
_your_	_your_
&quot;Robert	&amp; Quot; Robert
o&#39;xshaydi.	like.
begunoh	innocent
Bunga	It
bo&#39;laklari	the pieces
Davolash	Cure
tashvish	concern
toplar.	tops.
geologiya	geology
chiroqlar	lights
foydalanish.	.
ma&#39;noga	meaning
(bentz.e.puryear)	(Bentz.e.puryear)
iymon	We believe in
&quot;bajo&quot;	&amp; Quot; &amp; quot fulfilled;
uchadi.	to fly.
(Portable):	(Portable):
Pay	Tendon
miqdorda	the amount of
qimmat,	expensive,
qimmat.	expensive.
xorijiy	foreign
Stereo	Stereo
foydalanish:	use:
ishlaydi	works
qilsa&gt;	If the &amp; gt;
Wells	Wells
narx	price
Voyager	Voyager
miscommunication	miscommunication
Ibroniylarga	Hebrews
rasmiy	official
hayoti,	life
***	***
gchin@Eng.Sun.Com	html>
tuyulardi-da,	Although it seemed,
o&#39;ng&quot;	right &amp; quot;
Shaxsan	Personally,
puxta&gt;	strong &amp; gt;
flybys	flybys
yoqdi.....	Like .....
Rick.	Rick.
APPRECITATED	APPRECITATED
davrlari	circuits,
qiladi:	:
House	House
(Klaudio	(Claudio
kometa	comet
harakat&gt;	&amp; gt;
qiladi?	?
yutadi,	Utah
qo&#39;shnilarining	neighbors
missiyaning	mission
masofaga	the distance
hozirgi	current
janob	Mr.
tupurib,	spit,
iymon.	believe.
tomonidan&gt;	&amp; gt;
qiladi,	,
qiladi.	.
hozirga	now
Radioaktiv	Radioactive
HIMEM.SYS	HIMEM.SYS
ismli	named
ilmi	The knowledge of
hammamiz	all
kabi&gt;	&amp; gt;
hayotga	life
maqolasida	article
yorilish	to crack
orêasida	Reckless
disklar	discs
&quot;yo&#39;ldoshlarini	&amp; Quot; satellites
ko&#39;rsatiladi.	will be displayed.
Massalari	Masses
mutakabbirlik	arrogant
tonggi	The dawn
yadroviy	nuclear
endi&gt;	Now &amp; gt;
avlodlari	The descendants
Chryse	Chrysler
Masihiyning	Christian&#39;s
kema	ship
radyoizotopların	radioisotopes
istardim.	I would like to.
telefon	telephone
talab	demand
Legge	Legge
kuni	day
80111	80111
muddati	The term of
davrlarini	Conversions
Verbatim	Verbatim
&quot;salomatlik&quot;	&amp; Quot; healthy &amp; quot;
aytganda	words
uchrashuv	meeting
ijtimoiy	social
ilmiy	scientific
Pavlus	Paul
beri	Since
navbatda,	primarily,
qoidalari,	rules,
qiyin).	difficult).
bera	Can you
yozadi	writes
pop	pop
______________________________________	______________________________________
yangradi	sounded
&quot;Christian»,	&amp; Quot; Christian &#39;
Allohning	Allah,
orbitaga	orbit
tog&#39;li,	mountainous
saytidan	site
takabburlik	arrogance
asosida,	on the basis of
Uyali	Mobile
qoidalarga	regulations
landshaft	landscape
sinovlarni	trials
oddiy&gt;	Simple &amp; gt;
qurilgan	built
Klaudio	Claudio
qiladi	will
RAM	RAM
Computer	Computer
Ahdda,	Testament,
ta&#39;rifi	The definition of
amaliyotini	practice
siri	The secret of
kosmosda	space
gaz,	Gas,
buni	it
yoki&gt;	or &amp; gt;
61153	61153
sirt	surface
kelib	to come
(Oila	(Family
qiyomat	Day of Resurrection
Shapiro	Shapiro
iloh	god
uchun&gt;	&amp; gt;
Meksika,	Mexico,
aynan	exactly
ishlatilgan	used
resurslarni	resources
sabablar	reasons
Ateizm	Atheism
biron-bir	any
kosmosga	space
gunohkor	sinner
keladi:	:
chiqildi.	.
urish	pulse
vazifasi.	function.
Chips	Chips
Nunnally	Nunnally
turib,	without
keladi.	.
besh	five
sizlar	you
keladi,	,
miss,	Miss
narxlar	prices
shuningdek,	as well as,
(balki	(But
sarmoya	investment
583.&gt;	583 &amp; gt;
ekipajlari	crews
qoldirganmiz.	left.
&quot;charog&#39;on	&amp; Quot; light
hamma	all
hype	hype
zarralar,	particles,
kompaniya?	the company?
800mA	800m
aytganda,	In short,
sabab	cause
agnostitsizm	agnostic
2-va	And 2
dedi.	he said.
62,4	62.4
kuzatildi	observed
davrlarida	periods
(eng	(
tushadi,	falls
dedi,	he said,
keldi	arrived
okeanlar	oceans
&quot;gumanitar&quot;	&amp; Quot; human &amp; quot;
misollar	Examples
dedi?	said?
qoplandi.	covered.
metan	methane
tutadi	plays
axloq&gt;	Ethics &amp; gt;
&quot;ilmiy&quot;	&amp; Quot; D &amp; quot;
six-	six-
mainstream	mainstream
misol	example
yoppasiga	Faulting
haydash?	driving?
Alloh	Allah
boshqalar	others
Derazali	Windows
klaviatura	keyboard
solishtiring?	Compare?
Ganymede	Ganymede
zid,	contrary
bitnet	bitnet
yangradi.	rang.
to&#39;dasi	swarm
7,329	7.329
Sabres	Sabres
dans@uxa.cso.uiuc.edu	html>
(ular	(They
hech&gt;	&amp; gt;
kishilarning	people
-------------------	-------------------
xabar	report
ruxsat,	,
Study&quot;	Study &amp; quot;
ruxsat.	.
Uyg&#39;onish	Wake up
ishonchsizlik	distrust
(yuk	(Cargo
Ota-window	The main window
sigareta	cigarette
________)	________)
Biz&gt;	We &amp; gt;
davolashda	the treatment
*******************	*******************
zich	tight
modelga	model
QXI	Warehouse
mexanika	mechanic
Company	Company
pastga.	down.
qo&#39;yildi.	put.
kiriting	Enter the
bir-bir	a
jarayonida	In the process
İyonosfer,	Ionosphere
(Microsoft	(Microsoft
siz,	you
dumli	Haley
Wings	Wings
o&#39;yin	play
Azot	Nitrogen
ultrahigh-qaror	ultrahigh-resolution
eşleştirilir	is mapped
X3153	X3153
og&#39;riqlari	headaches
WINDOWS	WINDOWS
goon	Goons
Sirt	The surface
&lt;ekdfc.14.0@ttacs1.ttu.edu&gt;	&amp; Lt; ekdfc.14.0@ttacs1.ttu.edu&amp;gt;
electronics	electronics
qalin,	thick
&quot;bosh&quot;	&amp; Quot; &amp; quot;
(dual	(Dual
chiqilishi	the development
&lt;Fenton@Kaleida.Com&gt;	&amp; Lt; Fenton@Kaleida.Com&amp;gt;
Chin)	Chin)
kanyonlar,	canyons,
Bos)	Bos)
shafoat	intercede
xato)	error)
gosh	gosh
berilgan,	,
berilgan.	.
oshiradi&quot;	&amp; quot;
Xotami,	Hate
Finlyandiya	Finland
versiyasini	version
O&#39;xshash	Similar
Avenue	Avenue
uch,	three,
munosabatlarni	relations
hisobga.	account.
Pul	Money
uch.	three.
bu,	This
Arabic	Arabic
(SF	(SF
(Re	(Re
Ishtar	Ishtar
shartnomasi	Treaty
nosimmetrik	Symmetrical
odatiy	usual
ayta	say
(No	(No
Emas,	It&#39;s not,
o&#39;zgardi.	changed.
pul	money
tortishish	shooting
(P.	(P.
so&#39;nggi&gt;	&amp; gt;
Spiros	Spiros
kiritish	enter
Foundation	Foundation
B2:&gt;	B2: &amp; gt;
bag&#39;ishlangan.	dedicated.
Topraklama	The grounding
romantik	romantic
Neptun	Neptun
1Meg	1Meg
past&gt;	Low &amp; gt;
boshlangan	started
savollar	Questions
makon,	space
atalishga	to be
belgisi	mark
sharmandalik.	shame.
avtobus	bus
yaqin,	close
gap)	GAP)
Titania	Titania
Audio	Audio
386DX-40	386DX-40
moslamalarni	objects
egalari	owners
&quot;ular&quot;,	&amp; Quot; &amp; quot ;,
Rauser)	Raus)
fikrlar	opinions
boshqalarni	others
tarmoqlari	networks
to&#39;lash.	payment.
O&#39;n	Ten
dalillar	facts
odatda	usually
Semiconductor	Semiconductor
to&#39;lash)	payment)
Java	Java
geologik	geological
tatbiq	implementation
orbitasi	orbit
koordinatalar	ordinates
to&#39;lash?	to pay?
Medical	Medical
oshiriladi)	)
xolislik.)	equity.)
ayt.	Tell me.
o&#39;tkaziladi	held
oshiriladi.	.
Qo&#39;shimcha	Additional
O&#39;z	Own
&lt;1993Apr20.102756.1709@mala.bc.ca&gt;	&amp; Lt; 1993Apr20.102756.1709@mala.bc.ca&amp;gt;
&quot;break	&amp; Quot; break
bc744@cleveland.Freenet.Edu	html>
zarralari	particles
oshiriladi?	?
Cirelli)	Cirella)
Albertan,	Alberto
millatli	MNCs
kitoblar	books
hijrat!	emigrate!
ko&#39;zalar&gt;	pitchers &amp; gt;
qarashda,	At first glance,
tuzish	Creating
sinf	class
(Va	(And
tasdiqlash	certification
o&#39;liklarning	the dead
Injil,	Gospel,
buyurgan	ordered
«talqin»	&#39;Interpretation&#39;
sessiyasi	session
energetika	energy
Bible	Bible
da&#39;vat	calling
Texnologiya,	Technology,
&quot;Siz	&amp; Quot;
yoqilgan	enabled
ko&#39;tarildi.	rose.
dumlar	tails
​​hozir	now
(Emi	(Amy
so&#39;zni	the word
foydalanuvchilar	users
Galant	Galant
deyilgan	says
baxtli	happy
(yangi)	(New)
sotish&gt;	sales &amp; gt;
miqdor	quantity
Welles	Welles
qulaylik	convenience
engillashtirish	facilitate
title-	title-
izoh	comment
jhardono@nickel.ucs.indiana.edu	html>
ortiqcha	excessive
tomondan	On the other hand
qatorida	Among the
ayol	woman
sayyora-keng	planet-wide
shifrlash&quot;&gt;	encryption &amp; quot; &amp; gt;
emas	it&#39;s not
gchin@ssf.Eng.Sun.COM	html>
ARMM&quot;	ARMM &amp; quot;
nasroniy	Christian
(gomoseksual	(Homosexuals
Gomoseksual	Homosexual
ROM	ROM
ayting.	website.
aka	brother
(6.118	(6,118
Yamaha	Yamaha
ayting)	website)
ayting,	website,
Verse	Verse
qilmang.	Do not.
tarmoqli	tape
Versa	Versa
daromad	income
bo&#39;lsangiz&gt;&gt;	&amp; gt; &amp; gt;
oyat-	oyat-
Uilyam	William
ommaga	the public
(va,	(And,
pragmatik	pragmatic
AUTOEXEC.BAT	AUTOEXEC.BAT
teleskoplar	telescopes
Xudoga	God
oddiy	simple
Chikagodagi	Chicago
Email	Email
bevosita	immediate
Finney)	Finney)
o&#39;zgaruvchilar	variable
*****************	*****************
ko&#39;rinadi.&quot;	will be shown. &amp; quot;
fikrim	thoughts
Kosmik	Space
aloqa&quot;	&amp; quot;
muomala.	treatment.
chegarani	border
o&#39;zgartirilgan.	changed.
boshlangan,	started
8300	8300
og&#39;irlik	weight,
tomon	party
-or-	-or-
mo&#39;ljallangan-yilda	In
rahmat&gt;	Thanks &amp; gt;
yetkaza	supply
o&#39;rgatish	to teach
O&#39;tmishda	In the past,
Evropa,	Europe
engp2008@nusunix1.nus.sg	html>
belanchak	to swing
erkin	liberal
Yoqubning	Jacob,
teshiklari	the holes
sayyoraga	planet
noyabr,	November
Ilmiy	Scientific
&quot;bajarildi&quot;	&amp; Quot; done &amp; quot;
2000	2000
Oldindan	In advance
zanglagan-qizil	rusty-red
versiyalari	versions
12-14)	12-14)
termokupl	thermocouples
tadqiqotlar,	Research
\&gt;	\ &amp; Gt;
krater-pocked	crater-Pocket
normal	normal
O&#39;sha	That
darajasi	level
tekshiring.	Check.
Alabama	Alabama
quyuq	dark
asoslangan	based on
ko&#39;mildi	buried,
Qonundan	The law
Oyning	Month
qaytish)	Back)
yuzlab	hundreds of
^^^^^^^^^^^^^^^^^^^^^^^^^^^^^^	^^^^^^^^^^^^^^^^^^^^^^^^^^^^^^
Lyme	Lyme
Universiteti	University of
sarma	volts
yerda	here
groove	groove
foydalangan	using
saboq	lessons
to&#39;qib	forged
ana	such
sayohat	travel
jonbozlik	dedication
professional&gt;	professional &amp; gt;
Dual-Sport	Dual-Sport
Hitter,	Hitter
mol,	goods
Return	Return
Repo	Repo
Villanova	Villanova
Orson	Orson
sanktsiya	Sanctions
payg&#39;ambarlar	prophets
amp	amp
amr	amr
qilaylik,	Let
hisoblanadi;	is;
Kompyuterlar	Computers
hisoblanadi:	is:
gravitatsiya	gravity
stoli	desktop
tekshirib	Check
Ba&#39;zan	Sometimes
---------------------------------	---------------------------------
qancha	how much
moliyaviy	financial
fosh,	mask,
tug&#39;ib	bore
Xudo,	God,
shakar	sugar
Yerni	Click here
qayiqda	the boat
(DOS	(DOS
P7625)	P7625)
sariq	yellow
yoki?	or?
Xudo:	God:
to&#39;g&#39;riligiga	the accuracy of the
ma&#39;naviy	spiritual
yolg&#39;iz&gt;	single &amp; gt;
fikrni	the idea
bormi:	Is it:
sadoqati	loyalty
bormi?	Is it?
sharoitlari	conditions
joylashtiriladi	be placed
rejalangan	planned
«sekin	Slowly
olamlarning	Worlds
;-)	;-)
+31	+31
biladimi	know
hisoblanadi,	is
S.)	S.)
Ular,	They
hisoblanadi.	is.
aks	reflection
&quot;Scooter,&quot;	&amp; Quot; Scooter &amp; quot;
tasodifiy	random
davlat	state
birlashgan	united
Pluto	Pluto
(boshqa	(Other
uglerod	carbon
uzoqda	away
atrofga	around
bilan&gt;	&amp; gt;
hosil;	;
faolligi	activity
=============================	=============================
nazar,	,
kuchaya	to swell
qurbonlik	sacrifice
oyatlarni	the signs
mahrum	sentenced to
sirtini	surface
funktsional	functional
417-4101	417-4101
yaratish	create
Randall	Randall
nafrat	hate
yoqadi.	like.
bo&#39;lsin.	Let.
willisw@coe-nw.clemson.edu	html>
guruhlar,	groups
sayyoramizdagi	planet
Micronics	Micronics
tovushi	the sound
printerni	printer
bo&#39;lsin!	Let!
tushib	fall
Schuster)	Schuster)
murojaat	address
bo&#39;ylab,	Worldwide,
Uilyams	Williams
kristallari	crystals
&lt;1993Apr21.182606.6798@ra.royalroads.ca&gt;	&amp; Lt; 1993Apr21.182606.6798@ra.royalroads.ca&amp;gt;
hajmi,	volume,
yirik,	large,
DR350S	DR350S
ishlaydi.	work.
Qo&#39;shnilari	Neighbors
&quot;U	&amp; Quot;
ichiladi	Designated
kimga	anyone
**********	**********
qilinishi	things
ishlaydi?	work?
g&#39;aram	haystack
qismidir.	part.
Mashina	Machine
RIP	RIP
yetarli	enough
aytaylik.	for example.
yarim-muz,	half-ice,
&quot;?	&amp; Quot ;?
ko&#39;p&gt;	&amp; gt;
erkak	male
sovutiladi	cooled
ayol,	Women,
(Ibroniylarga	(Hebrews
Gods	Gods
aslida	actually
&quot;,	&amp; Quot ;,
Quyoshning	The sun
&quot;.	&amp; Quot ;.
orada	Meanwhile,
haydash	ride
m-it2691@cs.nyu.edu	html>
idish	The container
turibsizlar.	stand.
solaman;	Solana;
ekilgan	planted
tashlashdi,	cast
dlb@hudson.wash.inmet.com	html>
ishlatiladi,	used,
ishlatiladi.	is used.
jamoalar	The teams
solaman,	I will
irodasiga	the will of the
Genri	Henry
argon,	argon,
xursand	glad
porlaydi.	Shines.
SUPERVGA	Superve
&quot;Plastinka&quot;	&amp; Quot; plate &amp; quot;
ionlar	ions
teskarisini.	the opposite.
jamoa	community
rethorical	rethorical
Askew	Askew
zikr	mentioned
o&#39;xshash	similar
bilagini	wrist
chiqarish.	.
chiqarish,	production
^^^^&gt;	^^^^ &amp; Gt;
aprel,	April
gravitatsion	gravitational
ommasi	the masses
quacks	quacks
meteorologiya	Meteorology
nemis	German
sayyorada	planet
darajali	level
yadrosining	nucleus
o&#39;sha.	.
Whitsell	Whitsell
shimoliy	northern
asetilen,	acetylene,
paneli	Toolbar
etmoqda?	?
Yerga	The ground
Yuqori	High
qilingan	have been
ichki	internal
oshirish	increase
qilmasliklaridandir	not
mintaqasini,	region
613)	613)
etmoqda.	.
etmoqda,	,
&lt;15378	&amp; Lt; 1537
zondlar	probes
Costner	Costner
mos.	.
Near-bo&#39;ron	Near-storm
mantiya	mantle
uslublarini	methods
hambidge@bms.com	html>
dunyodan	the world
ayollarga	women
18:33	18:33
solishtirganda,	Compared to,
qon	blood
DBD@ICF.HRB.COM	html>
(Clayton	(Clayton
texnologiyasi,	Technology
theists)	theists)
reliz	Release
Guerke,	Guerke
İticiler	Thrusters
Guerke)	Guerke)
Faqat	Only
avlodlar	generations
Chill.	Chill.
ulkan	huge
theists,	theists,
yuborish	Send
Project	Project
B433EI2	B433EI2
chunki?	because?
ateist&quot;	Atheist &amp; quot;
darajaga	level
Cape	Cape
amerikaliklar).	Americans).
(ehtimol	(Perhaps
haq.	the truth.
11:26),	11:26)
Karl	Karl
chunki,	because,
g&#39;oyalarni	ideas
o&#39;chirildi	deleted
3-8),	3-8)
ikki	two
Surveyor	Surveyor
Yerda	Here
(Herman	(Herman
ai843@yfn.ysu.edu	html>
thomasp@ifi.uio.no	html>
To&#39;rt	Four
anekdot	anekdot
to&#39;qqiz	nine
dunyoda,	the world
Boshqalar	Others
LATONIA)	LATONIA)
tasdiqlagan,	confirmed
muhitini	environment
Nyu-York	New York
Quebec,&gt;	Quebec &amp; gt;
yo&#39;q)	No)
yo&#39;q,	No,
o&#39;zimizni	ourselves
yo&#39;q.	no.
Allohga	Allah
harf	letter
Managerda	Manager
hard	hard
(Peter	(Peter
aralash	mixed
(21,648	(21,648
Stone)	Stone)
ogohlik	clutch
dono)	wise)
Harakat	Action
chiqinglar.	Quit.
ostida,	Under the
kesib-nazorat	-cut control
burchakli	Feeback
DELCO	DELCO
23-26,	23-26,
haqida,	About
masihiy	Christian
xavas,	Havas,
halo	halo
uzunligi	The length of the
pley-off	play-off
egasidirģ	Those lucky
hali	yet
o&#39;zlarini,	themselves,
Christian	Christian
Uzoq	Far
alung@megatest.com	html>
Sayyoralar	Planets
yoritilgan	lit
qodir.	capable of.
batareyani	battery
ham,	,
havoriylariga,	apostles,
FJ1200	FJ1200
ham.	.
Oyga	The moon
diplomatiya	Diplomacy
(shapka,	(Hat,
oshiriladi	will be
haqida?	?
Detroyt	Detroit
kichik,	small,
ham)	)
olishi	take
agentligi	Agency
kichik)	Small)
ko&#39;plab	many
Sarlavha	Title
haqida.	.
yo&#39;li	Road
(Dan	(Dan
Thorson	Thorson
Reyting:	Ratings:
noto&#39;g&#39;ri,	wrong
so&#39;rovnoma	poll
zarur.	necessary.
Pharasees	Pharasees
yo&#39;l,	,
Oyda	Month
takomillashtirish	improvement
suhbatlashdi	a conversation
signal	signal
noto&#39;g&#39;ri	wrong
Raketa	Missile
kech	late
--------------------------	--------------------------
Corolla	Corolla
qo&#39;shadi.	Addiction.
Taxta,	Flooring,
qum	sand
kamarning	Belt,
qo&#39;shadi,	Addiction
kitobxonlar	readers
taraqqiyot	progress
Nagle	Nagle
ob&#39;ektlarni	objects
ota-va	and parents
Moon	Moon
oyatlarda	verses
==========================================	==========================================
g&#39;oyalarini	ideas
tushunib	understand
maqola	article
Rauser	Raus
adolatli	fair
çökmekte	crumbling
darajada	level
(2.544	(2,544
olgan&gt;	&amp; gt;
bog&#39;liq	related
ekan.	.
topish	find
ekan,	Therefore,
foto	photo
qadriga	appreciate
Rossiya,	Russia,
HAMZA	HAMZA
yo&#39;l)	)
talqini.	interpretation.
qizg&#39;in	heated
Coord.	Coord.
#&gt;	# &amp; Gt;
drama	drama
Filip)	Phillip)
bilgan	I knew
vositalarini	means
Ulysses	Ulysses
Kaliforniya	California
g&#39;oyasini	The idea of
itrakonazol	itraconazole
reja,	plan
415-688-8231	415-688-8231
Turli&gt;	&amp; Gt;
Que	Que
tashlangan	removed
Nobuaki	Nobuaki
20Meg	20Meg
Nowadys	Nowadys
Keyinchalik	Later
Brooks	Brooks
Rendezvous	Rendezvous
topsangiz,	Getting
muddat	term
o&#39;tib,	later,
Pioneers	Pioneers
Momo	Eve
asl	original
fosh	exposed
shogirdidan,	students,
--------	--------
donut	donut
ehtiyot	spare
darslari	classes
JESUSCHRIST	JESUSCHRIST
firibgarlik	fraud
o&#39;zgartirishda	transform
Apriori	Apriori
olish:	Views:
buyuradi.	to pay.
mo&#39;minlarga&gt;	Believers &amp; gt;
boshqalar,	others
natija	result
qopqog&#39;ini	cover
emasmiz,	not
saraton	cancer
Maksvell	Maxwell
Kokomo,	Kokomo
ishlar	Affairs
ayollarni	women
do&#39;zaxdan	Fire,
olish,	,
tomchi	drip
Maydoni	Area
orbitasini	orbit
gumanitar	humanitarian
refering	referrals
ibodat	worship
bag&#39;ishlangan	dedicated to
markaziy&gt;	Central &amp; gt;
aql	intelligence
ishlab	production
tasvirlarni	images
aniqlashdi.	discovered.
shgichlar:	connectors:
abadiylashtirish	perpetuate
Maktab,	School
(der	(Der
Cary	Cary
bermadi.	I did not.
uyg&#39;onish	wake up
Oyni	The moon
eshitildi	heard
bosqichga	level
davolash	cure
erkaklar,	Men
avj	escalation
Askew,	Askew
Seminar	Seminar
reasonning	Reasons
majburlash	coercion
Proper	Proper
qobiq	dressing
o&#39;qish,	read
unclumped	unclumped
(1,170	(1,170
o&#39;qish)	Reading)
Freq.	Freq.
Arablar	Arabs
hokazo	etc.
kasalliklar	Diseases
Palmer	Palmer
(Darvoqe,	(By the way,
qaytarmoqchi	to discourage
Nunnally)	Nunnally)
&lt;bo&#39;sh	&amp; Lt; empty
asr	century
bashorat	prophesy
nurlarini	rays
nazarda	by the
masala	issue
&quot;haqida	&amp; Quot;
bosqichda	stage
mashg&#39;ulotlari	Occupation
Alyosha	Alyosha
majlislarida&gt;	meetings &amp; gt;
eslab	Remember
yozib	record
ato	given
(va	(And
havo	air
VL-avtobus	VL-bus
Buning	It
Plus	Plus
Askew)	Askew)
eshitib	heard
Lankford	Lankford
tushirish	Start
buy-orqa	buy-back
RSEVERY	RSEVERY
(faqat	(Only
yo&#39;qol	go away
o&#39;rganamiz.	learn.
Carl	Carl
universiteti	University of
parokandalik	turmoil
Card	Card
eslay	remember
xavfsizligi&quot;	Security &amp; quot;
tortiladi,	subject to,
jiddiy	serious
Qoida	Rule
tezligi	speed
Ichida	Within
Justification_,	Justification_
yana&gt;&gt;,	&amp; gt; &amp; gt ;,
tabiatda	nature
sessiya	session
pgf@srl03.cacs.usl.edu	html>
Uy-pishirmoq	Home-cooked
hujjat	document
kashfiyotlar	discoveries
roli	The role of
sekin	slow
emasmi?	Is it?
Xudosi&quot;,	God &amp; quot ;,
oldin,	before
asteroit	Asteroid
oldin.	ago.
homosexal	homosexal
[386Enh]	[386Enh]
yuborilgan	sent
o&#39;zgartiradi	converts
ishonasizmi?	Do you believe that?
Iso	Jesus
kim&gt;	&amp; gt;
native	native
etadi,	,
kutaman	Waiting for
e&#39;lon	announcement
o&#39;tish	Go to
etadi.	.
o&#39;zimni.	myself.
oldim.	I.
bog&#39;liq.	.
AT)	AT)
(non-Duo)	(Non-Dead)
eshitmagan?	heard?
shartnoma.	the contract.
_____	_____
Qodir.	Almighty.
olish	to get
gumon	suspicion
hukmron	ruling
dizaynerlari	designers
oldini	prevention
yozilgan,	written
huquqdan	right
asteroid	asteroid
omad	luck
fitna	conspiracy
Isoni	Jesus
[Ibroniylarga	[Hebrews
teskari	reverse
Hozir&gt;	Now &amp; gt;
Communications	Communications
yarimsharda	Hemisphere
dasturlarda	applications
(va&gt;	(&amp; Gt;
bo&#39;lmagan.	.
040	040
yog&#39;dirilgan.	women as well as men.
20X-60X60mm,	20X-60X60mm
qaroqchi,	Thieves,
hetero	hetero
universiteti:	University:
o&#39;ylash	focus
ateistlar	Atheists
qilayotganini.	that.
AIAA	AIAA
derazasiga	window
dinamikasi,	dynamics,
qaynoq	boiling
emasmi	Is
_______________________	_______________________
o&#39;chirilishi	deleted
azot,	nitrogen,
Phobos	Phobos
yangilanadi.	updated.
fabrikalar	Factories
&lt;C5xxq0.18M@cs.columbia.edu&gt;	&amp; Lt; C5xxq0.18M@cs.columbia.edu&amp;gt;
narigi	the other side
DH-kabi	As DH
Comet	Comet
versiyasi.	version.
===============	===============
adabiyotlarda	literature
ko&#39;tarib,	raised
Galiley,	Galileo,
sovuq,	cold,
N-8-1	N-8-1
piramida}	Pyramid}
kimdir,	someone
Panoramic	Panoramic
mo&#39;g&#39;ullar	Mongols
tananing	the body
organlari	bodies
daryo	river
Baseball	Baseball
mumkin	You can
Madyanga	The Madyan
boshlaydi.	.
javob:&gt;	Answer: &amp; gt;
ufqda	on the horizon
WinJPEG	WinJPEG
Magellan,	Magellan
Okay,	Okay,
koloniya	colony
ko&#39;rinishi,	appearance
komikslar	comics
&quot;&gt;	&amp; Quot; &amp; gt;
000	000
[masihiylar]	[Christians]
tizimi	System
qutblar	poles
gazetasi	Newspaper
(UNT-CAS	(UNT-CAS
kun-litsenziya	-day license
atmosferasida	atmosphere
S5R3.2	S5R3.2
chiqardi.	was issued.
muzlatilgan	Frozen
Humphreys	Humphreys
tushunchasi.	concept.
meniki	mine
3.1,	3.1
xudosizlar	atheists
omma	mass
erkinligi	Freedom of
yükseltilebilir	upgradeable
duchor	exposed
Odam,	The man,
sababi&quot;	The reason for &amp; quot;
rang	color
&quot;velopoygachi»	&amp; Quot; doping
ya&#39;ni	that is,
Quddus	Jerusalem
oling	Learn
(Nik	(Nick
etyolojik	etiologic
ko&#39;rsatadi,	shows
​​non-tajovuzkor,	non-aggressive,
132,252	132.252
Qarshi	Against
Active	Active
bosimini	pressure
toml@boulder.ParcPlace.COM	html>
Herman,	Herman,
Kreyg	Craig
kabellar:	Cars:
ko&#39;rsatadi.	.
mars,	Mars,
balandlik	height
Asosiy	Main
oldingi	previous
^^^^^^	^^^^^^
tajriba.	experience.
emasman	I&#39;m not
fikr-mulohazalaringizni	comments
oldinga	ahead
missiyalari	missions
Merkuriy,	Mercury,
nomga	title
gapirdingizmi!	gapirdingizmi!
resurslari	Resources
Teleskop	Telescope
shayton	devil
olaman	I&#39;ll
tabiblarga	healers
​​Mars	Mars
Maftunkorliliga	Maftunkorliliga
olasizmi,&gt;	Are you a &amp; gt;
tushlar)	dreams)
Felix	Felix
ulushi	The share
Heterosexuel	Heterosexual
o&#39;qi	READ
qiluvchi	Buyer
paytida	During the
tevaragida	a vague
chipset	chipset
symbolisms&gt;	Symbolisme &amp; gt;
g&#39;alaba	victory
Bake	Bake
da&#39;vo&gt;,	&amp; gt ;, claim
Newton	Newton
(Bill	(Bill
aslida&gt;&gt;	Collins &amp; gt; &amp; gt;
aytaman	I say
sabablari:	Reasons:
oynaning	window
lekin,	but,
zarba	impact
jahon	World
urinishlariga	efforts
Sichqonchasi;	Mouse;
zarar	harm
|&gt;&gt;	| &amp; Gt; &amp; gt;
yer-out-of-biznes	Land-out-of-business
mashinalar	park
kriptografik	cryptographic
marly	Marly
belbog&#39;larini	belts
qonun	law
TIFF	TIFF
yozgan	wrote
musibat	disaster
istiqomat	living in
Timmons	Timmons
urinishlar	Attempts
geografik	geographical
ikki&gt;	&amp; gt;
mamlakat	country
Fisher	Fisher
o&#39;rniga&gt;	instead of &amp; gt;
nomi	the name
ma&#39;muriyatining	administration
6/92,	6/92
olishda	Tart
topishingiz	find
tuman	district
shakllari,	forms,
dasturlarga	applications
katta&gt;	a &amp; gt;
Germaniya,	Germany,
mlee@post.RoyalRoads.ca	html>
qabr	grave
o&#39;ng	right
15-siz&gt;	15 &amp; gt;
v124p7kk@ubvmsc.cc.buffalo.edu	html>
ishlarni	work
neccacery	neccacery
(Yusuf	(Yusuf
berishi	give
Placebo	Placebo
emasmi.	Is.
Qizil	Red
____________________________________________	____________________________________________
1992/93	1992/93
chiqdi.	.
bo&#39;yicha,	on
qilmadi	did not
zichlikka	density
bo&#39;lmasdan	without
KELDI	ARRIVE
AAS	AAS
Jet	Jet
qulflangan,	locked,
Inc.	Inc.
tarbiyasida	the education of
qulflangan.	locked.
&quot;jargonese&quot;)	&amp; Quot; jargonese &amp; quot;)
Yee)	Yee)
olmaysiz.	You can not.
Inc,	Inc
kuzatganman.	observed.
to&#39;rttaga	four
qo&#39;ng&#39;iroqning	of the call
Triantafyllopoulos)	Triantafyllopoulos)
uzoqlashib,	away,
BO&#39;LGAN	WITH
(myslef	(Myslef
yo&#39;qdan	The Originator
qurolga	firearm
salomatligini	health,
qatnashdi	participated in
Safety	Safety
Mitchum)	Mitchum)
teginish	touch
nazardan,	Accordingly,
berdi,	,
berdi.	.
molekulalari	molecules
aniqlangan.	identified.
raqamlarini	numbers
Atrofida	Around
reklama	advertisement
asosiy-kamar	The main-belt
ob-havo	Weather
Englewood,	Englewood,
bemor	patient
to&#39;lgan	filled
&quot;dinamik&quot;.	&amp; Quot; dynamic &amp; quot ;.
ikkita	two
noorganik	inorganic
ANTI-Trust	ANTI-TRUST
KES	KES
olov	fire
&quot;uzoq	&amp; Quot;
mitti&quot;	small &amp; quot;
qaytganida,	returned
tanlagan	chosen
Albatta,	Of course,
(CRAF)	(Craft)
o&#39;zi	himself
futbolchilar?	players?
rozi	agree
talqinlar	interpretations
(Mayk	(Mike
knifes	knifes
omadli	lucky
(Hans	(Hans
jaskew@spam.maths.adelaide.edu.au	html>
chodirlarda	tents
antennalar	Aerials
Pasadena,	Pasadena,
aylanib	become
hududlari	zones
Jay	Jay
Vancouver	Vancouver
magnit	magnet
fanlar	Sciences
Faehl)	Faehl)
meva,	fruit,
ikkisi	both
nur	beam
mening	my
Odam	Man
e&#39;tiqodlari	beliefs
iste&#39;mol	consumption
sig&#39;maydigan	excels
cho&#39;zilgan	extending
xaridorning	buyer
tanqidga	criticism
oynani	popup
o&#39;yinni	game
(Mark	(Mark
(Mat.	(Matt.
vositachi	intermediate
Yahudiylar,	Jews,
yordamida,	using
&quot;electroglow.&quot;	&amp; Quot; electroglow. &amp; Quot;
ruhiy	mental
Adams	Adams
tektonik	tectonic
(sianid	(Cyanide
heterojenlik	heterogeneity
Masters,	Masters
Lore	Lore
Oxir-oqibat,	In the end,
Shuning	Therefore,
(afzal	(Preferences
^),	^)
yulduzning	the star
ADC	ADC
so&#39;ngra	then
(303)488-6120	(303)488-6120
451-0815,	451-0815,
(_______________________)	(_______________________)
chap?	left?
Evro-urish)	Euro-Pulse)
chunki&gt;	&amp; gt;
to&#39;g&#39;ri!	right!
(Ethan	(Ethan
Masihga	Christ
(Matt	(Matt
qilmoqchi	you want
rahmat	Thank you
taxmin	guess
alohida-alohida	separately
fungal	fungal
kirdi.	entered.
Viking	Viking
kengliklarida.	bands.
Nagle)	Nagle)
katta	large
&quot;ism	&amp; Quot; name
olma	apple
kuzatilmoqda.	observed.
atraction	Atractii
sintez	synthesis
tiriladi	will be resurrected
laetril	laetril
scan	scan
Info	Info
radiatsiya	radiation
chang	dust
keladi	come
MacRae)	MacRae)
Look	Look
&lt;1993Apr17.125545.22457@rose.com&gt;	&amp; Lt; 1993Apr17.125545.22457@rose.com&amp;gt;
instituti&gt;	Institute &amp; gt;
(Keyt	(Keith
qotillik	murder
AIR	AIR
^^^^^^^^^^^^^^^^^^^^^^^	^^^^^^^^^^^^^^^^^^^^^^^
gapirganda	Speaking
biz&gt;	We &amp; gt;
beraman	Lease
Horus	Horus
ko&#39;rindi	appeared
shafqatsiz	ruthless
ishtirok	participate in
bechora	pitiful
Joseph	Joseph
xx155@yfn.ysu.edu	html>
nom	title
non	bread
ahvoli	status
&quot;savdo	&amp; Quot;
jinsiy	sexual
Microsystems	Microsystems
muammo	problem
Qancha	How much
ko&#39;ring.	.
(Rick	(Rick
(437	(437
ko&#39;ring,	,
&quot;biz&quot;	&amp; Quot; &amp; quot;
rangi	color
tanish	recognition
Bloomberg,	Bloomberg,
hech,	no,
​​muayyan	certain
Faks:	Fax:
Management	Management
o&#39;yinda	match
parodiya	parody
oynada	window
&quot;uzuk,	&amp; Quot; Ring
qismini	part
******************	******************
[ajoyib	[Great
axloqi	Morals
yoqilg&#39;i	fuel
yo&#39;lida,	on the way
100&gt;	100 &amp; gt;
chiqadi.	.
Korinfliklarga	Corinthians
axloq]	Ethics]
(Brian	(Brian
&quot;Xudo&quot;	&amp; Quot; God &amp; quot;
ming	thousand
ammo,	but,
Iltimos	Please
Erning	The earth
803-654-8817	803-654-8817
masalalarni	issues
sochlari	hair
British	British
kuzatuvchi	observer
inson-Mürettebatlı	-man crew,
so&#39;nggi	latest
sahifalar	Pages
erkaklar&gt;	Men &amp; gt;
davrlar	periods
qaror:	Decision:
karışıklığından	perturbations
fayllar	files
jangda	battle
»bilan	»
borish	go to
chamadonni	suitcase
qilgach,	After
kalitlari	keys
&quot;nisbiy.&quot;	&amp; Quot; relative. &amp; Quot;
Sotuvchining	Seller
Shtatlari	States
kiritishingiz	to add
tarbiyalashda	in upbringing
34,839	34.839
muzli	icy
sci.crypt	sci.crypt
miqdorda,	amount,
tasdiqladi.	has confirmed.
olti	six
aholi	population
Qariyb	Almost
manziliga	address
&quot;yuz	&amp; Quot;
​​murakkab	difficult
Jon	John
(447	(447
sharqdan	the east
samarasiz	ineffective
Joe	Joe
-club	-club
Agressive	Agressive
hollarda,	cases
qilmang	Do not
dioksid	dioxide
tasma	ribbon
[LDS]	[LDS]
40Meg	40Meg
namunalarini	samples
ta&#39;lim	education
distributorga	distributor
molesters	molesters
Emulator	Emulator
qoldiqlari.	Ruins.
Yangiliklar	News
qoldiqlari,	Ruins,
aylandi	has become
o&#39;tkazgandan	spending
chiqaylik.	Let.
(siz	(You
qilishingiz	to
Ju)	Ju)
anglatadi.	means.
Shvetsiya	Sweden
15:	15:
ingliz	English
kamchiliklarni	shortcomings
qadr-qimmatini	dignity
Harvey)	Harvey)
shifrlash&gt;	encryption &amp; gt;
tinchlikda	Barista
150	150
15,	15
anglatadi?	mean?
Stanley	Stanley
qurilmalar	devices
insoniyat	humanity
kurashsagina	struggles
Norvegiya	Norway
qurilma,	The device,
xristian	Christian
joylashtirish	placement
Apple	Apple
yuborgan	sent
ibtidoiy	primitive
Wizzard	Wizzard
ohm	ohm
162	162
ovozli	sound
(215)645-6463	(215)645-6463
umuman	general
piksel	pixels
bokira	virgin
Jadvalga	Table
dedi:&quot;	said: &amp; quot;
sotilgan.	sold.
Havoriylar	Acts of the Apostles
kegani	hers
o&#39;ylaysiz	think
ma&#39;lumot)	Information)
176	176
ok,	ok,
qidiruv&gt;	Search &amp; gt;
chaqirib,	calling
170	170
ekanligini	that
_hard_	_hard_
masihiylar,	Christians,
tuzildi	was made
yuboriladi.	sent.
örtülmemesidir	obscuring
xudolarsiz,	gods,
nihoyatda	very
Ba&#39;zi	Some
nafratlanaman.)	I hate).
to&#39;pi	the ball
oqlanishni	justification
Sukunatga	Silence
Menga	Me
sana	date
zarur	necessary
o&#39;rab,	surrounded
X-Window	X-Window
(Brian@gab.unt.edu)	(Brian@gab.unt.edu)
hayoti	life
yuzasiga,	surface,
muzliklarning	glaciers
[&quot;Isoning	[&amp; Quot; Jesus
&quot;yoki	&amp; Quot; or
ajoyib	remarkable
masihiylar?	Christians?
&quot;Bir	&amp; Quot;
yo&#39;ldoshlarini	satellites
xarakterdagi	character
va&#39;zgo&#39;ylik	preaching
(David	(David
21-22	21-22
o&#39;n	ten
moddiy&gt;&gt;	material &amp; gt; &amp; gt;
(post	(Post
&quot;Biz	&amp; Quot; We
imkonsiz	impossible
oqish	leak
o&#39;z	own
wrap,	wrap
Karamazovlar	Karamazov
pole	pole
ismingiz	Your name
bemorlarga	patients
Noring)	Nori)
20850	20850
xavf	risk
kasalliklarni	diseases
cramer@optilink.COM	html>
Yulduzning	The star
122	122
Shack	Shack
kabi.	such as.
Mags	Mags
yahudiy	Jew
ta&#39;siri&quot;	effect &amp; quot;
muhimdir.	It is important.
hayot.	life.
saqlanayotgan	stored
&lt;1993Apr16.173252.7393@asd.com&gt;	&amp; Lt; 1993Apr16.173252.7393@asd.com&amp;gt;
guruhi	Group
kabi,	such as,
arab,	Arab,
muqobil&gt;	Alternative &amp; gt;
120	120
kabi)	such as)
Saturn,	Saturn,
namozda)	Salah)
Quinn)	Quinn)
Butrus&gt;	Peter &amp; gt;
mikser	mixer
qolgan	remaining
Payg&#39;ambarlarni	The prophets
Hisoblash	Calculation
tushuntirib	explain
Fridman	Fridman
(408)	(408)
Keyinchalik,	Then,
Orbiter	Orbiter
Camary	Camarena
imkoniyatiga	to
13,	13
joylashgan	located
bo&#39;lganlar	ones
Mail	Email
safarlarimiz	journeys
isloh	reforming
yo&#39;qligi	The lack of
Isroil	Israel
------------------------------	------------------------------
&lt;timmbake@mcl.ucsb.edu&gt;&gt;&gt;	&amp; Lt; timmbake@mcl.ucsb.edu&amp;gt; &amp; gt; &amp; gt;
ko&#39;rib	consideration
xato	error
Taxminan	Approximately
149	149
14:	14:
********	********
&quot;Isoni	&amp; Quot; Jesus
92.8	92.8
liniyalari	lines
dasturi	program
yotoqlari	bearings
orbitasida,	orbit
off	off
guruh,	group,
140	140
xastaligidan	ailment
oqibatida	As a result of
turing	hold
ochiladi	opens
Frantsiya,	France,
Jonson,&gt;	Johnson &amp; gt;
tormoz	brake
Torre	Torre
Yevropa	Europe
o&#39;ylamayman.	I do not think.
xavfsiz	secure
Masihiy	Christian
qaysi&gt;	&amp; gt;
o&#39;g&#39;illari,	sons,
Kasallik	Disease
yo&#39;qligini	whether
faxrlanib,	proud
qurilma	The device
Mototsikllar	Motorcycles
nazardan	Within
olmadi.	failed.
Xulosa	Summary
ofset	Offset
Qadimgi	Ancient
wagner@mala.bc.ca	html>
&quot;Sizning	&amp; Quot; Your
dastur.	program.
Oltingugurt	Sulfur
yopilishi	Closing of
(Noring	(Norio
gapirayotganim	speaking
boshlaydi	begin
etsa,	If the
&quot;Shifrlash	&amp; Quot; encryption
shunday	so
o&#39;lgan	dead
oynasi	The window
edi&gt;	&amp; gt;
indicting&gt;	indica &amp; gt;
nuqtalari	points
berilgan	given
dollar	dollar
(shunday	(
niyatlarini	intentions
LA,	LA
CRAF	Craft
readiing	readiing
o&#39;zgaradi,	change,
oqimi	flow
ilovasidan	app
obo	OBO
nazorati	Control
xursandman.	I am happy.
kitobida	In the book
(deyarli)	(Almost)
qora	black
tomir,	vascular,
tıklatırsa	clicks
yutuqlari	achievements
19,	19
poda	herd
mouse@thunder.mcrcim.mcgill.edu	html>
Fraering	Fraering
vakolatxonalari	representative offices
(Oh,	(Oh,
VESA	VESA
daqiqa	minute
a&#39;zolari	The members of the
RA&gt;	RA &amp; gt;
bakterial	bacterial
pitching	pitching
Masihni	Christ
balki!	but!
qo&#39;llab-quvvatlaydi	supports
Qadimiy	Antique
Yupiter,	Jupiter,
ierarxik	hierarchical
19:	19:
vodiylarda	valleys
berur.	He will.
Aksariyat	Majority
o&#39;zini	himself
balki,	but,
tugadi	ended
zahirasini	a reserve
tergov	investigation
Halley	Halley
Tabiblar	Healers
Deb,	That
bemalol,	free,
professional	professional
vositalari	tools
payg&#39;ambar	prophet
&lt;C51nLs.7As@boi.hp.com&gt;	&amp; Lt; C51nLs.7As@boi.hp.com&amp;gt;
trillionth	trillionth
27.2.	27.2.
&quot;Magic&quot;&gt;&gt;	&amp; Quot; Magic &amp; quot; &amp; gt; &amp; gt;
jarrohlik,	surgical,
yuqorisida	at the top
talabgor	Bidders
(Tinglash).	(CAL).
o&#39;qildi	read
chiqishidan	LEAVE
Mercury	Mercury
Boyd	Boyd
ijobiy	positive
emas.	it&#39;s not.
emas,	it&#39;s not,
VE7GDA	VE7GDA
rishiz	flyby
---------------	---------------
&quot;eshkaklar	&amp; Quot; shovels
bekor	canceled
asteroitler	Asteroids
emas)	it&#39;s not)
LDS	LDS
BO&#39;LMAGAN	NOT
Jahannam&gt;	Hell &amp; gt;
boshlagan	started
tushirilishi	The launch of
to&#39;xtadi.	stopped.
LED	LED
mulohaza	reasoning
sun&#39;iy	artificial
qismida	Eastern
emas?	it&#39;s not?
tunda	night
turish	stay
oniy	instant
emas;	it&#39;s not;
viloyatlariga&quot;	regions &amp; quot;
&quot;sub&#39;ektiv&quot;	&amp; Quot; subjective &amp; quot;
Lvc@cbnews.cb.att.com	html>
~~~	~~~
xalq	people
Millatiga	Ethnic
ishlatish	the use of
sarf	spending
aralashmasidir.	mixture.
to&#39;g&#39;ridan-to&#39;g&#39;ri	straight away
himoya	protection
olish&gt;	&amp; gt;
Ken	Ken
qator	series
oshiradi.	increases.
yuborilgan.	sent.
kiriting:	enter:
Venera,	Venus,
Matt	Matt
chunki	because
yashiringan.	hidden.
astronomi	astronomer
oz,	little
murabbiyi	Coach
farqni	the difference
ko&#39;rinishi	appearance
gravitacional	gravitacional
&lt;1993Apr4.221228.17577@bsu-ucs&gt;	&amp; Lt; 1993Apr4.221228.17577@bsu-ucs&amp;gt;
kuzatilishi	Traceable
ovoz&gt;	&amp; gt;
to&#39;laqonli	full
ohista	softly
gapning	sentence
odamlarga	the people
(liscened	(Liscened
endi	Now
ko&#39;rikdan	examination
o&#39;ynaymiz.	play.
Ayniqsa	Especially
tilaymiz!	Good luck!
oy,	month
tezlikda	speed
ULARNING&gt;	DA &amp; gt;
raqamini	number
rivojlanishi	development
tizimli&gt;	Structural &amp; gt;
Bo&#39;ron	Storm
(Gordon	(Gordon
(510)	(510)
o&#39;tib&gt;	Salon &amp; gt;
so&#39;radi.	he asked.
&quot;kasallik	&amp; Quot; disease
Rechargeable	Rechargeable
Scandinavians	Scandinavians
astronom,	astronomer,
qismi	part
kerakki,	It should be noted that,
cho&#39;ponlik	shepherding
uchib	flying
rost»,	True,
farqli	Unlike
&quot;rag&#39;batlantirish&quot;	&amp; Quot; stimulus &amp; quot;
qolish!	stay!
astein@israel.nysernet.org	html>
jismoniy	physical
Qanday	How
qimmat	expensive
shifokorga	doctor
Texnikaning&gt;	Technic &amp; gt;
muvofiqligini	compliance with
biridan	one of the
orbita	The orbit
mehmon	guest
100,000	100,000
sobiq	former
so&#39;rashi	ask
xafa	upset
Qachon	When
ko&#39;z	eye
ruxsatsiz	unauthorized
Express	Express
o&#39;ziga	himself
unutmang.	Do not forget.
singari	such as
Infiniti	Infiniti
​​Masih	Christ
aylanishlar	Orbit
o&#39;zga	else
izlaydi.	Arar.
Rossiya	Russia
kuyruklu	comet
metodlarni	techniques
Kim	Who
bo&#39;rilar	wolves
sobit	fixed
qilmadi.	did.
scott@asd.com	html>
(astronomik	(Astronomical
qilmadi,	I did not
sug&#39;urta	insurance
Maqolada	Article
Maqola	Article
ishlashi	Performance
yangi	new
(Yuhanno	(John
tepasida	above
1-26	1-26
Kipling	Kipling
aqldan	crazy
&quot;sport&quot;	&amp; Quot; Sports &amp; quot;
mart,	March
etildi	It was
Qaerda	Where
ko&#39;k	blue
omon	survive
starowl@rahul.net	html>
tasmasi	BAND
ko&#39;p	many
ma&#39;nolari	meanings
avval	before
paradoks	paradox
surunkali	chronic
so&#39;rash)	Claims)
zarurligini	the need to
qisqa	short
o&#39;zim	I myself
bo&#39;lgan	which
4-savol,	Q4,
bozor	market
​​bir	one
ma&#39;qul	acceptable
qatra	drop
qozig&#39;ini	peg
nisbiy	The relative
yozuvlar	records
odamlarni	people
..:.:	..:.:
(Alan	(Alan
oqib,	flow
Gordon	Gordon
tufayli	Due to
hodisaga	Commonly,
qamariy	lunar
Mayk	Mike
o&#39;zida	at
o&#39;zgaruvchan	variable
reparented	reparented
ishonchli	reliable
qilindi,	It was,
qilindi.	.
Benedikt	Benedict
plitalarning	plates
Keyin	After
PB170	PB170
xalqining	people
marta	times
hamrohlik	accompaniment
(aprel	(April
Infinity	Infinity
M.)	M.)
kemiruvchilar	rodents
out	out
Man,	Man,
(tez	(
«Xudo	&#39;God
iyun	June
yuboring.	Send.
betayin	vanity,
to&#39;qnashuv	collision
Jo&#39;sh	Turbulence
yaxshiroq	better
bir-yarim	one-half
Folta	Foltz
so&#39;z	word
(bir	(A
yuqori.	high.
xalta	bag
oq,	white
katta,	great
tajribasiga	experience
supurib	sweep
kasalman	sick
katta.	great.
yuqori,	High,
topdik.	found.
qalqonsimon	thyroid
(biz	(We
bep1@cbnewsg.cb.att.com	html>
silikat	Silicate
g&#39;alati	strange
ishonchni	confidence
qaramasdan	despite
Shoh	King
ko&#39;chib	move
&lt;lsj4ruINNl7o@saltillo.cs.utexas.edu&gt;	&amp; Lt; lsj4ruINNl7o@saltillo.cs.utexas.edu&amp;gt;
uning	his
majusiy	heathen
Reeves)	Reeves)
&#39;edi.	&#39;.
oldiga	to the
1-2	1-2
10,	10
Kor	Kor
xususiyatlari	features
yuqoridan	from above
sozlash	settings
Erog&#39;lu)	Roth)
(Malcolm	(Malcolm
intollerent	intollerent
Jonson)	Johnson)
Havoriy	The apostle
Jonson,	Johnson,
Kou	Kou
saing	Saint
keltira	bring
oldida	by
tadqiqot.	Research.
egalik.	ownership.
100	100
joylarini	places
gapirib	speaking
o&#39;g&#39;illari&gt;	sons &amp; gt;
qo&#39;ymaguncha	put
uchayotganda	flying
Edmonton	Edmonton
tosh,	stone,
faks	fax
Vica	Vica
O&#39;g&#39;li&quot;	Son &amp; quot;
fan.	fan.
1/2	1/2
munozarasi	talk
tabib	physician
Elektron	Electronic
tarqatish	distribution
old	the front
xarajatlarni	expenses
odamlarda	people
oldik.	we got.
yashash	living
&quot;jargonu&quot;	&amp; Quot; &amp; quot jargon;
on-line	on-line
clueless	clueless
Pichoq	Knife
ma&#39;nosidir.	sense.
(Gary	(Gary
yuboraman.	send.
sezgir	sensitive
qo&#39;rqdilar	afraid of
deydi:&gt;&gt;	said: &amp; gt; &amp; gt;
Adams)	Adams)
ko&#39;tarilgan	rising
yaqinmiz	closer
tutashuv	circuit
harorati	The temperature
Tiff	Tiff
Bernard)	Bernard)
global	global
_National	_National
keyin	after
MIniVas	MIniVas
to&#39;rt	four
muhosaba	tolerable
yuziga	the face
Onadan	The mother
o&#39;ldiradilar	kill
ona	mother
Bures	Bures
Iyun	June
tushish	recession
&quot;T&quot;	&amp; Quot; T &amp; quot;
assult	Assouline
tushundim	I understand
sotib	purchase
Mart	March
Mars	Mars
aslida&gt;	Collins &amp; gt;
yo&#39;nalish	direction
minib	riding
uchta	three
hunarmandchilik	crafts
Blomberg	Blomberg
1,1	1.1
vakolatli	authorized
Mark	Mark
eng.	.
indeksi	Index
kelmagan,	not
infrastrukturaning	Infrastructures
yuzida	earth
1,3	1.3
o&#39;rta-1993	mid-1993
faol	active
tvtwm	tvtwm
asoslarini	the basics
rad.	rejected.
yozadi:	writes:
saqlab	save
harorat,	temperature,
sug&#39;urib	tear
rag&#39;batlantirish	promotion
muvaffaqiyat	success
GIF,	GIF,
gacha	until
Saturnning	Saturn
ko&#39;ra.	.
rad)	RED)
ko&#39;ra,	According to the
qat&#39;iy	strict
yozadi.	writes.
uchun	for
o&#39;tkir	sharp
stargazers	stargazers
ExposureMask	ExposureMask
bilasizmi?	Do you know?
shakllantirish	formation
atmosfera,	the atmosphere,
egasining	the owner
inson	human
Chunki	Because
alomatlar.	symptoms.
adovat	feud
Timo&#39;tiyga	Timothy
hajmining	the volume of
Uning	His
(hollar	(Cases
(38,8	(38.8
ranglar	colors
ob&#39;ekt	object
Neal	Neal
bahor	spring
aytish.	say.
boshqarish	Management
aytish,	say,
Kanadaliklar:	Canadians:
Suriya	Syria
faxr	pride
vshield	vshield
ular&gt;	&amp; gt;
joylarda	places
iconified	iconified
...	...
So&#39;ngra,	Then,
Fang)	Fang)
Neptunning	Neptune
Ana,	That is,
Eurosport	Eurosport
..:	..:
sotib&quot;	&amp; quot;
Midwest	Midwest
Cipriani)	Cipriani)
joylarga	places
o&#39;tkazish	transmission
kasal	sick
o&#39;rtasida	between
ta&#39;kidlanadi.	pointed out.
jargon	jargon
Rabbiyning	The Lord
Nea.	Nea.
qo&#39;ltiq	armpit
Word	Word
aytishi	say
*&gt;	* &amp; Gt;
jinsdoshlarini	LGBT
&quot;Siz&quot;	&amp; Quot; You &amp; quot;
qo&#39;shing.	add.
osmonni	the sky
jirkanch	nasty
loyqa	muddy
Qonunda	Law
jihatidan,	in terms of,
organlarining	the bodies of
biladi	who knows
Larri	Larry
so&#39;ng,	After
surib	aside
inkor.	denied.
bermaydi	does not
oozed	oozed
yashayman.	m.
qilganlar	Those who
xokkey,	hockey,
so&#39;ng.	then.
sudlanuvchi)	BEP)
ortiq,	more than
kompyuter	computer
qilinganidan	has been
hissa	contribution
tushing	Go down
belgilash	determination
tashqariga	out
jumladan,	including,
menga.	me.
terminal	terminal
Marokash,	Morocco
yonga	chip
tana	flesh
kasallik	disease
kınanması	reprehensible
yetarlicha	enough
bo&#39;lish&gt;	&amp; gt;
o&#39;tirgan	sitting
osmon	sky
etagida	on the outskirts of
Cloud	Cloud
belgilari	marks
sarflayapsiz,	expending
Nega	Why
qanchadan-qancha	how many
batafsil	thorough
balandliklardan	altitudes
States	States
bo&#39;lganlarga	those who
tushunmadilar.	understand.
-Karl	Kars
o&#39;xshaydi	similar to
Bilaman)	I know)
qirish	surfaces
(hammasi	(All
kuchi	The power of
(kamida	(At least
Skeptitsizm	Skepticism
Natijada,	As a result,
Brendan	Brendan
qilamiz.	.
zichroq	denser
o&#39;qimagan	unlettered
yoshgacha	years of age
Consulting,	Consulting
&lt;15464@optilink.COM&gt;	&amp; Lt; 15464@optilink.COM&amp;gt;
farq	difference
lekin&gt;	but &amp; gt;
deydi:&gt;	said: &amp; gt;
to&#39;qson	ninety
Kun	Day
eshitish	hearing
HELP:	HELP:
ixtiloflar,	disagreements,
Kaldis	KALDILDI
Mariner	Mariner
tasvir	image
tashqarida	out
yordam!	Help!
dastani	SAP,
tadqiqotlarning	research
rangli	colorful
bemorlarni&gt;	patients &amp; gt;
sex&quot;.	sex &amp; quot ;.
«kasalliklar	Diseases
o&#39;ylaydi.	think.
Qiladi	Will
yordam,	help
xabardor	aware
yuzi	face
kashf	discovered
qismlar,	parts
Miranda	Miranda
tark	leave
jamoat	public
emasman&gt;	I am &amp; gt;
beraman.	I will.
kuz	fall
tomosha&gt;	watch &amp; gt;
kun	day
tashxis	diagnosis
yonilg&#39;i	Cash
oshirilmoqda	being
miloddan	BC
kriptoanaliz,	cryptanalysis,
mls@panix.com	html>
holda	case
bukilib-bukilib,	legs,
ketgan,	,
Lee	Lee
tarqatib,	dissolution
odamlar	people
chizig&#39;i	line
joy&gt;	&amp; gt;
qo&#39;llanilishi	applied
bir&gt;	a &amp; gt;
sog&#39;liqni	health
qilib&gt;	&amp; gt;
tavakkal	risk
virtual	virtual
haqda	about
bo&#39;lishi:&gt;&gt;	: &amp; gt; &amp; gt;
England	England
Thorson)	Thorson)
Shapiro)	Shapiro)
tugmalaridan	buttons
(Haqiqat)	(Truth)
loyiq	worthy
Bounce	Bounce
alomatlar	symptoms
gomoseksualistlar,	gays,
Dr.Banzai	Dr.Banzai
ohangini	tone
(0,0)	(0,0)
........	........
muassasada	institution
Support)	Support)
relizlar),	release)
restart	restart
MDs	MDs
kerak.	.
hunarmandlikni	crafts
kerak,	,
qismlari	parts
.45	.45
Vodorod	Hydrogen
dbd@icf.hrb.com	html>
klavishlar	Shortcuts
afzal	rather
Aviatsiya	Aviation
kodini	Code
yakka	single
metan,	methane,
kerak?	you need?
1-800-344-4539.	1-800-344-4539.
bozorlarida	markets
kerak;	;
metall	metal
400&gt;	400 &amp; gt;
MC)	MC)
ustalari	masters
maslahatlashing	Consult
Foydalanish	The use of
sekundiga	second,
Rubin)	Rubin)
yuksaltirish	upgrades
Qonunga	Law
FJ1200&gt;	FJ1200 &amp; gt;
holat	status
axloq&quot;.	Ethics &amp; quot ;.
argument	argument
demadi-ku	did not have
X11R5	X11R5
X11R4	X11R4
fikrdamiz.	suggest.
amaldagi&quot;	current &amp; quot;
qilinishi.	.
alüminyumdan	aluminum,
olganda,	When the
elektr	electric
yo&#39;ldoshlar	Fellow
filtri	Filter
miqyosda	Captain
kmac@cisco.com	html>
laboratoriya	laboratory
o&#39;laroq,	In contrast,
(ning&gt;	(&amp; Gt;
hal@cco.caltech.edu	html>
amerikaliklar	Americans
tartibi	The procedure for
osondir.	easy.
sohalari	spheres
dept.	dept.
topdingiz.	relaxing.
(aytaylik,	(For example,
shubhali	doubtful
minnatdor.	Appreciation.
olgandan	receiving
minnatdor,	Appreciation
8000	8000
Kometa	Comet
kelmaymiz,	do not
joshuaf@yang.earlham.edu	html>
Kashshoflar	Pioneers
fayl	file
SETVER.EXE	SETVER.EXE
&quot;o&#39;sha	&amp; Quot;
munns@cae.wisc.edu	html>
istayman	I would like to
Model	Model
e-mail	e-mail
IMHO	IMHO
maydonida	Square
qochish,	escape,
Marsda	Mars
xususiyatlari;	features;
ro&#39;yobga	realization
Steve.Shapiro@f440.n101.z1.fidonet.org	html>
Brenner)	Brenner)
Fransiya	France
yillarning	years
sotiladi	be sold
Siemon	Siemon
xususiyatlari.	features.
xususiyatlari,	features
qismlar	parts
pop&quot;.	pop &amp; quot ;.
parchalanib	the collapse of
uskunalar	equipment
&quot;qismiga	&amp; Quot;
Isoning)	Jesus)
XR250L	XR250L
Andreas	Andreas
Asteroitler	Asteroids
kelishi	cause
kelsa,	comes,
Lo!	Lo!
(Xuan	(Juan
Terra	Terra
ro&#39;yxat	list
Mormonizm	Mormonism
statik	static
Luis&gt;	Luis &amp; gt;
loy	clay
albatta,	of course,
miltiq	rifle
albatta.	of course.
Patricia	Patricia
&quot;tizimli&quot;	&amp; Quot; systemic &amp; quot;
arzimas	junk
Terrorizmga	Terrorism
ro&#39;y	occurred
futbolchi.	player.
yilda&gt;&gt;	&amp; gt; &amp; gt;
berasiz.	Are you curious.
p.s.	p.s.
Olimlar	Scientists
xamirturush	yeast
boshladi	started
(Uzr,	(Sorry,
formuladan	formula
&lt;Apr.9.01.09.22.1993.16580@athos.rutgers.edu&gt;	&amp; Lt; Apr.9.01.09.22.1993.16580@athos.rutgers.edu&amp;gt;
ahmoq	fool
baham	share
havo-paket	air-bag
Ulardan&gt;	&amp; Gt;
o&#39;ldirilgan	killed
Yapon	Japanese
atsetilen,	acetylene,
reboot	reboot
holatlardan	matters
original	original
torre	torre
yomon	bad
nissan	nissan
bo&#39;lishidir.	is.
albatta?	really?
o&#39;xshashliklar	Similarities
qilishi	to
ko&#39;rinmaydi	Invisible
Missiya,	Mission
Cisco	Cisco
axborot	information
qilish]	]
Lin	Lin
qulfni	unlock
Salom,	Hello,
bo&#39;lishi	to be
brauzer	browser
Voizlik&gt;	Field &amp; gt;
Korenek	Korenek
(Ryan	(Ryan
maydoniga	Square
southeners	southeners
_ARE_	_ARE_
chekka	marginal
vulqonlardan	volcanoes
foizi:&gt;&gt;	%: &amp; gt; &amp; gt;
ehtimol,	probably
inson,	human,
qurollar	weapons
orbitasining	orbit
bezatilgan.	decorated.
192.100.81.100	html>
Marsga	Mars
qilish.	.
3&quot;,	3 &amp; quot ;,
qilish,	to
derazalar	windows
lmh@juliet.caltech.edu	html>
sehr	magic
bo&#39;lish.	.
endi,	Now,
nuqtasi	point
yükseltici	The amplifier
teleskopik	telescopic
emaslikda	are not
federal	Federal
Davis	Davis
Internet:	Internet:
sayyoramizga	planet
Aniq	Clear
yetib.	reached.
repopulation	repopulation
Axir,	After all,
futbolchi	players
Mail:	Mail:
ta&#39;sirida	Under the influence
bo&#39;lish,	,
lsa	is set
o&#39;rash	packing
David	David
ehtimoli	the possibility of
Dekabr	December
(starowl@a2i.rahul.net)	(Starowl@a2i.rahul.net)
(iltimos	(Please
oshirish,	increase
orangizda	among
og&#39;irligi,	weight,
kabi,&gt;	&amp; gt;
tushuntirish	explanation
Planetoloji	Planetology
PCX,	PCX,
aloqa	link
Orqaga&quot;	Back &amp; quot;
???	???
tabib&quot;	Physician &amp; quot;
(Yordam!)	(Help!)
zamburug&#39;li	fungal
5-7)	5-7)
saxiy	generous
ta&#39;sirini	the impact of
turing,	hold
&lt;May.7.01.08.16.1993.14381@athos.rutgers.edu&gt;	&amp; Lt; May.7.01.08.16.1993.14381@athos.rutgers.edu&amp;gt;
havoriylar,	the apostles,
ishonchliligi	reliability
sel,	flood,
Yuhanno	John
yuki	The burden of
Pitsburg	Pittsburgh
Prism	Prism
baho	appreciation
&quot;Buy	&amp; Quot; Buy
muzliklarning:	glaciers:
(225	(225
Things	Things
osmonda	the sky
qarsillamoq	n
sizlarga	you
Albatta	Definitely
Beyond,	Beyond,
yaratilgan	created
kishining	man
endi.	Now.
NatLamp	NatLamp
Bucky	Bucky
jinsi	Sex
holda,	,
shafoatga	intercession
parametrlarini	the parameters
uy-o&#39;lchamli	household size
5-6.	5-6.
zo&#39;rg&#39;a	barely
N81	N81
holda)	)
Canaveral	Canaveral
port	port
qilmasa,	does not
faxrlanamiz	We are proud
...&gt;	... &amp; Gt;
shahzoda	prince
shish.	tumor.
gaplashib	talking
yopishqoq	sticky
orbital	orbital
safar	time
muomalasi	The circulation
bemorlarni	patients
Yo&#39;lovchilardan	Passengers
bajo	fulfilled
gazsimon	gaseous
deb).	).
post	post
(Life	(Life
yaqinda	recently
shisha	glass
(g&#39;arbiy	(West
m-it2691@DOC.CS.NYU.EDU	html>
ekansiz	If you
chiziqlarga	Tangent
bozorida	market
qarang.	See.
seni	you
NASA,	NASA
fotosuratlarni	photographs
(quyosh	(The sun
er-xotin	pair
Nima?	What?
xayriya.	charity.
sirlarini	secrets
sent	cents
Roman	Novel
Nima,	What,
---------------------------&gt;	--------------------------- &amp; Gt;
bilaman.	I know.
folta@well.sf.ca.us	html>
&quot;munosib	&amp; Quot; likely
O&#39;liklar	Dead
pedalına,	pedal,
bepusht	barren
Landmann)	Landmann)
bilan,	with
bilan.	.
bilaman,	I know,
Falastinda,	Palestine
yozishni,	writing,
symbolisms	Symbolisme
(Blez	(Blaise
bilan)	)
TIDSA	Tidser
dentin	dentin
Triton	Triton
kuchining	Corfe
o&#39;ylaysiz?	do you think?
koordinatalarini	coordinates
Pan-Evropa	Pan-European
1742a	1742
&quot;standart&quot;	&amp; Quot; standard &amp; quot;
soluvchi	crusher
muhtoj	need
intizom	discipline
ikkala,	two,
jilo	Sensitivity
Masihiylar	Christians
Loc	Loc
Aylend	Rhode Island
bo&#39;ladi;&gt;	; &amp; gt;
===================================	===================================
(800)	(800)
beqaror	unstable
standart,	standard,
umumiy	general
Magellan	Magellan
kulgili.	funny.
o&#39;ynashga	play
CHARON	CHARON
karta	card
manbalarini	sources
millionlab	millions of
welshed	welshed
dalgalıdır	rippled
boshlab,	from
Schaufenbuel)	Schaufenbuel)
dushmanlari	enemies
suiiste&#39;mol	abuse
qaytmoqda,	freezes,
LM350T	LM350T
nomlangan	called
hisobidan	expense
yo&#39;lini	the path
randomize	randomized,
ishonaman,	I believe,
manbaidir	a source
bo&#39;lish	to be
tizim	system
beruvchi	employer
ishonaman.	I believe that.
qarshilik	opposition
o&#39;ylardim	I thought
turdagi)	types)
murakkabligi	the complexity of the
taklif	proposal
Va&#39;zi	Sermons
qilyapsan,	doing
qilyapsan.	doing.
voltgacha	volts
temir-boy	iron-rich
18EB	18EB
(Norvegiya)	(Norway)
&gt;,	&amp; Gt ;,
o&#39;rnatilgan,	Monte,
nuqtaga	point
kamtarlik	humility
qilyapsiz»,	doing &#39;
amin	sure
Postbus	Postbus
shaxsi	the personality
qasam	oath
ommaviy	mass
&quot;hal	&amp; Quot;
tariflanadi.	charge.
{uunet,	{Uunet
qulay	comfortable
Chiqish	Exit
bug&#39;ining	vapor
ateizm	atheism
fortay	Fort
bayon	explained
hayotimda	life
-km	-km
///	///
Boshlovchi	Conduct
Musoning	Moses&#39;
MC05A	MC05A
.signature	.signature
(keyingi	(Next
vaziyat	circumstances
mag	mag
Rind	Rind
aylanish	rotation
kutib	meet
bilingki	know
River	River
man	man
oyoqlari	the legs
qaytishingiz	return
bemorning	the patient
(Billy	(Billy
etiladi	It is
chiqarilishi	The production of
shaxsiy-kompyuter	personal-computer
g&#39;ildirak	wheel
etamiz.	offer.
izsiz	Bosham
modomiki	as long as
nosimmetrikliklar&gt;	irregularities &amp; gt;
tezligini	speed
Matt&gt;	Matt &amp; gt;
hizmatkorlari)	sysops)
10--	10--
Xonda	Honda
gt4417a@prism.gatech.edu	html>
gravitatsiyaviy	Jeans
MWm	MWm
mavjudligining	the existence of
o&#39;likdan	the dead
Saturn	Saturn
aytaman,	I say,
nuqtada	point
eshitdim.	I heard.
tushiradi.	decreases.
Borland	Borland
marta,	Once,
Expo	Expo
tahlil	analysis
marta.	times.
generatorlari,	generators,
qochqinlar	refugees
tashqari,	In addition,
tashqari)	)
Terminal	Terminal
niyatlarda	motives
nomimdan	On behalf
&quot;kaltaklashdi&quot;	&amp; Quot; beat &amp; quot;
ammo	but
oylik.	month.
gapiryapsiz&gt;	talking &amp; gt;
(yangilash):	(Update):
yoshda	years
elektromexanik	electromechanical
**************************************************	**************************************************
bilaman	I know
EISA	EISA
Xato	Error
(Qanday	(How
vahiy	revealed
organlari,	bodies
harakatlanish	Jump
Gregory	Gregory
-------------------------------------------------	-------------------------------------------------
qorong&#39;u,	dark,
(Elaine	(Elaine
fotoelektrik	Photoelectric
hünirini	scam
o&#39;limi	death
inobatga	Considering the
datchiklari	sensors
men	I
mezbon	host
topmasangiz	you can not find
marta)	times)
parallel	parallel
savollarga	questions
oxirgi	last
qoyaga	rock
ketish	departure
signallari	signals
dunyoviy	secular
yana))	again))
kometalar,	comets,
amaliyot&gt;	Practice &amp; gt;
___________________	___________________
so&#39;rovda	survey
erishish	achieve
ammo&gt;	but &amp; gt;
o&#39;lim.	death.
lmh@shakes.caltech.edu	html>
chips,	chips,
va&#39;dalari	promises
Joshuaf	Joshua
ko&#39;ylak,	shirt
maqsad	target
bitimi	Deal of
xotin	spouse
kuzatilgan.	observed.
qora,	black
Men	I
23:17:25	23:17:25
go&#39;yo	as
Cl056@cleveland.Freenet.Edu	html>
&lt;pgf.735012282@srl03.cacs.usl.edu&gt;	&amp; Lt; pgf.735012282@srl03.cacs.usl.edu&amp;gt;
Great	Great
dileriga	Reseller
sahobaning	Companion
Sizchi?	Have you?
Meg	Meg
yashamadi.	live.
qo&#39;shimcha	additional
pokiza	immaculately
sayyoramizni	planet
suratlarni	photos
Shamol	Wind
NHL	NHL
bu&gt;	&amp; gt;
sattellite	sattellite
kuponlar	Coupons
qo&#39;shish	Add
Toronto	Toronto
«barcha	&#39;All
lozim	should
o&#39;qituvchi,	teacher,
kirishlar&gt;	Input &amp; gt;
Mariners	Mariners
an&#39;analarini	traditions
kanallari	channels
Future	Future
saçmalýklarý	bullshit
EUROPA	EUROPA
Parsli	Parson
sayyora,	planet,
davlat.	state.
sayyora.	the planet.
Guthrie	Guthrie
bo&#39;lmasa	not
ateist	atheist
haqida	About
halqalarni	rings
Windows	Windows
rejalashtirilgan	planned
tashish	transportation
kirishlar	the inputs
davolash,	treatment
(tovarlar	(Goods
biologik	biological
ob&#39;ektlarini	objects
bo&#39;limi	Department
davolash)	Treatment)
so&#39;raysizlar	ask
tugmalari	buttons
bankrot	bankrupt
qolmoqda.	remains.
cliffs	Cliffs
Williams	Williams
individual	individual
albatta	definitely
SMARTDRV.EXE	SMARTDRV.EXE
o&#39;qing.	Read more.
yadrolari	cores
Greg,	Greg,
^^^^^^^^^^^^^^^^^^^^^^^^^^^^^	^^^^^^^^^^^^^^^^^^^^^^^^^^^^^
etadi	offers
yordamni	Treatments
olib	out
km@cs.pitt.edu	html>
Kevin	Kevin
ko&#39;rsatadi	shows
tezlik	speed
missiyalari,	missions
Man	Man
amerikalik	American
Mariner,	Mariner
Misol	Example
NCI	NCI
etiladi)	)
shakllantirish,	formation
Mac	Mac
tajribalar	experiments
etiladi,	It is,
versiya	view
plakat	The poster
etiladi.	.
va&#39;dalari&gt;	Words &amp; gt;
o&#39;tmish	past
uzatadi	transmits
Xristianlikni	Christianity
elementlar	elements
Pastda	Below
rls@uihepa.hep.uiuc.edu	html>
to&#39;g&#39;ri,	right,
Klaviaturadan,	Keyboard,
qoldirardi.	letting.
o&#39;tmay	soon
anti-kun	anti-days
May	May
kelajak	future
faraz&gt;	Assuming &amp; gt;
boshlash	initiation
tushunmadim.	I do not understand.
ethan@cs.columbia.edu	html>
olim	scientist
NET	NET
kishilarga	people
saqlanishi	stored
olis	remote
shamollarni	winds
apelsin	orange
(Benedikt	(Benedict
muayyan	certain
[insoniyat]	[Human]
oliy	supreme
qondirish.	satisfaction.
so&#39;nggi,	latest
o&#39;liklarni	the dead
qolish	stay
tarbiyachimiz	tutor
hokimiyat	authorities
ushlab,	,
--------------------------------------------------	--------------------------------------------------
va&gt;	and &amp; gt;
shahrida	city
jamoalarning	teams
shack	shack
&gt;&gt;&gt;&gt;&gt;	&amp; Gt; &amp; gt; &amp; gt; &amp; gt; &amp; gt;
yopish	closure
faoliyat	activity
o&#39;lim	death
o&#39;lik	dead
bo&#39;ylab	along
1970	1970
Kirish	Input
xursandman	I am happy
ichida:	in:
1971	1971
doirada	Accordingly,
qaror	decision
1972	1972
1973	1973
1974	1974
1975	1975
(Re:	(Re:
1976	1976
birovga	someone
1977	1977
1978	1978
1979	1979
ichida)	)
yashirincha	secretly
Instruments	Instruments
C.O.D.	C.O.D.
chuqurga	pit
_____________________________________________________________________	_____________________________________________________________________
o&#39;rgandim.	I learned.
-&gt;&gt;	- &amp; Gt; &amp; gt;
aralashmalar	The compounds
1990	1990
alyoung@kiwi.ucs	alyoung@kiwi.ucs
ko&#39;rinish	view
mol	goods
mamlakatlarida	countries
1983	1983
1980	1980
1981	1981
shifokor	doctor
1986	1986
boshchiligidagi,	headed
mos	suitable
1984	1984
1985	1985
486/33	486/33
1989	1989
achingan	pitied
Xiroshi	Hiroshi
muvaffaqiyatsiz	unsuccessful
Aprel	April
judayam	too
qayd	mention
(Red	(Red
Ammo	But
(HAWK	(HAWK
masallar	parables
davosi	treatment
sovuq	cold
«xolis»	&#39;Impartial&#39;
1995	1995
o&#39;zgarish	change
boshqaruvchiName)	manager)
1991	1991
diametri	in diameter
bedavo	incurable
1992	1992
1993	1993
LM350K:	LM350K:
haydovchilar-litsenziya	drivers license
1994	1994
bilmasdim.	I did not know.
armiya	army
1999	1999
|&gt;	| &amp; Gt;
birodarim	brother
uzoqdan	remote
Yordam:	Help:
xunasa	Gay
xavfsizlik&quot;	Security &amp; quot;
Qabul	Accepted
ZENON	ZENON
telefonni	Phone
Note	Note
kerakmi?	?
Javoblar.	Answers.
davom	continuation
Alicea,	Alicelik
o&#39;lib	die
3:31	3:31
shahridagi	city
&lt;1993Apr22.153000.1@vms.ocom.okstate.edu&gt;&gt;	&amp; Lt; 1993Apr22.153000.1@vms.ocom.okstate.edu&amp;gt; &amp; gt;
Mount	Mount
dushman&gt;	Shower &amp; gt;
instituti	Institute of
kislotalar	acids
------------------------------------------	------------------------------------------
(360	(360
hamohang	synchronization
hujayralar	cells
MacRae	MacRae
irodasi	prompt,
bordik)	Czech)
viloyatida	region
emas&gt;	&amp; gt;
mamlakatlariga	countries
hududga	by region
Gazlar	Gases
bo&#39;lsangiz.	If.
&lt;thomasp@ifi.uio.no&gt;	&amp; Lt; thomasp@ifi.uio.no&amp;gt;
bo&#39;lsangiz,	If
yo&#39;qolib	disappearance
ulamolar	printers,
carl_f_hoffman@cup.portal.com	html>
uyiga	the house
Quyoshdan	The sun
qoidalari	rules
jodfishe@silver.ucs.indiana.edu	html>
shapiro@sofbas.enet.dec.com	html>
&quot;biznes&quot;	&amp; Quot; &amp; quot;
unsurlar	the elements
Fotokimya	Fotokimya
dushmanlik&quot;	hostile &amp; quot;
bajarilishi	the implementation of
o&#39;quvchilar	students
jinoyatlar	crimes
O&#39;qish	Reading
davri	period
zararli	harmful
rejalashtirish	planning
Observer	Observer
qaytadi	returns
komissiya	commission
vodorod	hydrogen
masalasidir	a matter of
ziyorat	visit
arziydi.	worth.
Kawaguchi,	Kawaguchi,
Bell-Shimoliy	Bell-Northern
Jamoatning	Of the church
....&gt;	... &amp; Gt;
masofalarga,	distance,
nazariyasi	The theory of
Hizqiyo)	Ezekiel)
-----------------------------	-----------------------------
(Larry	(Larry
kibr	arrogance
Steve.	Steve.
yulduzlar,	stars
bo&#39;lib,	,
jumladan	including
uzoqdagi	distant
Diffie-Hellman,	Diffie-Hellman
slegge@kean.ucs.mun.ca	html>
talqin	the interpretation of
suratlar	pictures
NASA	NASA
tayyorlash,&gt;	Training &amp; gt;
sharafini	honor
ularni,	them,
muz	ice
Evolution	Evolution
joylari	places
xulosa	summary
qadimiy	antique
taqdir	fate
ota-)	Mom)
sotish,	sales,
amal	follow
yotipti	that&#39;s
Uranian	Urania
Ctrl-Alt-Del	Ctrl-Alt-Del
asboblari	devices
shakl	form
erkinlik	freedom
taqdim	submitted
turli,	different,
retrograd	Retrograde
behuda,	in vain,
va.&quot;	. &amp; quot;
(323	(323
mahsulot	product
Hatto	Even
tarqalgan	common
joylarni	places
ta&#39;siri	the impact of
jamiyatda	society
Kou)	Kou)
Ariel,	Ariel,
materiallar.	materials.
====================================	====================================
bo&#39;lmasa,	at least,
tarix	history
(Earth	(Earth
sodda	primitive
o&#39;lsa	dies
yuguruvchi	runner
CHIPS	CHIPS
qiyin.	difficult.
Steven	Steven
tushunmayman.	I do not understand.
tark.	leave.
theists	theists
og&#39;rig&#39;i	headache
5,25	5.25
turli?	different?
Nicji,	Nicji
qiyin,	difficult,
-dk	-dk
kino	film
shama	The implied
kelishidan	the arrival of
axloqsiz	immoral
Xudoning	God&#39;s
My,	My
go&#39;zallik	beauty
»(yo&#39;q	(No
ta&#39;sir,	affect
yordamisiz	Without the help of
yakshanba	Sunday
Vulkanizm	Volcanism
matnlari	texts
berildi,	given
yakuniy	ultimate
mil	Spindle
vertikal	vertical
almashtirish	Replace
cho&#39;kkan	laptop
tarixga	history
adabiyotni	literature
behuda.	in vain.
chiroq,	Lamp,
yuqori	high
(818)	(818)
O&#39;qisak	As far as
tarixi.	history.
yahudiylar	Jews,
andozalari	templates
masihiylarga:	Christians:
iboralar	statement
...&quot;	... &amp; Quot;
yo&#39;lida	in the way
qutulmoqchi	Therapy
zichlikdagi	density
tarixi,	history,
Crater	Crater
1938	1938
Mart&gt;	March &amp; gt;
kim?	Who?
mls	MLS
chunki&gt;&gt;	&amp; gt; &amp; gt;
ma&#39;lumotlari	info
1930	In 1930
orziqib	forward
birining	one of the
sodir	committed
Masihiylikda	Christianity
martin	martin
haqingizda	about
bunday&gt;	&amp; gt;
qo&#39;yadi	will
keldi,	,
keldi.	.
Isoga	Jesus
Gravitational	Gravitational
1947	1947
1949	1949
1948	1948
Fine	Fine
o&#39;nlab	tens of
spekülasyon	of speculation
stantsiyalarda	stations
Enterprise,	Enterprise
kasallikning	the disease
sevganlar)	Lovers)
&quot;bemorlarning	&amp; Quot; patients
nusxa	copy
Mr.	Mr.
aytilmoqda,	said,
sayyoralarning	the planets
kichik	Small
sanoqsiz	countless
Technology	Technology
1959	1959
1958	1958
tiklanadi	restored
bilan),	)
mototsikl	motorcycle
zaiflashishi	sever
(xamirturush)	(Yeast)
astronomik	astronomical
saytida	the site
qarab	Depending on the
muhandis	engineer
tekshiruvi	Checker
osmondan	from the sky
qachon,	when,
qachon.	when.
quloq	ear
vaqtning	time
kamida	at least
hisoblanadi&gt;	&amp; gt;
Barry	Barry
bo&#39;lishidan	everywhere
keldim	I came
INFJ	INFJ
xatolar	errors
===========================	===========================
1967	1967
1969	1969
1968	1968
chiqmaysiz,	I do not,
1962	1962
chiqmaysiz.	I do not.
1965	1965
birovni	someone
1964	1964
kim,	Who,
keldi:	:
kengaytmalari,	Extensions
qarshi,	against
a&#39;zosi	a member of the
(Ray	(Ray
INF)	INF)
qilmoqchiman.	I&#39;d like to.
qaramay	Despite the
(310	(310
ketyapman,	I am going to
-----------------&gt;&quot;	----------------- &amp; Gt; &amp; quot;
rivojlangan.	developed.
qadimgi	ancient
(&quot;zohiriy	(&amp; Quot; apparent
